Issue.ID,Number.of.issue.solving.commits.found,Total.additions.made.to.fix.the.issue,Total.deletions.made.to.fix.the.issue,Total.changes.made.to.fix.the.issue,Commits..commit.hashcode..date.of.commit..commit.s.author..number.of.additions.made.by.the.commit..number.of.deletions.made.by.the.commit..number.of.total.changes.made.by.the.commit..approach.used.to.find.the.commit.
1,19,4393,948,5341,"(0b93974075844601913c6df50f6566418a35eee8, 2021-02-25 14:32:13 -0800, Akao Kazutoshi, 2, 2, 4, LINK), (ad260ae7fd8e295015cef3a911431fb55752a63b, 2020-10-28 19:25:43 -0700, Pritam Damania, 3, 0, 3, LINK), (a058e938f944b6834b5d237735d715a79974b656, 2020-05-04 11:51:15 -0700, Edward Yang, 156, 57, 213, LINK), (1fe635be3c540ac9fd0a48cb1fcf3fb67eef64e2, 2020-02-19 18:39:33 -0800, Gao Xiang, 251, 159, 410, LINK), (9c2ed2574a9e36e2572486382fb4bc5b37ab8b9e, 2020-02-03 16:18:48 -0800, Xiang Gao, 1204, 441, 1645, LINK), (bad67015fedfa9de0e75999f89a7b661bd6a860f, 2019-06-06 19:24:29 -0700, ptrblck, 5, 2, 7, LINK), (7e6d932208a866551ca1b9ea7f149d48eb3ad413, 2019-06-05 18:03:51 -0700, Junjie Bai, 7, 1, 8, LINK), (b90cbb841d98aeae435b1d02b1ff211e028cdf5b, 2019-04-05 12:44:49 -0700, Joakim Rishaug, 1, 1, 2, LINK), (be6ad7ddde64cebeec4cd9537ddc3bca9cbe18e5, 2019-02-22 07:54:47 -0800, Will Feng, 8, 8, 16, LINK), (84d464f8f9ef470e7720b20ee297d07c512bfc82, 2018-11-15 14:51:44 -0800, Yinghai Lu, 1, 1, 2, LINK), (0b78ae86c59e7372f0b9d4cadcd0e50bc76f8667, 2018-09-10 15:30:08 -0700, Owen Anderson, 77, 29, 106, LINK), (26f038a557ae4fa9eb856b286c31f4f9ec2b27f3, 2018-01-22 17:47:18 -0800, Yongjik Kim, 178, 55, 233, LINK), (966db35dd9422c0da8595548d595dd2979c8c4fc, 2018-01-22 17:47:18 -0800, Yongjik Kim, 178, 55, 233, LINK), (83b36175fc0c6209e74592065aa4cbaa2fc825c9, 2017-11-14 11:43:00 +0800, peterjc123, 16, 2, 18, LINK), (4664808938b22c22abd216008926ecd81cb0c5e5, 2017-09-24 17:07:30 -0700, Igor Sugak, 1, 1, 2, LINK), (efda016108f16d4ac6087a3bcb0909729c1a7e11, 2017-09-13 23:17:05 -0700, Philip Pronin, 2, 2, 4, LINK), (080fab8f6c82daa93b478267f3a604e1bdb8083f, 2017-08-30 16:11:39 -0700, Misha Smelyanskiy, 1737, 64, 1801, LINK), (fe2c360eda650a485adca3d0629a8ef23cd2d3ab, 2017-03-09 19:23:37 +0100, Filip Binkiewicz, 358, 7, 365, LINK), (fa0451afe0cc207fdafa31214dbcf96acb64ac15, 2015-04-04 12:49:40 -0700, Adam Lerer, 208, 61, 269, LINK)"
10,5,21,19,40,"(0b93974075844601913c6df50f6566418a35eee8, 2021-02-25 14:32:13 -0800, Akao Kazutoshi, 2, 2, 4, LINK), (48d5ab54a842cf1e6893f4e3b896c37088eb6616, 2019-04-25 20:50:47 -0700, Jack Montgomery, 9, 7, 16, LINK), (b90cbb841d98aeae435b1d02b1ff211e028cdf5b, 2019-04-05 12:44:49 -0700, Joakim Rishaug, 1, 1, 2, LINK), (be6ad7ddde64cebeec4cd9537ddc3bca9cbe18e5, 2019-02-22 07:54:47 -0800, Will Feng, 8, 8, 16, LINK), (4664808938b22c22abd216008926ecd81cb0c5e5, 2017-09-24 17:07:30 -0700, Igor Sugak, 1, 1, 2, LINK)"
10009,1,9,7,16,"(242280162546797b32d6911b781d2dc74bed7fbf, 2018-07-31 13:35:40 -0700, Roy Li, 9, 7, 16, LINK)"
10013,1,17,17,34,"(9767951ca8a0af26d3caf2e84a52b10f81b9c2cb, 2018-08-22 12:27:10 -0700, Julian Rosenblum, 17, 17, 34, LINK)"
10032,1,6,4,10,"(29406a2c4c36d3c155abed16cf75f26af44426d4, 2018-08-04 11:30:57 -0700, Richard Zou, 6, 4, 10, LINK)"
10041,1,65,31,96,"(6b338c80264280b1c983ba49d0ffa43a499cd2fe, 2018-08-01 19:10:27 -0700, Richard Zou, 65, 31, 96, LINK)"
10096,1,306,83,389,"(e29b5a1ea8a8564550537f5db2ea0d4c8c45476d, 2018-08-17 15:46:06 -0700, Richard Zou, 306, 83, 389, LINK)"
10114,2,68,29,97,"(1c8a823b3b3b67e4e1bcf5d1102b6cfbda7cef15, 2018-10-29 11:54:08 -0700, Peter Goldsborough, 66, 29, 95, LINK), (01227f3ba7f0bc261c574373d8780209bb07eedf, 2018-10-21 20:05:57 -0700, Peter Goldsborough, 2, 0, 2, LINK)"
10120,1,56,16,72,"(49231ab0a8dc5381502d04a1ee3a32326fea93aa, 2018-09-06 16:06:25 -0700, Edward Yang, 56, 16, 72, LINK)"
10127,1,1,0,1,"(d57124823bb97c0233c7e84b79eec019f497ee87, 2019-10-08 11:39:15 -0700, Nathan Goldbaum, 1, 0, 1, LINK)"
1014,1,206,122,328,"(c2cfa4cf5bea1143d0a6e84f84881e85b6335c76, 2017-04-27 01:11:56 +0200, Adam Paszke, 206, 122, 328, LINK)"
10160,1,5,0,5,"(fe68879832f1198c0e2edb24d6b7b415ab9c87ae, 2018-08-07 09:51:54 -0700, Roy Li, 5, 0, 5, LINK)"
10206,1,23,10,33,"(df23bdc82da05f45037898d09662265876850698, 2018-08-05 15:47:02 -0700, Shuichi KITAGUCHI, 23, 10, 33, LINK)"
10236,1,1098,623,1721,"(24e958a0a779e3dcd7bda19ef3fa702ee654e9dc, 2018-09-19 16:17:18 -0700, Tongzhou Wang, 1098, 623, 1721, LINK)"
10237,1,85,14,99,"(1350f76b628bd4630439223adbe21ee993873f44, 2018-09-01 23:01:34 -0700, Tongzhou Wang, 85, 14, 99, LINK)"
10238,1,10,8,18,"(254dedf6043d5bea7dab6d1f663bcf9331628307, 2018-08-15 12:53:18 -0700, Tongzhou Wang, 10, 8, 18, LINK)"
10241,1,19,3,22,"(0b8a0125ab1c7af1d518c0018cf5596f24c1d55a, 2018-08-10 13:26:46 -0700, Christian Puhrsch, 19, 3, 22, LINK)"
10270,1,7,0,7,"(6e49f933ad01ccd9064e5ef3d433c7aefcfe3d86, 2018-08-08 21:04:44 -0700, Thomas Viehmann, 7, 0, 7, LINK)"
10276,1,29,38,67,"(64a60030a619ab656666be49aa332a96d8094845, 2018-08-09 12:39:04 -0700, Thomas Viehmann, 29, 38, 67, LINK)"
1029,1,0,2,2,"(b08862405ee992f2459d3ca628887a8d13fe446c, 2016-11-11 12:53:48 -0500, gchanan, 0, 2, 2, LINK)"
10307,1,21,0,21,"(7169906249fb57e0a9be00902abcb26457dcc14c, 2018-08-29 09:32:08 -0700, zou3519, 21, 0, 21, LINK)"
10345,1,38,21,59,"(a9469c9c8ab046a7961c1c357d84f60063507c4b, 2018-08-29 10:48:04 -0700, Ailing Zhang, 38, 21, 59, LINK)"
10353,1,2,3,5,"(64a6f17177732f459725ff64c6ba7c2db2c94bba, 2018-08-13 09:11:18 -0700, Edward Yang, 2, 3, 5, LINK)"
10357,1,1098,623,1721,"(24e958a0a779e3dcd7bda19ef3fa702ee654e9dc, 2018-09-19 16:17:18 -0700, Tongzhou Wang, 1098, 623, 1721, LINK)"
10397,1,2,3,5,"(64a6f17177732f459725ff64c6ba7c2db2c94bba, 2018-08-13 09:11:18 -0700, Edward Yang, 2, 3, 5, LINK)"
10435,1,1,1,2,"(508de8109fe88d6e690c03bc2c5ecb863f889062, 2018-08-12 18:06:41 -0700, Tongliang Liao, 1, 1, 2, LINK)"
10456,1,51,1,52,"(fed05cf4cf1063df009fc2280a0b5040606fde89, 2018-08-13 20:55:56 -0700, Richard Zou, 51, 1, 52, LINK)"
1046,1,112,0,112,"(f483679425fc766660003569fcc9789ee6a6fb0d, 2017-07-11 13:22:36 -0400, Amartya Sanyal, 112, 0, 112, LINK)"
10492,1,101,85,186,"(47d65ed34fa6bec4c3038edf1ee5119347607664, 2018-09-17 12:05:13 -0700, vishwakftw, 101, 85, 186, REGEX)"
10501,1,300,168,468,"(86c9856d9c878631e611de0e138bc409228bbfef, 2018-08-17 14:08:05 -0700, Richard Zou, 300, 168, 468, LINK)"
10523,1,1,1,2,"(26c764a1db1fecbab3870eb88c928da378ab0c5b, 2018-08-15 14:24:10 -0700, Marat Dukhan, 1, 1, 2, LINK)"
10532,1,66,4,70,"(5dd915cd1ac73d06b9c30134bacdac88aa24fae7, 2019-08-28 14:53:33 -0700, Stefan Krah, 66, 4, 70, LINK)"
10538,1,464,255,719,"(f6ec46489065d0fa3cb584210a3a932229f2a0ce, 2019-05-28 17:46:10 -0700, vishwakftw, 464, 255, 719, LINK)"
10540,1,50,32,82,"(05e06f7de2c84b8dd770c2f5008f5b7620e97d39, 2018-09-13 15:04:43 -0700, Jeff Smith, 50, 32, 82, LINK)"
10568,1,1,1,2,"(238b4b9236c8f0b36667ff9a83ca9125e34e7713, 2018-08-16 00:37:08 -0700, Tongliang Liao, 1, 1, 2, LINK)"
10570,1,4,5,9,"(7487ee55f10e8702b83ad2b79395991851edef7e, 2018-08-16 00:14:02 -0700, Tongliang Liao, 4, 5, 9, LINK)"
10584,1,6,1,7,"(c5c1c051cac7a120a1aeecaf3f6fb418d9a989d6, 2018-08-17 14:44:11 -0700, Tongzhou Wang, 6, 1, 7, LINK)"
10631,1,34,1,35,"(585e6b581f15332da5424d3ebf58767f780cd8dd, 2018-08-20 14:07:44 -0700, James Reed, 34, 1, 35, LINK)"
10632,1,156,86,242,"(3d43a8244091ff4ffa70404110263e202fd94a0c, 2018-08-23 15:06:16 -0700, Zachary DeVito, 156, 86, 242, LINK)"
10642,1,8,1,9,"(f1df85d799ab737e78f8a06b317a1852acbb3ef2, 2018-08-24 11:12:41 -0700, Wei Yang, 8, 1, 9, LINK)"
10648,1,80,22,102,"(5317429e826ad1049bdbdf40de79a25d3b957120, 2018-10-12 11:11:30 -0700, Ailing Zhang, 80, 22, 102, LINK)"
10654,1,24,1,25,"(e6bbbb017e1ad829316e7d7ea0f9ca9e78421da2, 2019-04-05 17:52:12 -0700, Elias Ellison, 24, 1, 25, LINK)"
10698,1,2,2,4,"(39a3dcc9999409a534331b3c3d905bfc298d51d2, 2018-08-20 13:55:28 -0700, Edward Yang, 2, 2, 4, LINK)"
10715,1,34,2,36,"(656e81db9372ea62f80155acded8b90b3445f0fd, 2018-09-06 07:43:10 -0700, Richard Zou, 34, 2, 36, LINK)"
10723,1,550,556,1106,"(de11fe0c8381bc8fa4182f247226d1f606d79678, 2018-09-21 16:21:32 -0700, Wei Yang, 550, 556, 1106, LINK)"
10726,1,16,13,29,"(a72603f8f8ffdd77a826129b18e839df3fe3a109, 2018-09-27 07:05:19 -0700, Freddie Mendoza, 16, 13, 29, LINK)"
10741,1,5,2,7,"(1421a9d7041d0c877ffdecb92ea90ead5425c0a5, 2018-08-28 09:22:15 -0700, Rohan Varma, 5, 2, 7, LINK)"
10742,1,488,102,590,"(bbe6ef38642cda127ece82f984ee3971e8750a45, 2018-10-15 13:38:59 -0700, Benoit Steiner, 488, 102, 590, LINK)"
10751,1,2,2,4,"(abb209ef253f47db0880f4482766d38c2c59212b, 2018-08-21 21:03:48 -0700, Tongzhou Wang, 2, 2, 4, LINK)"
10774,2,384,89,473,"(4d678790c56974108bcc2072380b850dcb0b74a8, 2018-09-06 16:33:59 -0700, Richard Zou, 186, 46, 232, LINK), (ca567862b279b9006e73dedc003779329d935772, 2018-08-24 07:57:28 -0700, Richard Zou, 198, 43, 241, LINK)"
10823,1,49,33,82,"(4ee0a78ee6452b7c1584b6020aef791b9d3e8ab6, 2018-09-18 07:36:15 -0700, Amitesh Arora, 49, 33, 82, LINK)"
10832,1,70,0,70,"(85ff72348d92c9e4b38dd00bbe42f0ca3e66667f, 2018-09-13 16:15:56 -0700, Gregory Chanan, 70, 0, 70, LINK)"
10838,1,4,4,8,"(02114e877f3b1acc4966968af73ff453ee1f9ad1, 2018-09-08 16:59:15 -0700, Yifei Teng, 4, 4, 8, LINK)"
10839,1,38,0,38,"(82aeebb3d972bb20fc7deac410d9705954bbd37f, 2018-08-31 07:20:35 -0700, Adam Paszke, 38, 0, 38, LINK)"
10850,1,51,1,52,"(11a16961a543a44ad7fc36d144888f5ddf070791, 2018-10-30 16:18:55 -0700, Will Feng, 51, 1, 52, LINK)"
10858,1,8,8,16,"(cda74ac476471e753ca06bd3491c84dc0bcaa813, 2018-09-11 17:42:03 -0700, Wei Yang, 8, 8, 16, LINK)"
1086,1,1,1,2,"(1d656b6769469a4e44373dbd8e2d5b41ade78770, 2017-03-24 12:11:12 +0000, Rodrigo Castro, 1, 1, 2, LINK)"
10873,1,47,12,59,"(d4e1fa45d055a1b00e8b7cfefa5c9f5db9ae6160, 2018-09-18 13:41:11 -0700, Wanchao Liang, 47, 12, 59, LINK)"
10876,1,45,3,48,"(407a9fee0c8fb172459ac9b3556419305e47f8a7, 2018-09-17 23:24:49 -0700, Wei Yang, 45, 3, 48, LINK)"
10882,1,160,27,187,"(700271d0e92c33a4cce3fee34b39ad5baa179b00, 2018-12-17 13:45:21 -0800, Spandan Tiwari, 160, 27, 187, LINK)"
10884,1,89,37,126,"(f940af629320a81834f1f70858869a185937da12, 2018-08-27 09:53:08 -0700, vishwakftw, 89, 37, 126, LINK)"
11030,1,181,189,370,"(6251c563eb1b02ea0ad76271e0f8a0e378348f00, 2019-06-05 06:30:54 -0700, Vishwak Srinivasan, 181, 189, 370, LINK)"
11033,1,7,0,7,"(cf10efb8d453e0cf69a64383d8ed4239f967860f, 2018-09-02 13:32:34 -0700, pbialecki, 7, 0, 7, LINK)"
11057,1,7,2,9,"(55212507a24bc742c5e9c68f1b917e9cc6c32b0f, 2018-09-05 10:55:36 -0700, Adam Paszke, 7, 2, 9, LINK)"
11074,1,13,9,22,"(d32b41003aa5d0ec10aa72be126ad9c136b50111, 2018-09-11 10:03:36 -0700, Orion Reblitz-Richardson, 13, 9, 22, LINK)"
11084,1,85,14,99,"(1350f76b628bd4630439223adbe21ee993873f44, 2018-09-01 23:01:34 -0700, Tongzhou Wang, 85, 14, 99, LINK)"
11089,1,19,3,22,"(ffbac7d0bb4e0772cab0054f79339478124ea9aa, 2018-09-24 11:50:41 -0700, Syed Tousif Ahmed, 19, 3, 22, LINK)"
11093,1,96,51,147,"(33ea7eafefb6a74d4d87b4e02f8d182640051ffc, 2018-12-04 18:45:45 -0800, Andy Chen, 96, 51, 147, LINK)"
11108,1,41,41,82,"(e1a17d5a42485810dcc2e92f1424e7204287d780, 2018-09-02 14:33:47 -0700, Tongliang Liao, 41, 41, 82, LINK)"
11118,2,94,4,98,"(068eac255b088c55cfdff55e73d7d24517c5e801, 2018-09-20 14:27:02 -0700, Thomas Viehmann, 61, 3, 64, LINK), (336323f53c21fb68c884fd071825ac31914300a0, 2018-09-17 13:28:27 -0700, Natalia Gimelshein, 33, 1, 34, LINK)"
11157,1,31,14,45,"(120d7694327dafcfca5fa4447f438772c9b1c729, 2018-09-11 05:58:11 -0700, Adam Paszke, 31, 14, 45, LINK)"
11186,1,93,32,125,"(ed47b85d3bd9c33ed723d2ae5309bebb4d619ac6, 2019-03-22 13:48:59 -0700, Natalia Gimelshein, 93, 32, 125, LINK)"
11195,1,1,1,2,"(a11ebfa195db22268e9db562a6295752f55bec4a, 2018-09-11 21:04:10 -0700, Tongliang Liao, 1, 1, 2, LINK)"
1120,1,507,0,507,"(343d65db91c2419843d36aed5467c2d1374108bc, 2017-01-27 13:29:05 -0500, Soumith Chintala, 507, 0, 507, LINK)"
11204,1,160,98,258,"(581099a7b22027a43ca0c7b443a2d70ca70ee05d, 2018-09-09 10:26:21 -0700, Thomas Viehmann, 160, 98, 258, LINK)"
11206,1,12,2,14,"(313e89d8db87cadaa13a1d28c797610e2f56d10a, 2018-09-04 17:14:14 -0700, Christian Puhrsch, 12, 2, 14, LINK)"
1121,1,5,2,7,"(def0506d9563c93e1620a1c7789ac21f6a9931c8, 2017-09-25 21:21:22 -0700, Lu Fang, 5, 2, 7, LINK)"
1126,1,43,44,87,"(ac9312e9f8002227b267a82e224a5a99c7a7e734, 2017-02-04 10:07:45 -0500, Will Frey, 43, 44, 87, LINK)"
1127,1,152,6,158,"(909f31764faf65c80f4d8eaeae8a12c67eb24c17, 2017-06-15 08:41:38 -0300, Aron Barreira Bordin, 152, 6, 158, LINK)"
11326,1,18,1,19,"(9a76e84a08cbbec0c8be4984ee5931b048bd6756, 2018-10-17 10:40:12 -0700, Zachary DeVito, 18, 1, 19, LINK)"
11339,2,245,71,316,"(947229ebd780b0ecead66029691fd18881947b59, 2019-01-03 10:29:03 -0800, Spandan Tiwari, 133, 40, 173, LINK), (f0f9277c3cda0b022af0dfaf21d043641bea80d2, 2018-12-20 12:24:42 -0800, Spandan Tiwari, 112, 31, 143, LINK)"
11360,1,1,0,1,"(2946b021e38dd4cd4d6465b5aa4a8efbb160c2e5, 2018-09-06 20:39:21 -0700, Edward Yang, 1, 0, 1, LINK)"
11362,1,12,0,12,"(7122f8b3bb7f7287cf0410a5ced2c5b120d15d30, 2018-09-25 10:19:39 -0700, Will Feng, 12, 0, 12, LINK)"
11398,1,204,65,269,"(6100c0ea14306f409bc6d7ba46b149c64a2417b3, 2018-09-20 14:35:02 -0700, Peter Goldsborough, 204, 65, 269, LINK)"
114,1,38,0,38,"(35348dab103316a929ae55d91a9d03e049d7fc43, 2018-09-11 20:23:03 -0700, Rasmus Diederichsen, 38, 0, 38, LINK)"
11419,1,1,1,2,"(fbc17321fdd96ce4dcc275ff61264d04f2fbd6e2, 2018-09-11 12:24:52 -0700, James Reed, 1, 1, 2, LINK)"
11422,1,222,55,277,"(be47470c91e467d8bddbc0e07f099cf2a200e5c0, 2018-12-05 10:52:39 -0800, Ailing Zhang, 222, 55, 277, LINK)"
11427,1,118,13,131,"(a8b1755de6c967bd8e9d777b6a0dddf4e7a6eed1, 2018-09-17 08:15:19 -0700, Gregory Chanan, 118, 13, 131, LINK)"
11430,1,50,19,69,"(72822ee6b251118aefbe9af75ac0fcb4ee56a0ee, 2018-09-14 08:55:39 -0700, Edward Yang, 50, 19, 69, LINK)"
11452,1,2,3,5,"(f09054f8d09cca58e3ef63568b18977e66ca56a6, 2018-09-14 17:45:51 -0700, Ailing Zhang, 2, 3, 5, LINK)"
11453,1,13,9,22,"(d32b41003aa5d0ec10aa72be126ad9c136b50111, 2018-09-11 10:03:36 -0700, Orion Reblitz-Richardson, 13, 9, 22, LINK)"
11476,1,77,9,86,"(ac994f2c788a8e02fe7756a91a2d0bc292f32b36, 2018-10-16 15:59:23 -0700, Tongzhou Wang, 77, 9, 86, LINK)"
11504,1,44,10,54,"(8b196d671b1a2be26fd6fe73f55aa45fb8a91e1e, 2018-09-11 17:41:28 -0700, Adam Paszke, 44, 10, 54, LINK)"
11518,1,3,0,3,"(09273868903b0b657250bcdd9555aaa49506017f, 2018-09-20 09:20:49 -0700, Soumith Chintala, 3, 0, 3, LINK)"
11535,1,10,11,21,"(bbf54ea37cc063503d6e30ffe2124031f3c87f59, 2018-09-11 18:24:02 -0700, Fritz Obermeyer, 10, 11, 21, LINK)"
11570,1,3,1,4,"(94c513cc7f27d98ec6b5dead0af7fabcf5c5cd13, 2018-09-25 11:10:34 -0700, Orion Reblitz-Richardson, 3, 1, 4, LINK)"
11582,2,10,4,14,"(24a8c13f3620b6f2cdef16e8749b7e49b50de3ed, 2018-09-17 17:29:34 -0700, Pieter Noordhuis, 6, 4, 10, LINK), (02c4cd3c8a3a4234ffbddde8d1214f0cfb209086, 2018-09-12 14:45:52 -0700, Tongzhou Wang, 4, 0, 4, LINK)"
11625,1,35,6,41,"(278e304c18b0da89cbc58ac43b2d5eabdd3fd6f3, 2018-09-14 10:04:05 -0700, James Reed, 35, 6, 41, LINK)"
11647,1,584,99,683,"(006505bb8f9dcf0f38b32518308d071c8a1ccec6, 2018-11-27 15:18:39 -0800, Sam Gross, 584, 99, 683, LINK)"
11652,1,14,0,14,"(e2bc95e1bd39f4cd1813a21290f2f8f6fb51c0eb, 2018-09-18 07:33:31 -0700, Xingdong Zuo, 14, 0, 14, LINK)"
11663,1,17,1,18,"(70e68e755a8fdd94218e9b8e0abfb6b805354a08, 2018-09-14 13:29:06 -0700, David Riazati, 17, 1, 18, LINK)"
1168,1,2,0,2,"(d4336edb052498ed52648c96b89857c11081a99a, 2017-09-06 13:39:44 -0700, Wojciech Glogowski, 2, 0, 2, LINK)"
11683,1,139,23,162,"(3bfa7258b3ec680328e0ebf9dc72a92833bcd2f3, 2018-10-16 20:08:45 -0700, Edward Yang, 139, 23, 162, LINK)"
11732,2,80,2,82,"(7b98af16eeb90a19507ef98db35b325513750cf2, 2019-01-08 19:57:16 -0800, albanD, 40, 1, 41, LINK), (828cb18fa35c7c132ab920de1c0dc6d859f152d6, 2019-01-08 19:57:16 -0800, albanD, 40, 1, 41, LINK)"
11736,2,1072,708,1780,"(8812a5d42e7be858334a4f5bd6acc7e6e942815f, 2018-12-04 00:13:24 -0800, Adam Paszke, 536, 354, 890, LINK), (68ffe469918a5eaa014e230efe81af9c298857aa, 2018-12-03 13:41:05 -0800, Adam Paszke, 536, 354, 890, LINK)"
11739,1,29,21,50,"(7df6650e9c23c507137b9af7ffb94053b8a86a2d, 2018-09-17 14:36:18 -0700, Tongzhou Wang, 29, 21, 50, LINK)"
11750,1,41,5,46,"(a7e3cd09e023685a96f65d8447490455a16a4ebb, 2018-09-17 09:44:51 -0700, Thomas Viehmann, 41, 5, 46, LINK)"
11751,1,28,1,29,"(807de9a1e3cff49dd23fb7df83aea38269ccdd23, 2018-09-25 19:08:00 -0700, Wei Yang, 28, 1, 29, LINK)"
11752,2,18,6,24,"(b403b10ff98a6bc1a238e7ba4eee6393b6b89048, 2019-06-17 12:52:40 -0700, LUO luoyuchu, 15, 4, 19, LINK), (ae1a972d78950abc4dab372f496914b5e78b9637, 2018-09-19 17:07:05 -0700, sytrus-in-github, 3, 2, 5, LINK)"
11755,1,325,3,328,"(b8256280ce45f02a7e105d3b3db4a547990e683d, 2019-05-07 07:46:16 -0700, Ahmad Salim Al-Sibahi, 325, 3, 328, LINK)"
11757,1,109,6,115,"(39bd73ae513358e1fe5881e58b1ab6aea14bed41, 2018-10-04 12:00:29 -0700, vishwakftw, 109, 6, 115, LINK)"
11762,1,1,1,2,"(2732c8bae10881bc7a359af2dfbc812238efb436, 2018-09-18 10:47:21 -0700, Soumith Chintala, 1, 1, 2, LINK)"
11788,1,38,0,38,"(b263078bc3528c1e64a93290d2eaa473bce6ed92, 2018-09-25 13:07:47 -0700, Sam Gross, 38, 0, 38, LINK)"
11795,1,43,9,52,"(1cf5b0c7c19f55411a01c936fb265dd6b7847392, 2018-09-21 13:49:16 -0700, Sam Gross, 43, 9, 52, LINK)"
11800,1,20,8,28,"(4fb7e72fe5969b9de7dde1fbc4499eb1dc8486c8, 2018-09-21 08:24:02 -0700, Thomas Viehmann, 20, 8, 28, LINK)"
11803,1,132,87,219,"(044d00516ccd6572c0d6ab6d54587155b02a3b86, 2018-11-07 11:56:09 -0800, Tongzhou Wang, 132, 87, 219, LINK)"
11804,1,39,56,95,"(4ec6bd73566bb5372e615b963db068143f417bfb, 2018-11-29 09:14:37 -0800, Pieter Noordhuis, 39, 56, 95, LINK)"
11847,1,18,6,24,"(9f2b2cac37da4476dde478d063cc5a5f2edb0e91, 2018-11-02 10:19:18 -0700, Tongzhou Wang, 18, 6, 24, LINK)"
11874,1,122,63,185,"(97036d3c3043b99b9015bf44f9a58eb14f106a80, 2018-11-14 01:26:44 -0800, Teng Li, 122, 63, 185, LINK)"
11878,1,5,6,11,"(aa022313cb694546cca7fcb0123a818bf2d668b9, 2018-12-13 00:19:13 -0800, Syed Tousif Ahmed, 5, 6, 11, LINK)"
1188,1,1,1,2,"(9fe99241b2baf6a45d6bfd2d452e8f7985bfd9f6, 2017-09-23 19:38:13 -0700, Yangqing Jia, 1, 1, 2, LINK)"
11886,1,3,3,6,"(f6609daad7b03dcf32cc62bb78a96de4099c2ce4, 2019-05-06 06:32:42 -0700, peter, 3, 3, 6, LINK)"
11888,1,19,3,22,"(ffbac7d0bb4e0772cab0054f79339478124ea9aa, 2018-09-24 11:50:41 -0700, Syed Tousif Ahmed, 19, 3, 22, LINK)"
11905,1,15,0,15,"(775358e4c2543af4da39387385e39da6cfed5ece, 2018-09-21 12:27:56 -0700, Thomas Viehmann, 15, 0, 15, LINK)"
11912,1,24,602,626,"(5865561a9a8daf4735fdbd1091fd028dd79df0e5, 2018-11-27 10:41:04 -0800, Pieter Noordhuis, 24, 602, 626, LINK)"
11913,1,8,1,9,"(58d28a5f126fedbf47d87b16708357c1319fb1d0, 2018-09-21 06:05:37 -0700, Luca Antiga, 8, 1, 9, LINK)"
11914,1,325,1,326,"(7a1b668283ef80098d00f621803863c492900389, 2018-10-12 13:33:43 -0700, Alex Ford, 325, 1, 326, LINK)"
11991,1,10,3,13,"(cf444f354450821a9e4288a8eb32a2a6571754e9, 2019-03-29 06:41:49 -0700, crcrpar, 10, 3, 13, LINK)"
11995,1,1,3,4,"(93ecf4d72ada7fd6cbcf9ec582ecb0e37344bc7c, 2018-09-29 22:40:09 -0700, Peter Goldsborough, 1, 3, 4, LINK)"
12014,1,1,1,2,"(20e395a1302966349841aab04a45a614d6354c11, 2018-11-14 21:34:56 -0800, Teng Li, 1, 1, 2, LINK)"
12042,1,112,81,193,"(a5818047c4c297de7ccb41c32fb98609ab3eaab7, 2018-09-27 19:01:29 -0700, Edward Z. Yang, 112, 81, 193, LINK)"
12067,1,34,7,41,"(7b2c0a09e4795bb8dc06c3d1881289fbe75d84e2, 2018-09-28 13:55:42 -0700, mruberry, 34, 7, 41, LINK)"
121,1,1,7,8,"(4afd6306321bc84db33c94813e85945a0ab59ade, 2017-10-24 05:48:51 -0700, Zachary DeVito, 1, 7, 8, LINK)"
12112,1,1,1,2,"(b46a630836973c8101a4d806e44246cda4693dcb, 2019-05-14 08:29:38 -0700, Sam Gross, 1, 1, 2, LINK)"
12115,1,151,82,233,"(bd958cde685c2de67ecf691934470ef3c289e00d, 2018-12-17 20:08:15 -0800, Jie, 151, 82, 233, LINK)"
12118,1,18,2,20,"(c9f9df002dc9e2b0c4648cb6148030b5405c55d3, 2018-10-03 17:10:22 -0700, David Riazati, 18, 2, 20, LINK)"
12120,1,30,19,49,"(5ffc915f26a7759d3a24b692599a49db2ef6b0c0, 2018-09-29 22:23:36 -0700, Wei Yang, 30, 19, 49, LINK)"
12129,1,29,5,34,"(488d393ea604184eb30e9eaa67b6c60291152e21, 2018-10-31 10:13:14 -0700, Ailing Zhang, 29, 5, 34, LINK)"
1215,1,1,2,3,"(81898e5d470caac8674ee457c5265cbf190c54b1, 2018-01-12 16:02:38 -0800, Leon Masopust, 1, 2, 3, LINK)"
12150,1,138,34,172,"(74819087de17de4c8215a7f631d8d4d18dd13d45, 2018-11-05 16:20:19 -0800, Teng Li, 138, 34, 172, LINK)"
12160,1,117,1,118,"(f0ed927b625068a636d2f2de7d19e505e06a3fb9, 2018-11-05 08:53:23 -0800, Thomas Viehmann, 117, 1, 118, LINK)"
12168,1,59,30,89,"(d120b9af5ad23b461dab2243959a66bff26e7ce1, 2018-10-19 16:38:38 -0700, Teng Li, 59, 30, 89, LINK)"
12174,2,33,6,39,"(7c1e4258a958863ee5363373289d05418be06887, 2019-02-12 14:14:30 -0800, Pearu Peterson, 19, 3, 22, LINK), (7ce33c586de4c73a618430fdbf8f52ac1b9cc9f6, 2019-02-07 20:27:40 -0800, Pearu Peterson, 14, 3, 17, LINK)"
12193,1,15,3,18,"(2b033332c8b7720b16b7a442311aeb4adfaab84c, 2018-10-10 23:43:23 -0700, sclarkson, 15, 3, 18, LINK)"
122,2,4,2,6,"(b06d8937f54037f9d425b4712daa93c1ceafa331, 2017-10-24 11:31:01 -0400, SsnL, 2, 1, 3, LINK), (1a0e4e1b00a679f789f248c6180e4a4fbb7f63ee, 2017-10-24 11:31:01 -0400, SsnL, 2, 1, 3, LINK)"
12207,1,42,2,44,"(0521c47c9150332dea65c41a4139bf987b06ac3a, 2018-10-16 23:56:27 -0700, Thomas Viehmann, 42, 2, 44, LINK)"
12230,1,11,4,15,"(02695c11db939180f25bfbbc82a922a9c339d50a, 2018-10-14 23:09:44 -0700, Mingfei Ma, 11, 4, 15, LINK)"
12241,1,599,2,601,"(be7c618fd7fadb9db58aae8bef16638912748cfa, 2018-11-28 02:16:56 -0800, Wei Yang, 599, 2, 601, LINK)"
1225,1,43,13,56,"(34546f022aefdd1947107bcf9f8d8009d1031ea1, 2017-04-18 16:37:28 -0400, Edward Z. Yang, 43, 13, 56, LINK)"
12251,1,2,2,4,"(1a6071d436c63cb9174b07726d302de70989ec0b, 2018-10-17 09:14:04 -0700, Jaivarsan, 2, 2, 4, LINK)"
12259,2,17,17,34,"(c60465873c5cf8f1a36da39f7875224d4c48d7ca, 2019-06-07 07:47:30 -0700, Kaixhin, 10, 10, 20, LINK), (c9be135bb9284461d0ec377cb71c0e796fcb5090, 2018-11-08 18:58:03 -0800, Kaixhin, 7, 7, 14, LINK)"
12260,1,24,22,46,"(8734b174cadc8513bef177c57f1f8267898f34d0, 2018-10-10 20:32:51 -0700, Ailing Zhang, 24, 22, 46, LINK)"
12261,1,7,8,15,"(f17b2fdf1b9479f1d8ae186d5c17d6a1d4d9c7c9, 2018-11-15 17:52:51 -0800, Teng Li, 7, 8, 15, LINK)"
12290,1,485,203,688,"(b13f91dbd935cf6282129c2c377231b56d8cc77b, 2018-11-26 12:28:44 -0800, Richard Zou, 485, 203, 688, LINK)"
12309,1,163,198,361,"(c89301a6250ca17c568f11e52f715f939c08d7ce, 2019-09-03 09:36:34 -0700, Igor Fedan, 163, 198, 361, LINK)"
12319,1,55,65,120,"(1a0d82e4f43ecce9d13c90d9219f0b419a4852c9, 2018-10-08 22:12:54 -0700, Roy Li, 55, 65, 120, LINK)"
12320,1,5,2,7,"(b3cdaee6dbe88e49750514107a64e3cb0c674083, 2018-10-05 08:38:17 -0700, ohlr, 5, 2, 7, LINK)"
12324,1,9,7,16,"(543048d2758e714a953da6af7082c8fb7b1c98b2, 2018-10-10 17:03:14 -0700, Syed Tousif Ahmed, 9, 7, 16, LINK)"
12326,1,1,1,2,"(9ebac3d7fe93b50db4518a35cc9ed94619e66ead, 2018-10-05 10:55:47 -0700, David Riazati, 1, 1, 2, LINK)"
12327,1,29,5,34,"(488d393ea604184eb30e9eaa67b6c60291152e21, 2018-10-31 10:13:14 -0700, Ailing Zhang, 29, 5, 34, LINK)"
12364,1,101,4,105,"(97eec33f801609b90f0a5398c087ca9fcce9c87b, 2018-10-12 11:27:02 -0700, Xiang Gao, 101, 4, 105, LINK)"
12371,1,2,2,4,"(e6a420114f184ecfe58765b934f07831fbbf6d85, 2018-12-06 14:55:55 -0800, Richard Zou, 2, 2, 4, LINK)"
12395,2,3,20,23,"(4c06f1f2bbbc655fcbffcd16af1da38f8906c1cc, 2018-10-31 09:29:21 -0700, Will Feng, 0, 17, 17, LINK), (85273acca8ab534b83886a1ebcc9608acd3bca42, 2018-10-24 11:43:50 -0700, Anders Papitto, 3, 3, 6, LINK)"
12406,1,5,0,5,"(0e44db8b0d23431c6db4c79af8b7c66527e2cc73, 2018-10-07 18:53:17 -0700, Thomas Viehmann, 5, 0, 5, LINK)"
12420,1,175,86,261,"(0740a5d521c04c832538767230a9ee7ea2c93bed, 2018-10-15 12:31:15 -0700, vishwakftw, 175, 86, 261, LINK)"
12426,1,11,0,11,"(ea79f7c032112571f0181d2c3199604aafb7b54d, 2018-10-09 11:24:11 -0700, Thomas Viehmann, 11, 0, 11, LINK)"
12431,1,15,7,22,"(2f82a0682687552c27f86312de012c95cbb754f5, 2018-11-02 07:44:58 -0700, Tongzhou Wang, 15, 7, 22, LINK)"
12454,1,62,52,114,"(0cf3c1ce66c31e735f0ddce58ad2e3ac3e77a6a9, 2018-10-12 02:08:49 -0700, Thomas Viehmann, 62, 52, 114, LINK)"
12459,1,247,244,491,"(99a5d195917a14cdcef83c8c8a9553d30a568f08, 2018-11-01 10:27:50 -0700, Tongzhou Wang, 247, 244, 491, LINK)"
1246,1,2,1,3,"(c39216f8c49361456d7d827b6199ac54799ff2e2, 2018-09-06 17:25:06 -0700, Lu Fang, 2, 1, 3, LINK)"
12495,1,0,1,1,"(7b0f5d6631321c9758a853dd3ac2c95ebf326d53, 2018-10-11 13:43:02 -0700, Orion Reblitz-Richardson, 0, 1, 1, LINK)"
12510,1,21,1,22,"(26751ce30064d1d93d744f0d114968bc77dccddc, 2018-11-08 21:07:51 -0800, peterjc123, 21, 1, 22, LINK)"
12540,1,0,787,787,"(a1bbe80e2199f81973bbeb8e6f0d40c5707d02e7, 2018-10-15 11:02:31 -0700, mratsim, 0, 787, 787, LINK)"
12545,1,1,1,2,"(52cbf4b7749a94dad280f96388dd358c96d36cbd, 2018-10-15 16:51:26 -0700, Bowen Bao, 1, 1, 2, LINK)"
1256,1,16,2,18,"(ad3e619198bf2f8d0b1968380b57745c2c49271f, 2017-11-20 13:44:46 -0800, Pieter Noordhuis, 16, 2, 18, LINK)"
12565,1,10,3,13,"(710191e292b39c6d26948454fcf1f4a30433d6a0, 2018-10-18 00:49:26 -0700, Wei Yang, 10, 3, 13, LINK)"
12578,1,120,74,194,"(478886be308c5c14f5898bfe4d9833f4debba20a, 2018-10-24 18:10:32 -0700, Ailing Zhang, 120, 74, 194, LINK)"
12580,1,53,4,57,"(db0b5c7ab7f6bbb3c69b388f53dc806d86f6b639, 2018-10-29 13:53:46 -0700, James Reed, 53, 4, 57, LINK)"
12586,1,171,178,349,"(d5eae905370970e40dec59b9ebf908f5afb42d2d, 2018-10-15 11:55:31 -0700, ArmenAg, 171, 178, 349, LINK)"
12603,2,71,11,82,"(5268dd468cf75ebcd7a08cf72da8c809c3a1dc44, 2018-12-02 17:10:48 -0800, Teng Li, 60, 11, 71, LINK), (4983397c02b804e5197de9a75381e2823af20434, 2018-11-14 10:28:28 -0800, Teng Li, 11, 0, 11, LINK)"
12604,1,83,41,124,"(dceec1de30e4ef2f31fcaa9109402a76dd04d6fa, 2018-11-07 12:09:35 -0800, Teng Li, 83, 41, 124, LINK)"
12631,1,2,1,3,"(f6de833cac63016de7f0f04b260c734f19e46505, 2019-03-13 03:16:40 -0700, serhii-havrylov, 2, 1, 3, LINK)"
12643,1,117,108,225,"(d6a8dd95385755cf121ff6278b995e3f82f6f845, 2019-01-17 12:14:39 -0800, Egil Martinsson, 117, 108, 225, LINK)"
12647,1,2,2,4,"(23c4dbd6d7f672945c58dd02e18b0051a9e89591, 2018-10-15 17:12:50 -0700, ahirner, 2, 2, 4, LINK)"
12653,2,919,172,1091,"(06a7cb59019ee57c679ba2cf7d51e36bd3710ad4, 2018-12-20 10:21:02 -0800, Shen Li, 569, 171, 740, LINK), (90f9e8103c9b1108ae923f5ab67bcc566e942699, 2018-12-12 15:18:57 -0800, Shen Li, 350, 1, 351, LINK)"
12669,1,6,0,6,"(d80a3eb549f0e38791ba54eac278056f6d9757a6, 2018-10-15 17:43:33 -0700, Thomas Viehmann, 6, 0, 6, LINK)"
1267,2,40,37,77,"(e25b3d7bc5621e3d8d9469a59238e0d9a09e89dc, 2017-07-27 09:43:56 -0400, Eric Cosatto, 4, 4, 8, LINK), (aab30d4ea25686bcd8502aa280ba75d73559c2e4, 2017-04-23 08:45:27 -0400, Sam Gross, 36, 33, 69, LINK)"
1269,1,4,2,6,"(ee143d31ef071b277e21ac5eb3d7b725f60e7756, 2017-10-10 11:15:07 -0700, Luke Yeager, 4, 2, 6, LINK)"
12721,1,5,0,5,"(1b64c0f8fe4336efdf69d0f02b83528ab3290608, 2018-11-05 16:37:57 -0800, Teng Li, 5, 0, 5, LINK)"
12735,1,3,1,4,"(9d79030d38820c15e38c497720e76075d03ea768, 2018-10-17 10:12:09 -0700, James Reed, 3, 1, 4, LINK)"
12737,1,363,114,477,"(2cd912bcc22bcbd58cf5e4461901b68a7cf77492, 2018-11-06 19:11:45 -0800, Tongzhou Wang, 363, 114, 477, LINK)"
12751,1,4,4,8,"(84ce3ab47e4da0ca4727c9daf125138a7642935a, 2018-10-17 15:35:21 -0700, Kaixhin, 4, 4, 8, LINK)"
12780,1,23,502,525,"(57e162da56f83f04ed744caba1b3819a2ca8c86a, 2018-11-01 19:37:53 -0700, Michael Suo, 23, 502, 525, LINK)"
12810,1,27,1,28,"(026a9c6bf2e17c724f011adb6ed9c051fe7e4b65, 2019-04-08 13:35:34 -0700, Thomas Viehmann, 27, 1, 28, LINK)"
12854,1,7,4,11,"(ddbd87e31045196dd999f55fc65c4b38edcf2f68, 2018-11-14 22:36:54 -0800, Teng Li, 7, 4, 11, LINK)"
12876,1,5,6,11,"(2a6431ba2d3343d19364cd57538cf485a7206d04, 2018-10-25 08:49:37 -0700, Pieter Noordhuis, 5, 6, 11, LINK)"
1288,1,26,10,36,"(036c3f93af1b94bb133fe5db7b50f48672b9171c, 2017-05-25 00:35:19 -0400, Sam Gross, 26, 10, 36, LINK)"
12906,1,53,4,57,"(db0b5c7ab7f6bbb3c69b388f53dc806d86f6b639, 2018-10-29 13:53:46 -0700, James Reed, 53, 4, 57, LINK)"
12918,1,3,6,9,"(49cd83d7356aa40b3223866adab8a7d823f2c9f4, 2020-01-23 14:43:32 -0800, Denis Akhiyarov, 3, 6, 9, LINK)"
12921,1,4,1,5,"(2d9b1fcd093bfd4680c9db846afed2c1bf51cd5b, 2018-10-24 20:10:03 -0700, Teng Li, 4, 1, 5, LINK)"
1297,1,7,2,9,"(b3589b04fd371cbaba7673cec538d3f37576d413, 2017-07-05 01:25:39 -0300, Bruno Alexandre Rosa, 7, 2, 9, LINK)"
13,3,4170,3494,7664,"(0b93974075844601913c6df50f6566418a35eee8, 2021-02-25 14:32:13 -0800, Akao Kazutoshi, 2, 2, 4, LINK), (cd5adc7b5f7a5d4415a936c5ceca219f14dbb319, 2018-07-26 10:11:53 -0700, Jerry Zhang, 4167, 3491, 7658, LINK), (4664808938b22c22abd216008926ecd81cb0c5e5, 2017-09-24 17:07:30 -0700, Igor Sugak, 1, 1, 2, LINK)"
1301,1,1,1,2,"(d278344e36dde4170da4e4d0c45953dcb53dcf65, 2018-09-13 10:35:53 -0700, Lu Fang, 1, 1, 2, LINK)"
13022,4,1629,316,1945,"(28b1f586f669c6c14d5eabffa162b59f0f4d853d, 2019-10-04 08:51:03 -0700, Vincent Quenneville-Belair, 401, 92, 493, LINK), (939ae80de14deb87ae2fd5f90f32e5d504689bbb, 2019-09-13 07:31:35 -0700, Vincent Quenneville-Belair, 436, 91, 527, LINK), (7578c91abe644003f69716b664df888a5f4c15d6, 2019-09-12 15:25:19 -0400, Vincent Quenneville-Belair, 436, 91, 527, LINK), (096ee8467cffda68f0ed12a1266cb0010081b809, 2018-12-18 16:40:23 -0800, Chandler Zuo, 356, 42, 398, LINK)"
1307,1,1,1,2,"(e3d12d7afb6d92e2b43fad016e8d851161af6a12, 2018-08-24 10:46:15 -0700, Lu Fang, 1, 1, 2, LINK)"
1310,1,1,1,2,"(e3d12d7afb6d92e2b43fad016e8d851161af6a12, 2018-08-24 10:46:15 -0700, Lu Fang, 1, 1, 2, LINK)"
13200,1,17,19,36,"(e475d3ede37cfec2892cf7e94a3109b6ec1b3cde, 2018-10-31 00:41:55 -0700, Teng Li, 17, 19, 36, LINK)"
13209,1,15,2,17,"(52b6460d3aa2714efc1831ed76159d24585481fe, 2018-10-29 10:21:14 -0700, Sam Gross, 15, 2, 17, LINK)"
13229,1,24,27,51,"(195cba500f2c98c10f3d4b8fc3cca6493099b6df, 2019-03-18 20:51:12 -0700, Lutz Roeder, 24, 27, 51, LINK)"
13254,1,52,57,109,"(751b5ea94103105e9a2617a2eddafc830cd0104d, 2018-11-19 09:18:45 -0800, ArmenAg, 52, 57, 109, LINK)"
13273,2,811,180,991,"(a0263ec04765fb9b20decc178241d2668ea58cee, 2019-04-15 12:24:43 -0700, Pieter Noordhuis, 221, 180, 401, LINK), (bdfdf6c2b936bc5ae34c6fe52dfbb92847ae4205, 2019-04-01 14:27:03 -0700, Pieter Noordhuis, 590, 0, 590, LINK)"
13292,1,70,54,124,"(6bfce168730985821687f6adfc643d424e60cb52, 2018-11-07 19:51:37 -0800, Wei Yang, 70, 54, 124, LINK)"
13324,1,13,2,15,"(e4bb56570c7d6c7e17a85cbface4828c62a33564, 2018-11-16 08:37:05 -0800, Brian Vaughan, 13, 2, 15, LINK)"
13326,1,117,89,206,"(6d2b3cc869d2d39832800e8127cb66abf3589311, 2018-11-01 19:04:17 -0700, Tongzhou Wang, 117, 89, 206, LINK)"
1337,1,27,11,38,"(b5868b2833332a23fa0a84bfb1169f7521728e8d, 2020-05-13 22:20:58 -0700, SsnL, 27, 11, 38, LINK)"
13376,1,21,2,23,"(f9c0a08eed723ac14378422f066e6ee1be3854a2, 2018-10-31 13:11:01 -0700, David Riazati, 21, 2, 23, LINK)"
13384,2,324,330,654,"(8408dff55af59cc264b0f55db8a8584241d7274c, 2018-11-27 11:30:41 -0800, Thomas Viehmann, 172, 44, 216, LINK), (e988dc621bc354598bd0ae5b5674a3edd31a046d, 2018-11-05 06:27:24 -0800, Adam Paszke, 152, 286, 438, LINK)"
13386,1,161,441,602,"(c19af59a6edd9567d5fb5712ca22cc8e22c7f8fc, 2018-11-27 09:36:11 -0800, Jan Schlüter, 161, 441, 602, LINK)"
13404,1,10,0,10,"(895cb8fcea85d1879ab04599487a678f3b8b61d7, 2018-12-12 19:51:34 -0800, Tyler Moncur, 10, 0, 10, LINK)"
13409,1,146,1,147,"(b1529eeadb531a2454ec8c851f70034b59664df7, 2019-01-04 13:01:49 -0800, Elias Ellison, 146, 1, 147, LINK)"
1344,1,2,1,3,"(c39216f8c49361456d7d827b6199ac54799ff2e2, 2018-09-06 17:25:06 -0700, Lu Fang, 2, 1, 3, LINK)"
13540,1,23,13,36,"(246d5282b39f9536249bb85127f90857c976fa8d, 2018-11-04 20:25:49 -0800, albanD, 23, 13, 36, LINK)"
13545,1,11,0,11,"(8045b3eb143ed70ab1873e148d266d56e0e1481f, 2019-03-11 08:07:22 -0700, Nicki Skafte, 11, 0, 11, LINK)"
13559,1,101,21,122,"(0a090fe60a2a2c716a1d709c4236d1c9ca6ebd38, 2018-11-08 12:00:54 -0800, vishwakftw, 101, 21, 122, LINK)"
13560,1,17,3,20,"(6cf450744fd9eee73a55d0aa961d3cce56f83c65, 2018-11-06 16:26:40 -0800, Elias Ellison, 17, 3, 20, LINK)"
13564,1,54,16,70,"(9403eddce41b16ededf6ce72ae5a427c30afadc6, 2018-11-07 09:20:04 -0800, Peter Goldsborough, 54, 16, 70, LINK)"
13566,1,46,1,47,"(9ffabcfcaac0df8ec0e183430945d95c772ff5c3, 2018-11-09 06:22:11 -0800, Thomas Viehmann, 46, 1, 47, LINK)"
1357,1,11,0,11,"(8ca7bf2ab3b1eb474a481e3a6673312d0b63f4a6, 2017-04-26 15:00:41 -0400, Sam Gross, 11, 0, 11, LINK)"
13573,2,161,49,210,"(2cc35c161ada1fb5e27b7ed9472c21a00c981d89, 2018-11-27 10:41:06 -0800, Pieter Noordhuis, 78, 39, 117, LINK), (bb301a431da886d994fb0155185ab7567d71279d, 2018-11-20 21:10:18 -0800, Teng Li, 83, 10, 93, LINK)"
13574,1,41,0,41,"(b807970aeaf3bd26068f347a01196b66c0a21bb5, 2018-11-19 18:25:00 -0800, Teng Li, 41, 0, 41, LINK)"
1358,1,3,4,7,"(ba1dba45f70876eb243ee293050b47425c37c94d, 2017-10-20 15:37:15 -0700, Yangqing Jia, 3, 4, 7, LINK)"
13622,1,12,4,16,"(7978ba45ba85d03091b99b375dfb82cf88518c51, 2018-11-07 14:27:06 -0800, Peter Goldsborough, 12, 4, 16, LINK)"
13634,1,36,14,50,"(5151d33287384cef9a0111a0525ff2db59829814, 2018-11-13 21:03:00 -0800, Peter Goldsborough, 36, 14, 50, LINK)"
1368,1,2,1,3,"(c39216f8c49361456d7d827b6199ac54799ff2e2, 2018-09-06 17:25:06 -0700, Lu Fang, 2, 1, 3, LINK)"
1371,2,7,1,8,"(c39216f8c49361456d7d827b6199ac54799ff2e2, 2018-09-06 17:25:06 -0700, Lu Fang, 2, 1, 3, LINK), (f0ca857e6b237b8e2e1cc18a9a4deccdd2ff8895, 2017-10-23 14:56:13 -0700, Yangqing Jia, 5, 0, 5, LINK)"
1374,1,2,1,3,"(c39216f8c49361456d7d827b6199ac54799ff2e2, 2018-09-06 17:25:06 -0700, Lu Fang, 2, 1, 3, LINK)"
13750,1,24,6,30,"(2d6f039766193623dbf17c46bfcd17bb8c8bdb32, 2018-11-26 17:05:17 -0800, Teng Li, 24, 6, 30, LINK)"
13773,1,12,1,13,"(a17c0118a52d34c97ab48bae416ae1896ad14e56, 2018-11-12 22:02:28 -0800, Ailing Zhang, 12, 1, 13, LINK)"
13867,2,38,16,54,"(eb531da9a8e8014338ba2a7417a3ff2d9c084de3, 2019-01-16 12:15:12 -0800, Thomas Viehmann, 19, 8, 27, LINK), (d33e7d12367db4a7ec8ed920563411b5584dd106, 2019-01-16 12:15:12 -0800, Thomas Viehmann, 19, 8, 27, LINK)"
13899,1,32,0,32,"(21696502ffd225e4d5fef0a30082090386e54eaf, 2019-02-15 15:00:59 -0800, Elias Ellison, 32, 0, 32, LINK)"
13907,1,23,0,23,"(ff4f4a0a35de5b31b0ef7a4a3391c651afb8064d, 2018-11-14 15:04:19 -0800, Pieter Noordhuis, 23, 0, 23, LINK)"
13909,1,17,1,18,"(c3680e2b19174fea3726d9175715e0e853c96265, 2018-11-13 16:41:28 -0800, Sam Gross, 17, 1, 18, LINK)"
1391,1,1,1,2,"(d278344e36dde4170da4e4d0c45953dcb53dcf65, 2018-09-13 10:35:53 -0700, Lu Fang, 1, 1, 2, LINK)"
13913,1,12,2,14,"(96e5d23bad20be60900e2133d912cdd2190caaa8, 2018-11-16 12:59:01 -0800, jjsjann123, 12, 2, 14, LINK)"
13969,1,65,155,220,"(2d56df7892ff6588da3fd079ee95d679644d6730, 2018-12-04 13:58:31 -0800, Thomas Viehmann, 65, 155, 220, LINK)"
13971,1,22,1,23,"(c7e0db140ef7cb65ed0d391c4f2849a803f3d52f, 2018-11-15 13:21:59 -0800, Thomas Viehmann, 22, 1, 23, LINK)"
14002,1,107,35,142,"(8f4dc192b6331533f56fc23a86fa055ee4d580c0, 2018-11-15 17:09:40 -0800, Peter Goldsborough, 107, 35, 142, LINK)"
14025,1,2,2,4,"(cf059028f047001ad13bdd04b66d55e94d390e3f, 2018-11-29 11:15:03 -0800, Your Name, 2, 2, 4, LINK)"
14026,1,6,6,12,"(1256cbaa6936ecae4db290b3f7af1923da5ba89a, 2018-11-16 11:36:06 -0800, Thomas Viehmann, 6, 6, 12, LINK)"
14057,1,10,4,14,"(88f70a16708369ad5d179fbe515f43739c0f2591, 2019-04-18 12:07:17 -0700, Ailing Zhang, 10, 4, 14, LINK)"
14063,1,18,11,29,"(45fd77d3b7aef27620d924019f6eb0f71cd338e9, 2018-11-15 22:29:15 -0800, Teng Li, 18, 11, 29, LINK)"
1407,1,1,1,2,"(d278344e36dde4170da4e4d0c45953dcb53dcf65, 2018-09-13 10:35:53 -0700, Lu Fang, 1, 1, 2, LINK)"
14078,1,6,3,9,"(eeb3e67eebbdc8fcb4d7063ee07ec912bda790f6, 2018-11-16 18:02:13 -0800, Teng Li, 6, 3, 9, LINK)"
14080,1,123,13,136,"(a38ed0268e72905cf350a2de3fd9521d4cc2df07, 2018-11-28 00:31:34 -0800, Teng Li, 123, 13, 136, LINK)"
14093,1,222,0,222,"(8c9caf185be66b996df5caf4b37a0e902ae3ca41, 2019-04-05 18:13:39 -0700, Gao Xiang, 222, 0, 222, LINK)"
14099,1,13,12,25,"(6e453e56f991d43ff9d0eac715020b7ef877ca77, 2018-12-06 23:55:34 -0800, Jon Crall, 13, 12, 25, LINK)"
14104,1,4,1,5,"(5fe26976559490a99cb60a0dd2e457c1fdda65ba, 2019-01-08 22:24:37 -0800, Yinghai Lu, 4, 1, 5, LINK)"
14170,1,5,3,8,"(17432a1051af457d1ef48310d64c2b45b5a1b238, 2018-11-20 23:27:16 -0800, Tongzhou Wang, 5, 3, 8, LINK)"
14188,1,94,26,120,"(6f2307ba6ac802f4c4650cd21869e49d1845188d, 2018-11-27 17:33:54 -0800, Peter Goldsborough, 94, 26, 120, LINK)"
14272,1,44,6,50,"(c71ce10cfcd1a5673a5f99a0b6b94707dc156724, 2020-09-14 20:34:09 -0700, Vitaliy Chiley, 44, 6, 50, LINK)"
14276,1,50,22,72,"(f639249d51562ce90a29ba15584b7a916a39569f, 2018-11-26 17:04:51 -0800, Peter Goldsborough, 50, 22, 72, LINK)"
14310,1,95,41,136,"(86af14b0c7a9f6fd96ad62a61ce2b6b105761fe1, 2019-01-10 21:41:48 -0800, Syed Tousif Ahmed, 95, 41, 136, LINK)"
14314,1,40,20,60,"(7c08f1083e56ce7e9799a15b36947c46052f0058, 2019-01-14 04:24:50 -0800, SsnL, 40, 20, 60, LINK)"
14317,1,5,2,7,"(3ab208004727c9c63d1170c537442963debaa6e1, 2019-02-22 16:56:06 -0800, Gemfield, 5, 2, 7, LINK)"
14335,1,92,38,130,"(29f096cc70cf9cc1a317ae7107228215b7dde60b, 2019-02-11 12:26:47 -0800, Thomas Viehmann, 92, 38, 130, LINK)"
14344,1,17,4,21,"(68251fb93196a4c28a0c9f9ce37896b21c6c04e0, 2018-11-28 06:11:08 -0800, Francisco Massa, 17, 4, 21, LINK)"
14355,1,12,4,16,"(478eb70c07ea54688b30242a76fb349e3c172dcf, 2018-12-07 16:37:30 -0800, Daniel Bermond, 12, 4, 16, LINK)"
14376,1,85,12,97,"(0f62af4ab1883cd59f4dfd71945c9755dc138644, 2018-11-28 11:32:47 -0800, Pieter Noordhuis, 85, 12, 97, LINK)"
14390,1,4,2,6,"(ffbc3905a18508ec0d97d54ae5c82c65ebe796f3, 2018-11-27 12:32:56 -0800, Teng Li, 4, 2, 6, LINK)"
14394,1,152,0,152,"(220ce8046e5fcf1434f948795bcdefda33e95e9a, 2018-11-29 20:03:59 -0800, Pieter Noordhuis, 152, 0, 152, LINK)"
14401,2,26,16,42,"(3486cebd8736d5f9ea687b29d122903b57e2adf4, 2019-01-08 22:23:10 -0800, Thomas Viehmann, 13, 8, 21, LINK), (c93cf89de21ff40d544f2091ea2cdcca629c4353, 2019-01-08 22:23:10 -0800, Thomas Viehmann, 13, 8, 21, LINK)"
1441,1,89,59,148,"(743e4894d2865108dc0ea2a1f344d9f34eb2b29d, 2017-05-03 11:14:10 -0400, Edward Z. Yang, 89, 59, 148, LINK)"
14410,2,2,2,4,"(30aed0237d4466160e813ad2fdd414cc0855d883, 2018-12-23 19:47:03 -0800, peter, 1, 1, 2, LINK), (f8a56bf476e9d0be02a605ba272f7d034c5a1b28, 2018-12-23 19:47:03 -0800, peter, 1, 1, 2, LINK)"
14433,1,85,12,97,"(0f62af4ab1883cd59f4dfd71945c9755dc138644, 2018-11-28 11:32:47 -0800, Pieter Noordhuis, 85, 12, 97, LINK)"
14445,1,5,5,10,"(7d07fcd2152bacd16fd76494da0ec15774d881d1, 2018-11-27 21:56:25 -0800, Teng Li, 5, 5, 10, LINK)"
14446,1,77,15,92,"(0d3cb91d8c8c1bb368128378e2300f96e9217344, 2018-11-29 18:46:22 -0800, Teng Li, 77, 15, 92, LINK)"
1447,1,61,10,71,"(80c0a8776bee6e42ddb07e4dcb19c561fc7a8e61, 2017-05-03 17:53:45 -0400, Edward Z. Yang, 61, 10, 71, LINK)"
14470,1,12,18,30,"(1921816f85b6db978175de5029bab03f29718d8d, 2018-12-04 07:02:01 -0800, Richard Zou, 12, 18, 30, LINK)"
14483,3,1098,709,1807,"(8812a5d42e7be858334a4f5bd6acc7e6e942815f, 2018-12-04 00:13:24 -0800, Adam Paszke, 536, 354, 890, LINK), (68ffe469918a5eaa014e230efe81af9c298857aa, 2018-12-03 13:41:05 -0800, Adam Paszke, 536, 354, 890, LINK), (31b3d81714653750129a120f6bcf1de34187f40a, 2018-11-29 13:02:15 -0800, Adam Paszke, 26, 1, 27, LINK)"
14501,1,37,39,76,"(4aae89fa7ba9f47cfa1cd20d19aca03a33e6ea2f, 2019-01-25 07:24:18 -0800, SsnL, 37, 39, 76, LINK)"
14502,1,1,1,2,"(db15f2e13f58823f487639f7934e3c21d0a2864d, 2018-11-28 20:25:21 -0800, Peter Goldsborough, 1, 1, 2, LINK)"
14507,1,24,4,28,"(fb22f76eb6eae224469493b26d88b87fe5455fa7, 2018-12-28 11:51:26 -0800, SsnL, 24, 4, 28, LINK)"
1452,1,2,1,3,"(f9d1b63d18b91888cdaedc5cb9f39c63d4f822e7, 2018-10-18 16:15:12 -0700, Lu Fang, 2, 1, 3, LINK)"
14528,1,88,18,106,"(9127ab386602d5b6509246332e71c63e6b741a25, 2018-11-29 19:55:34 -0800, Teng Li, 88, 18, 106, LINK)"
14536,1,21,34,55,"(11ef5191ff1336b30aaba5971cfde007ba9f18ea, 2018-11-29 21:36:51 -0800, Pieter Noordhuis, 21, 34, 55, LINK)"
14537,1,7,2,9,"(37627a182ba7af6ee388338d06af5c69d7ba6c59, 2018-11-29 23:34:23 -0800, Soumith Chintala, 7, 2, 9, LINK)"
14555,1,1,1,2,"(67dcf10631d4854657d3f42e4c7611567039c44c, 2018-12-05 17:15:51 -0800, Pieter Noordhuis, 1, 1, 2, LINK)"
14571,1,2,0,2,"(793b3026534aa284f743886fc3c3ae936b5c1a98, 2019-06-05 13:28:28 -0700, Brian Vaughan, 2, 0, 2, LINK)"
14582,1,475,11,486,"(1cdcdd78af84ee60777db9b8cd0fc9bb7d441975, 2019-02-15 14:51:56 -0800, Josh Varty, 475, 11, 486, LINK)"
14589,1,1,0,1,"(c02b3e7cea7e70d132cab164a8e875a330a081e7, 2018-12-05 17:07:26 -0800, Pieter Noordhuis, 1, 0, 1, LINK)"
14590,1,9,1,10,"(1975917d0e6ba5580b2f14cfa8dd70b2592c6d3b, 2018-11-29 20:30:02 -0800, James Reed, 9, 1, 10, LINK)"
14610,1,2,2,4,"(86ffc2a5f1f004f586526e4c2a7c2f11ed9ea633, 2018-12-04 08:34:04 -0800, Ailing Zhang, 2, 2, 4, LINK)"
14663,1,8,0,8,"(35c8f93fd238d42aaea8fd6e730c3da9e18257cc, 2018-12-01 16:47:57 -0800, peter, 8, 0, 8, LINK)"
14673,1,11,1,12,"(2d958b7f7745acbe6bd72a4de1781b0b16861095, 2018-12-05 08:27:00 -0800, Francisco Massa, 11, 1, 12, LINK)"
14674,1,3,1,4,"(7bc489c827b4b1924901520e1e03b04ecfb88471, 2018-12-04 08:53:38 -0800, Adam Paszke, 3, 1, 4, LINK)"
14676,2,62,6,68,"(7da2448d6276370edde67ef22582613d819de2c3, 2018-12-03 09:37:16 -0800, Pieter Noordhuis, 56, 5, 61, LINK), (74c3cbc013d61b3622faac7aaf21aff9b7adb360, 2018-12-02 17:41:36 -0800, Pieter Noordhuis, 6, 1, 7, LINK)"
14678,1,31,16,47,"(cac03280f973b7d4698678a863bd2f982491fd7e, 2018-12-03 12:01:18 -0800, Teng Li, 31, 16, 47, LINK)"
14703,1,1,0,1,"(c02b3e7cea7e70d132cab164a8e875a330a081e7, 2018-12-05 17:07:26 -0800, Pieter Noordhuis, 1, 0, 1, LINK)"
14704,1,30,23,53,"(02d149b767e3f5f64a42d7305a8882d0b40fd5ea, 2018-12-11 11:14:50 -0800, James Sun, 30, 23, 53, LINK)"
14727,1,17,12,29,"(5498a15d1040d95d679b6bc2ca90ac95dc6c58e5, 2019-10-17 20:35:55 -0700, Will Feng, 17, 12, 29, LINK)"
14732,1,65,155,220,"(2d56df7892ff6588da3fd079ee95d679644d6730, 2018-12-04 13:58:31 -0800, Thomas Viehmann, 65, 155, 220, LINK)"
1475,1,1,1,2,"(e4bb22ebbfe999efd2d8a48a68d0845b63335fd9, 2017-11-15 13:46:06 -0800, Yangqing Jia, 1, 1, 2, LINK)"
1476,1,18,3,21,"(625850c2c2f28c67881dc24f5d3abb80fd6e8483, 2017-05-19 01:55:09 -0400, Sam Gross, 18, 3, 21, LINK)"
148,1,5,0,5,"(1e0171f4364d8e26aafc014500532db23002ced7, 2017-08-28 12:42:56 -0700, Priya Goyal, 5, 0, 5, LINK)"
14801,2,68,47,115,"(7dc06810c2baeec11602c48ca7b73f0b6abaaff3, 2018-12-16 21:50:43 -0800, peter, 34, 23, 57, LINK), (d71fac20ebf6b393e464d312b8a38ae1c45c3386, 2018-12-16 21:50:43 -0800, peter, 34, 24, 58, LINK)"
14805,1,17,3,20,"(3a47d5694691642c730bf99ccbcaa81f09fcb60e, 2019-02-21 16:05:16 -0800, Soumith Chintala, 17, 3, 20, LINK)"
1482,1,30,17,47,"(e694db0eeb3ff380b476e92710475efc4551c826, 2017-05-08 23:14:11 +0200, Luca Antiga, 30, 17, 47, LINK)"
1483,1,15,2,17,"(335c7dc6812ae8224a96d73f9f41d725be658ff0, 2017-11-20 16:10:41 -0800, Pieter Noordhuis, 15, 2, 17, LINK)"
14859,2,4,0,4,"(74433436e87d89415e424ff967632893a2431466, 2018-12-07 07:25:55 -0800, vishwakftw, 2, 0, 2, LINK), (1c9df7facf1d280e72297654dbf32163e4f0e790, 2018-12-07 07:25:55 -0800, vishwakftw, 2, 0, 2, LINK)"
1488,1,2,1,3,"(1a83c372ecb0c81bdd5110c516cc6e9f9554a469, 2017-09-20 00:20:37 -0400, randxie, 2, 1, 3, LINK)"
14891,2,138,42,180,"(4909529584036cc989e6076db36fbba3a5bcacdc, 2018-12-11 22:38:14 -0800, Peter Goldsborough, 69, 21, 90, LINK), (0dade9862c62a427e5d48d74b1316a079c107726, 2018-12-11 22:38:14 -0800, Peter Goldsborough, 69, 21, 90, LINK)"
1494,1,2,1,3,"(f9d1b63d18b91888cdaedc5cb9f39c63d4f822e7, 2018-10-18 16:15:12 -0700, Lu Fang, 2, 1, 3, LINK)"
14954,1,8,16,24,"(8c6ff91d571c34e40ee12dbfe16499b2df2f7440, 2018-12-26 12:54:17 -0800, derek, 8, 16, 24, LINK)"
14984,4,52,8,60,"(95fd0afed5b0078ec3d9343c2d6690106dd5d2f2, 2018-12-11 13:36:00 -0800, Josef Lindman Hörnlund, 13, 2, 15, LINK), (04b65dfd1ff78cdda327aeb6ad33ce1bb444fb9d, 2018-12-11 13:36:00 -0800, Josef Lindman Hörnlund, 13, 2, 15, LINK), (95fd0afed5b0078ec3d9343c2d6690106dd5d2f2, 2018-12-11 13:36:00 -0800, Josef Lindman Hörnlund, 13, 2, 15, REGEX), (04b65dfd1ff78cdda327aeb6ad33ce1bb444fb9d, 2018-12-11 13:36:00 -0800, Josef Lindman Hörnlund, 13, 2, 15, REGEX)"
1499,1,4,0,4,"(2752ad8045c59c4eafe45fe94b6672cb436da523, 2018-11-29 16:29:46 -0800, Lu Fang, 4, 0, 4, LINK)"
15015,2,12,6,18,"(84cf1660d2e09edfacd3dbcdcb97993809a21eca, 2018-12-13 20:30:40 -0800, vishwakftw, 6, 3, 9, LINK), (81644ed9abbc1690833ea4466a938c04ca584e65, 2018-12-13 20:30:40 -0800, vishwakftw, 6, 3, 9, LINK)"
15038,2,56,2,58,"(228f73e7a94e75613b8a7bdc1d58a60600805288, 2018-12-12 09:37:10 -0800, Richard Zou, 28, 1, 29, LINK), (0ad39ec5c17864fc7aec2605c82fe82fba71e3c2, 2018-12-12 09:37:10 -0800, Richard Zou, 28, 1, 29, LINK)"
15052,2,198,18,216,"(274e7552378664eddabf2f3336093240c7f4f869, 2018-12-17 20:28:00 -0800, James Sun, 99, 9, 108, LINK), (e37a22128eca7ccac6e289659587a9e1bfe6d242, 2018-12-17 20:28:00 -0800, James Sun, 99, 9, 108, LINK)"
15058,2,40,8,48,"(ab1cd6241b97ae95c767e9274e23a854d057093f, 2018-12-13 09:38:40 -0800, vishwakftw, 20, 4, 24, LINK), (214f46faf5c5dddb073e09205d047aead814b0c6, 2018-12-13 09:38:40 -0800, vishwakftw, 20, 4, 24, LINK)"
15060,1,170,25,195,"(a47749cb28bb630bc99601a64e24ad453d9583a9, 2018-12-20 14:09:09 -0800, Gao Xiang, 170, 25, 195, LINK)"
15089,1,29,24,53,"(73d7ecd18398cf121a9a2ff2faad302d429bef3e, 2019-02-10 19:28:50 -0800, Hameer Abbasi, 29, 24, 53, LINK)"
1509,1,1,1,2,"(f53d5e0a756165d1719edfef5cf9788458042a56, 2018-10-16 10:18:54 -0700, Lu Fang, 1, 1, 2, LINK)"
1511,1,2,1,3,"(f9d1b63d18b91888cdaedc5cb9f39c63d4f822e7, 2018-10-18 16:15:12 -0700, Lu Fang, 2, 1, 3, LINK)"
15119,2,34,0,34,"(c19b16cc99a742ea73a55b3ce16502b618766805, 2018-12-12 11:32:05 -0800, Richard Zou, 17, 0, 17, LINK), (b34ab435efd9b4d839171d27bd6a0f321178d46b, 2018-12-12 11:32:05 -0800, Richard Zou, 17, 0, 17, LINK)"
15135,1,13,1,14,"(1dbc7cff3e654af6d74ebbfb81c6f045c45d7182, 2018-12-17 13:08:03 -0800, David Riazati, 13, 1, 14, LINK)"
15156,2,72,0,72,"(20296297ca0a7315e77aeccb03df1b0609cac2ab, 2018-12-17 15:18:15 -0800, peter, 36, 0, 36, LINK), (216ab259fb5142c20c9e5aef74accb4fe112858a, 2018-12-17 15:18:15 -0800, peter, 36, 0, 36, LINK)"
1518,1,2,1,3,"(f9d1b63d18b91888cdaedc5cb9f39c63d4f822e7, 2018-10-18 16:15:12 -0700, Lu Fang, 2, 1, 3, LINK)"
1521,1,3,0,3,"(6a46863c833c11ea33976eb67091d323135d0315, 2017-05-15 10:21:59 -0700, Edward Z. Yang, 3, 0, 3, LINK)"
15214,1,2,2,4,"(3a6d473b49fc04dc1f086ee7bd8f0a90578e8de6, 2018-12-20 16:53:49 -0800, surgan12, 2, 2, 4, LINK)"
15216,1,33,17,50,"(d42e90991bf93fcce9fae3f5edeb925876900bfc, 2019-01-03 12:14:17 -0800, Zachary DeVito, 33, 17, 50, LINK)"
15223,2,22,2,24,"(fe098a3605965ca9bd73224ab198293d367a7463, 2019-01-08 12:34:43 -0800, Richard Zou, 11, 1, 12, LINK), (196eee6ccd9bbab46d712c863265a433832b8f9c, 2019-01-08 12:34:43 -0800, Richard Zou, 11, 1, 12, LINK)"
1524,2,7,10,17,"(f9d1b63d18b91888cdaedc5cb9f39c63d4f822e7, 2018-10-18 16:15:12 -0700, Lu Fang, 2, 1, 3, LINK), (c57f0530e73da090a12a8ca9bcf26a8edda1df3e, 2017-05-18 18:31:36 -0500, Po-Hsien Chu, 5, 9, 14, LINK)"
15240,3,39,30,69,"(7d3e2fa1908336cb1eed80fb9537cd9971a3a119, 2018-12-21 15:59:29 -0800, David Riazati, 13, 10, 23, LINK), (1dcf2ea0963ece881cd95841e1db8ac920544e15, 2018-12-21 15:59:29 -0800, David Riazati, 13, 10, 23, LINK), (5e624948b65ff32f927eed7e4fa1002b4113f8c1, 2018-12-20 02:25:20 -0800, David Riazati, 13, 10, 23, LINK)"
15271,1,16,1,17,"(8ab4d348f464fe9bf28bf6cbf518f97a65efae1b, 2019-01-23 21:32:57 -0800, Lu Fang, 16, 1, 17, LINK)"
15278,1,30,1,31,"(956cabd8875ad15a7707376e8f313e58ca884329, 2019-01-25 15:02:30 -0800, Elias Ellison, 30, 1, 31, LINK)"
15281,2,6,0,6,"(98bc784694e1811fe57c17d858fdb1b83998fb95, 2018-12-17 14:38:46 -0800, David Riazati, 3, 0, 3, LINK), (df4c9471eccb16f6f1c2966803d16f86187e9ed7, 2018-12-17 14:38:46 -0800, David Riazati, 3, 0, 3, LINK)"
153,1,27,0,27,"(97bc100b920b41740c2e20b8ebf6aeb03676ed5f, 2017-10-31 21:43:02 -0400, Sam Gross, 27, 0, 27, LINK)"
15308,2,30,0,30,"(a9cf3f69abf2c13be5585488cd555abe33cd8187, 2019-01-08 07:26:15 -0800, Richard Zou, 15, 0, 15, LINK), (8f11147d43386acec2642a23cf08710ee0ab1af5, 2019-01-08 07:26:15 -0800, Richard Zou, 15, 0, 15, LINK)"
15319,1,6,3,9,"(667763a63add80ac136dc5c138d6f79509744643, 2019-03-08 10:29:51 -0800, David Riazati, 6, 3, 9, LINK)"
1532,2,63,42,105,"(22949350b6e853f4dc881491e6726d5b2a398107, 2017-05-30 09:34:50 -0700, Christian Sarofeen, 45, 28, 73, LINK), (db620304b2bcbaf14ca643220b42aeff717e37ec, 2017-05-30 09:34:50 -0700, Christian Sarofeen, 18, 14, 32, LINK)"
15328,2,12,46,58,"(9c863c1952853209883daf772dcb864ec7bf3b4d, 2018-12-26 08:29:57 -0800, vishwakftw, 6, 23, 29, LINK), (5ac95758e2d9362f21a33c6846da37804184e198, 2018-12-26 08:29:57 -0800, vishwakftw, 6, 23, 29, LINK)"
15330,2,20,8,28,"(8ca4fc3fd29e4af483a6d55936a6ef240cf10297, 2018-12-26 00:46:13 -0800, peter, 10, 4, 14, LINK), (6e4be0af2e7f36d4aa65819214ddbd93ab5ac4f6, 2018-12-26 00:46:13 -0800, peter, 10, 4, 14, LINK)"
15338,1,46,7,53,"(b52420742d70f01ed79ce9e55ec476f30c6e9423, 2019-01-01 23:09:45 -0800, surgan12, 46, 7, 53, LINK)"
15344,1,4,1,5,"(614121c1ef6a34e7653f43cb9be89c28d6766b19, 2018-12-21 09:37:25 -0800, Ashwin Ramaswami, 4, 1, 5, LINK)"
15346,1,18,6,24,"(d9cad71b36b678ea70ad2df29578a0aa985cbc3d, 2018-12-21 11:29:36 -0800, vishwakftw, 18, 6, 24, LINK)"
15353,2,50,28,78,"(7b40d9c7ff1a1841c724bddd5476824d68edcdd1, 2019-01-03 10:42:35 -0800, Ailing Zhang, 25, 14, 39, LINK), (78442f04fc60fd3f6fa5be70d3507811d6b11fd9, 2019-01-03 10:42:35 -0800, Ailing Zhang, 25, 14, 39, LINK)"
1541,1,1,1,2,"(2acfb2376aa3e88883ad85a165ef649e0b3faf98, 2017-05-21 20:27:48 +0300, Dmitry Ulyanov, 1, 1, 2, LINK)"
1543,1,1,1,2,"(639d1c7c5e738baef49cb3291ffa91d39a7da604, 2018-02-19 01:35:28 -0500, Marat Dukhan, 1, 1, 2, LINK)"
15462,1,24,27,51,"(195cba500f2c98c10f3d4b8fc3cca6493099b6df, 2019-03-18 20:51:12 -0700, Lutz Roeder, 24, 27, 51, LINK)"
15464,2,2,2,4,"(4c964dac7f733a530156b0242de362cb555fcb57, 2018-12-21 11:32:02 -0800, surgan12, 1, 1, 2, LINK), (7e2ec2488677776d58a45c4fcdc37d89ffe46462, 2018-12-21 11:32:02 -0800, surgan12, 1, 1, 2, LINK)"
15476,1,22,26,48,"(3d3bff5ff1bc277306d15a3caa96c2a6fdb924bb, 2019-10-16 09:17:39 -0700, Peter Bell, 22, 26, 48, LINK)"
15478,1,128,0,128,"(4fb39318963fd6ac64d4fc312d850004858641da, 2019-01-14 15:44:50 -0800, Elias Ellison, 128, 0, 128, LINK)"
1549,1,180,36,216,"(ba885a1a51776823609159fda24276563dc1fdde, 2017-05-15 12:36:15 -0500, Po-Hsien Chu, 180, 36, 216, LINK)"
15497,2,22,0,22,"(033ae1598fe8d89e74bbaacd15aab710c928dc26, 2018-12-25 21:43:22 -0800, peter, 11, 0, 11, LINK), (2ed95c58713b45a6a9dac4336135523555bc58a9, 2018-12-25 21:43:22 -0800, peter, 11, 0, 11, LINK)"
15505,1,47,0,47,"(0fff5b361215168ddc1335bb9e6be580f0922279, 2018-12-27 15:35:24 -0800, Elias Ellison, 47, 0, 47, LINK)"
15508,1,11,5,16,"(a478d416203b0e3934e2b1aaa6e05d838be748e7, 2019-03-05 14:26:20 -0800, Soumith Chintala, 11, 5, 16, LINK)"
15511,1,153,170,323,"(595f767880244979da6dcf22f6f032865ecb1718, 2019-01-17 10:12:47 -0800, Gregory Chanan, 153, 170, 323, LINK)"
15519,2,18,10,28,"(a4e2d27ddbe7bd90c0e0d4d2608067076afc4de2, 2018-12-26 19:43:10 -0800, Ailing Zhang, 9, 5, 14, LINK), (4d029bba7fdef1d7935c3eaf88eda819f9191470, 2018-12-26 19:43:10 -0800, Ailing Zhang, 9, 5, 14, LINK)"
15530,1,3,3,6,"(cdaeb0db545d50ee98d5dd1186ae258cbc744a86, 2019-01-09 22:17:45 -0800, an-kumar, 3, 3, 6, LINK)"
15537,1,37,6,43,"(a7415787ace8090c5f480a4fb6233437a3f4327e, 2019-01-13 23:07:16 -0800, kyryl, 37, 6, 43, LINK)"
1554,1,4,0,4,"(2752ad8045c59c4eafe45fe94b6672cb436da523, 2018-11-29 16:29:46 -0800, Lu Fang, 4, 0, 4, LINK)"
15567,1,15,2,17,"(ed0a761c824d5e325e39afe954f92cc14c3c88c1, 2019-01-18 07:56:17 -0800, Richard Zou, 15, 2, 17, LINK)"
15568,1,65,22,87,"(1154506533bfe9428600fd69fa2e71dd172b7fec, 2019-02-27 14:54:30 -0800, Shen Li, 65, 22, 87, LINK)"
15570,2,40,0,40,"(a6f4538f31d2a74f4ea51e849f449703eefb0397, 2018-12-28 13:52:01 -0800, David Riazati, 20, 0, 20, LINK), (692898fe379c9092f5e380797c32305145cd06e1, 2018-12-28 13:52:01 -0800, David Riazati, 20, 0, 20, LINK)"
156,1,1,1,2,"(c38defd20146bbec47d5ab8a1ae68f5220248c23, 2017-11-02 12:24:42 -0400, gchanan, 1, 1, 2, LINK)"
15602,2,80,388,468,"(4e5b994ca7050ab3a4d644a2fd2e1ffa2b57f6af, 2019-01-11 13:28:52 -0800, Christian Puhrsch, 40, 194, 234, LINK), (d33159a4261fed36e147cc2351aff0741f0fa715, 2019-01-11 13:28:52 -0800, Christian Puhrsch, 40, 194, 234, LINK)"
15604,2,47,18,65,"(231f1a499191e4961885aad2ddf2f9915968584e, 2019-01-10 12:49:54 -0800, Elias Ellison, 28, 13, 41, LINK), (9173cd5a4d31abd8cf42fcae0341db8287a69074, 2019-01-10 12:49:54 -0800, Elias Ellison, 19, 5, 24, LINK)"
15605,1,25,5,30,"(c863a759a0caa13f10f639b66de43e0b3b0f9dd4, 2019-01-27 12:08:09 -0800, SsnL, 25, 5, 30, LINK)"
15614,2,20,0,20,"(f80dba92aede4f8f424431de6d42947b93edcd47, 2018-12-29 16:09:12 -0800, Mark Harfouche, 10, 0, 10, LINK), (4047cdc6906c6e5c5e1fb837f7f479e0af149fa7, 2018-12-29 16:09:12 -0800, Mark Harfouche, 10, 0, 10, LINK)"
15618,1,1,2,3,"(c771d50ca26048647e7bfeb70f597c33769030bc, 2019-08-13 20:30:01 -0700, Orion Reblitz-Richardson, 1, 2, 3, LINK)"
15636,1,2,2,4,"(2d8f14cd120a74d80de199f057a2d40e17b0dd96, 2019-01-03 21:36:49 -0800, Elad Zippory, 2, 2, 4, LINK)"
15638,2,202,100,302,"(b65b55a652834b17bf2d33b20a7cb4027e8faeef, 2019-01-18 02:23:51 -0800, Teng Li, 101, 50, 151, LINK), (b4bc55beefda3a0724b0fb83c04b6bbd8dd46c77, 2019-01-18 02:23:51 -0800, Teng Li, 101, 50, 151, LINK)"
15642,1,22,0,22,"(2c302b6ea68eb9024f5f1b9cdc41e3bf39556fa2, 2019-02-21 00:15:59 -0800, Michael Suo, 22, 0, 22, LINK)"
15647,1,6,1,7,"(e2549cbc0101fc4f376f3226b0002625a397da14, 2019-01-02 19:50:19 -0800, Natalia Gimelshein, 6, 1, 7, LINK)"
1565,1,4,0,4,"(2752ad8045c59c4eafe45fe94b6672cb436da523, 2018-11-29 16:29:46 -0800, Lu Fang, 4, 0, 4, LINK)"
15661,1,30,6,36,"(76feb8c40fcfa49c6555ff7d89a0380406577c7a, 2019-01-07 13:49:20 -0800, David Riazati, 30, 6, 36, LINK)"
15669,2,32,10,42,"(c926cb4408da5d2f75499a7791f26feb6e26c743, 2019-01-02 14:32:00 -0800, Michael Suo, 19, 7, 26, LINK), (d86cc3e7de1c3e18adb8d5d4794e62d14bb2b543, 2019-01-02 14:32:00 -0800, Michael Suo, 13, 3, 16, LINK)"
1567,1,4,0,4,"(2752ad8045c59c4eafe45fe94b6672cb436da523, 2018-11-29 16:29:46 -0800, Lu Fang, 4, 0, 4, LINK)"
15681,2,14,0,14,"(ca1f9349dd60c8367a058a206b516d92984021d3, 2019-01-09 20:04:18 -0800, vishwakftw, 7, 0, 7, LINK), (5f1dd9e7436366d2ea4580ebbaaba1a70b22b4c9, 2019-01-09 20:04:18 -0800, vishwakftw, 7, 0, 7, LINK)"
15682,2,71,14,85,"(99d274386353e99d1568448d6e798d216e176d21, 2019-01-07 20:55:37 -0800, Shen Li, 26, 9, 35, LINK), (1e9a6d71921fc673d90699cd5230cf957f5f61cf, 2019-01-03 15:12:13 -0800, Shen Li, 45, 5, 50, LINK)"
1570,1,9,0,9,"(373b5080dacc4c4fa958e36182f8c41a0a9dc425, 2018-10-18 22:45:46 -0700, Jan Schlüter, 9, 0, 9, LINK)"
15700,1,23,1,24,"(95febdfacc112158565561e374819396dfd88861, 2019-01-07 10:38:16 -0800, vishwakftw, 23, 1, 24, LINK)"
1571,1,4,0,4,"(2752ad8045c59c4eafe45fe94b6672cb436da523, 2018-11-29 16:29:46 -0800, Lu Fang, 4, 0, 4, LINK)"
15735,2,16,0,16,"(ba4d1e8ca63b34563b523b4788dfe7e2bba73654, 2019-01-09 07:28:40 -0800, zou3519, 8, 0, 8, LINK), (f0c2a9a7b68f77841ba112088deedcd01ddc978a, 2019-01-09 07:28:40 -0800, zou3519, 8, 0, 8, LINK)"
15749,2,48,2,50,"(167f8e8314a51545f82ff2accf8574fb3bb1c202, 2019-01-08 09:45:52 -0800, Natalia Gimelshein, 24, 1, 25, LINK), (461dc9a28b132f032e1ae81bfdab27e9d3770fe9, 2019-01-08 09:45:52 -0800, Natalia Gimelshein, 24, 1, 25, LINK)"
15764,2,100,60,160,"(dfdf2376bb9bf4e99a2f7a61e956954646929709, 2019-01-11 08:09:06 -0800, Brennan Vincent, 50, 30, 80, LINK), (70dd44f6a8a20a52b8d800e08a8aa7ef98ee6352, 2019-01-11 08:09:06 -0800, Brennan Vincent, 50, 30, 80, LINK)"
15768,1,28,4,32,"(acc83ad54ef85eacd3c7ebfe20ee8225164e5bd1, 2019-01-08 13:09:11 -0800, Zachary DeVito, 28, 4, 32, LINK)"
1578,1,4,0,4,"(2752ad8045c59c4eafe45fe94b6672cb436da523, 2018-11-29 16:29:46 -0800, Lu Fang, 4, 0, 4, LINK)"
15815,1,124,6,130,"(c865d46736db4afff51690a712e35ed8e3899490, 2019-02-01 16:24:36 -0800, David Riazati, 124, 6, 130, LINK)"
1582,1,2,1,3,"(12e6c1ceeb74fc0a1ea6a1af9eb60174b26ce4f6, 2019-01-04 15:38:07 -0800, Lu Fang, 2, 1, 3, LINK)"
15826,2,22,2,24,"(9a9eae14d0eeb216c4a442b7c080263b99b934dc, 2019-01-11 11:19:56 -0800, vishwakftw, 11, 1, 12, LINK), (e07cca13123446d61576a2f54b9c5a680ff9f364, 2019-01-11 11:19:56 -0800, vishwakftw, 11, 1, 12, LINK)"
15828,1,22,26,48,"(3d3bff5ff1bc277306d15a3caa96c2a6fdb924bb, 2019-10-16 09:17:39 -0700, Peter Bell, 22, 26, 48, LINK)"
15837,1,42,4,46,"(fb68d813be3ccbab3cbf74008a11071b9a646c75, 2019-01-15 19:55:13 -0800, Brennan Vincent, 42, 4, 46, LINK)"
1584,1,11,4,15,"(f2037970cb665c894d52adfa68e05a48b05a6a73, 2017-09-28 17:06:44 +0200, Micael Carvalho, 11, 4, 15, LINK)"
15858,2,324,285,609,"(563d67087cee3987b2014c9a08a67b046d8b142f, 2019-01-10 06:44:37 -0800, peter, 168, 141, 309, LINK), (0ed3f766e9eb803e8f37f728af9494d756aec9a7, 2019-01-10 06:44:37 -0800, peter, 156, 144, 300, LINK)"
1587,1,1,1,2,"(7841fe4f27e0553179f2019da79f0f046d61c69d, 2019-01-11 08:25:08 -0800, Lu Fang, 1, 1, 2, LINK)"
15911,2,216,238,454,"(ca18fb85672159bf52b9a3d56738d057129b292f, 2019-01-13 23:30:09 -0800, Jongsoo Park, 212, 234, 446, LINK), (04b8a2f1baa87efc0434a532e036a0bb29de22a9, 2019-01-12 21:00:25 -0800, Jongsoo Park, 4, 4, 8, LINK)"
15919,2,2,8,10,"(b879d006f1a26ee5a9d3d4911ca6dbe89c827978, 2019-01-17 08:30:55 -0800, DavidWongEA, 1, 5, 6, LINK), (334258e39e5f821f55a6dce805e81f1eb31f73ef, 2019-01-17 08:30:55 -0800, DavidWongEA, 1, 3, 4, LINK)"
15923,2,4,0,4,"(e274158c722656b86cce12b4b798e8169659266f, 2019-01-19 14:58:36 -0800, Miro Furtado, 2, 0, 2, LINK), (33d1ec396bad4ff8d53b154e64166b56c9054a75, 2019-01-19 14:58:36 -0800, Miro Furtado, 2, 0, 2, LINK)"
15946,1,40,8,48,"(7078b2baf57bb6664309c680d4cc35bae23d6c9d, 2019-02-01 07:59:56 -0800, Asher Mancinelli, 40, 8, 48, LINK)"
1595,1,4,0,4,"(2752ad8045c59c4eafe45fe94b6672cb436da523, 2018-11-29 16:29:46 -0800, Lu Fang, 4, 0, 4, LINK)"
15968,1,121,12,133,"(300dcc3b96b2b8672570c4c9e6038cb5cff75afd, 2019-01-14 07:28:50 -0800, SsnL, 121, 12, 133, LINK)"
1597,1,4,0,4,"(2752ad8045c59c4eafe45fe94b6672cb436da523, 2018-11-29 16:29:46 -0800, Lu Fang, 4, 0, 4, LINK)"
15982,1,5,11,16,"(19bb496a0d8f37b8f9da77c98875bc16959f4c7f, 2020-01-27 08:56:40 -0800, xiaobing.zhang, 5, 11, 16, LINK)"
15992,2,36,0,36,"(b104068d24f9b1bebdfdd523fcd886e55a9d274d, 2019-01-16 09:06:22 -0800, peter, 18, 0, 18, LINK), (3cf76e78bd115b7b1340bdc2e8c677dc219704f3, 2019-01-16 09:06:22 -0800, peter, 18, 0, 18, LINK)"
16,1,77,29,106,"(0b78ae86c59e7372f0b9d4cadcd0e50bc76f8667, 2018-09-10 15:30:08 -0700, Owen Anderson, 77, 29, 106, LINK)"
1600,1,5,3,8,"(98581b9f7eab4d05613c39bb0f0573b9455e2bb8, 2017-05-24 20:46:32 -0400, Sam Gross, 5, 3, 8, LINK)"
16012,1,48,6,54,"(9497b21e63a14a54c4d95b17631ed5823bbc46a6, 2020-04-09 11:02:39 -0700, albanD, 48, 6, 54, LINK)"
16018,2,70,4,74,"(af03dbb93b7ffdf9c64f41c07c7d9c7eaf9f5924, 2019-01-23 23:14:54 -0500, gchanan, 35, 2, 37, LINK), (0cb24098c74f8ebed81ec08b83bf6cb5ab3903f5, 2019-01-24 07:36:54 -0800, Gregory Chanan, 35, 2, 37, LINK)"
16019,1,36,4,40,"(292edfb0879cb2ae9377637eadd282dfb6daea33, 2019-01-18 12:32:20 -0800, Shen Li, 36, 4, 40, LINK)"
16043,2,20,20,40,"(1e61241227dfd795fb013791dc3c72e50ce5b843, 2019-01-16 11:12:47 -0800, vishwakftw, 10, 10, 20, LINK), (503f412f795d6e91d3b16aafc1d522fbdc41b440, 2019-01-16 11:12:47 -0800, vishwakftw, 10, 10, 20, LINK)"
16045,1,20,2,22,"(8bc5b867093f1b44f5168f3e41b1bdf0ba3e05a7, 2019-03-24 19:17:00 -0700, mc-robinson, 20, 2, 22, LINK)"
1606,1,4,0,4,"(2752ad8045c59c4eafe45fe94b6672cb436da523, 2018-11-29 16:29:46 -0800, Lu Fang, 4, 0, 4, LINK)"
1607,1,4,0,4,"(2752ad8045c59c4eafe45fe94b6672cb436da523, 2018-11-29 16:29:46 -0800, Lu Fang, 4, 0, 4, LINK)"
1608,1,4,0,4,"(2752ad8045c59c4eafe45fe94b6672cb436da523, 2018-11-29 16:29:46 -0800, Lu Fang, 4, 0, 4, LINK)"
16099,1,213,0,213,"(aad0263a6b91c45d65404a621fdb220fccce0947, 2019-09-19 17:35:29 -0700, Will Feng, 213, 0, 213, LINK)"
1613,1,2,2,4,"(45524ec33ce1bf75ece04d4f6eb939ba0c9469e9, 2017-05-22 22:47:51 +0200, Cosmo Stérin, 2, 2, 4, LINK)"
16141,2,892,97,989,"(5653a914f757a032e27d74d44ad90c40149deadb, 2019-03-25 10:18:29 -0700, Vitaly Fedyunin, 841, 88, 929, LINK), (3b91df3744d960db3592c807c4f54a4509ce61c7, 2019-01-30 09:27:06 -0800, Ailing Zhang, 51, 9, 60, LINK)"
16144,1,1,1,2,"(a53d28dd87aa3f5e8fa0f8cbd3199b6a4661c0a9, 2019-02-03 11:49:25 -0800, Pieter Noordhuis, 1, 1, 2, LINK)"
1615,1,4,0,4,"(2752ad8045c59c4eafe45fe94b6672cb436da523, 2018-11-29 16:29:46 -0800, Lu Fang, 4, 0, 4, LINK)"
16152,1,11,4,15,"(bd19dd4b90aa94359b84986b0f9a298538ac7889, 2019-01-29 01:26:22 -0800, Soumith Chintala, 11, 4, 15, LINK)"
16154,1,26,2,28,"(866c1b1fcc2475da1bcd777a2f8e37f123f399be, 2019-12-26 10:44:32 -0800, Gregory Chanan, 26, 2, 28, LINK)"
16156,1,107,7,114,"(2235fb256e9e58050585a1bd0342de599570fcce, 2019-01-22 14:28:18 -0800, Shen Li, 107, 7, 114, LINK)"
16183,2,2,2,4,"(b65c22c01ab5e9b1644a8bbdaf87a52ca1a79ccb, 2019-02-15 01:19:33 -0800, Gu Jinghui, 1, 1, 2, LINK), (87ae1558a6c8c7c0693bfa995458d16239c484d7, 2019-02-01 07:13:38 -0800, Gu Jinghui, 1, 1, 2, LINK)"
16192,1,14,5,19,"(482d3a3bf32b0a2711891868dbb943b1ed607e48, 2019-01-31 11:12:21 -0800, bhushan, 14, 5, 19, LINK)"
1622,1,3,1,4,"(8f11df3cb7d43a433d12617078a263937f2734aa, 2019-01-15 17:10:56 -0800, Lu Fang, 3, 1, 4, LINK)"
16229,1,1,4,5,"(99674eb86f83ff505d9f6a1368821d6943b37be2, 2019-05-28 12:05:13 -0700, Your Name, 1, 4, 5, LINK)"
1623,1,4,0,4,"(2752ad8045c59c4eafe45fe94b6672cb436da523, 2018-11-29 16:29:46 -0800, Lu Fang, 4, 0, 4, LINK)"
16233,1,90,20,110,"(eae139e18fb575a8f6a0d2e43ff2f93ffe1acfde, 2019-02-10 18:10:59 -0800, Xiang Gao, 90, 20, 110, LINK)"
16250,1,73,29,102,"(7ce634ebc2943ff11d2ec727b7db83ab9758a6e0, 2019-01-24 17:11:26 -0800, Shen Li, 73, 29, 102, LINK)"
1626,1,54,71,125,"(eba3dc85617351077689f1e49b662b67e40b318e, 2017-06-02 21:08:50 -0400, Sam Gross, 54, 71, 125, LINK)"
16267,2,5,1,6,"(37953d92d198b6d8941d8120218d86d6e3813eee, 2020-02-03 11:10:53 -0800, Pierre Fenoll, 2, 0, 2, LINK), (4b06c063a5259f50ec4c3cdde621857ea125fa97, 2019-01-23 16:02:55 -0800, nlml, 3, 1, 4, LINK)"
16271,1,73,29,102,"(7ce634ebc2943ff11d2ec727b7db83ab9758a6e0, 2019-01-24 17:11:26 -0800, Shen Li, 73, 29, 102, LINK)"
16284,1,25,8,33,"(44d98c30a3ab4921b4b9354859c3571e21ae7722, 2019-02-07 11:50:27 -0800, David Riazati, 25, 8, 33, LINK)"
16285,1,3,1,4,"(26565046acaaffab037ae24a331eec89f2be935b, 2019-01-31 11:58:56 -0800, David Riazati, 3, 1, 4, LINK)"
16288,1,34,1,35,"(fdda533eb1d494da5e3dee8f321e0001db76adf9, 2019-01-24 13:07:35 -0800, Sidney Zhang, 34, 1, 35, LINK)"
16292,1,1,1,2,"(ee1844813801e3c0cca51a7272383f0a04393cfb, 2019-01-27 12:26:24 -0800, peterjc123, 1, 1, 2, LINK)"
1631,1,67,56,123,"(77484ecc454e354a5ec50a1138b42cb5248940dc, 2018-01-02 15:22:13 -0800, Yangqing Jia, 67, 56, 123, LINK)"
16326,1,94,7,101,"(18659e13367dd1ff37af9d79b954a035f7230582, 2019-01-30 13:48:36 -0800, Elias Ellison, 94, 7, 101, LINK)"
1633,2,31,0,31,"(2752ad8045c59c4eafe45fe94b6672cb436da523, 2018-11-29 16:29:46 -0800, Lu Fang, 4, 0, 4, LINK), (e0ebd9a14e77e20381f1bdf234408861603c9274, 2017-12-21 10:45:09 -0800, Pieter Noordhuis, 27, 0, 27, LINK)"
1634,1,4,0,4,"(2752ad8045c59c4eafe45fe94b6672cb436da523, 2018-11-29 16:29:46 -0800, Lu Fang, 4, 0, 4, LINK)"
16364,1,2,1,3,"(95d3825e48ad8eb6caab2374d831b4e76824dc25, 2019-03-29 06:42:52 -0700, Søren Rasmussen, 2, 1, 3, LINK)"
16365,2,2,2,4,"(37c8a33b54882c9efb1404dae4079cb29a3ef494, 2019-01-26 11:14:19 -0800, vishwakftw, 1, 1, 2, LINK), (8c81a72e87ac4114fbddfadb9285d89a9ead79a1, 2019-01-26 11:14:19 -0800, vishwakftw, 1, 1, 2, LINK)"
16367,1,864,8,872,"(3d44305e9d3f0ecb9eb126dbf0125a0cdc513b2d, 2019-03-18 18:15:17 -0700, David Riazati, 864, 8, 872, LINK)"
1637,1,1,1,2,"(c51cf09a4b1e5eea30e736fe08424144cebebd53, 2019-01-17 09:53:15 -0800, Lu Fang, 1, 1, 2, LINK)"
1639,1,4,0,4,"(2752ad8045c59c4eafe45fe94b6672cb436da523, 2018-11-29 16:29:46 -0800, Lu Fang, 4, 0, 4, LINK)"
16446,1,6,4,10,"(3ab620926f83a406de4da8250d3111796d74ed5d, 2019-01-29 12:37:37 -0800, peter, 6, 4, 10, LINK)"
16448,2,3,7,10,"(60538c8366587d9b8b08226c953c98a0013b833f, 2019-03-26 20:55:25 -0700, Tongzhou Wang, 1, 6, 7, LINK), (f61f9e17578dc9c47e77500cd86f6a002e2062cf, 2019-02-12 07:49:48 -0800, SsnL, 2, 1, 3, LINK)"
16471,1,21,2,23,"(7e5442f90099e27d285e585b8d4e3ee05eb4ac4e, 2019-02-19 04:24:45 -0800, bhushan, 21, 2, 23, LINK)"
16498,1,21,6,27,"(8ec7357312590d8ccb305d58690238536b009159, 2019-03-06 19:37:03 -0800, jwu, 21, 6, 27, LINK)"
16501,1,10,2,12,"(ffed8bff6a1df334e371957009dd77af0c5140dd, 2019-01-29 15:32:56 -0800, Gregory Chanan, 10, 2, 12, LINK)"
16520,1,63,0,63,"(8f9b11cf334bf15c35909094edd868892bddbc6f, 2019-04-09 12:06:04 -0700, Shen Li, 63, 0, 63, LINK)"
1653,1,2,1,3,"(5be28ade66c8c63bf4ab34e35991b8224c3d3e9d, 2018-12-07 17:24:01 -0800, Lu Fang, 2, 1, 3, LINK)"
16543,1,11,5,16,"(851437dd4b5a44b4f9795925f07329d0aab1aa3c, 2019-01-30 16:01:51 -0800, Gregory Chanan, 11, 5, 16, LINK)"
16559,1,77,43,120,"(925131a85e840893b1e1b229d2610dee2c55376c, 2019-09-17 07:38:52 -0700, Edward Yang, 77, 43, 120, LINK)"
1656,1,2,1,3,"(5be28ade66c8c63bf4ab34e35991b8224c3d3e9d, 2018-12-07 17:24:01 -0800, Lu Fang, 2, 1, 3, LINK)"
16560,1,12,0,12,"(16e2e4f29f8c9bd076011992755c3d2962fc5eb5, 2019-01-30 16:43:51 -0800, ParticularlyPythonicBS, 12, 0, 12, LINK)"
16562,1,19,3,22,"(d35c39e73b04d7ab95812be8cbda21023e1b5cc4, 2019-04-04 17:18:11 -0700, Brennan Vincent, 19, 3, 22, LINK)"
16577,1,97,7,104,"(7743ed850231781097fe4388fbe6d299cbb4a2c6, 2019-02-11 13:31:06 -0800, Adam Paszke, 97, 7, 104, LINK)"
1658,2,3,3,6,"(5be28ade66c8c63bf4ab34e35991b8224c3d3e9d, 2018-12-07 17:24:01 -0800, Lu Fang, 2, 1, 3, LINK), (45f665d05c9058e5e3c529c3a5ed02062a3929aa, 2017-05-26 11:21:25 -0700, Sam Gross, 1, 2, 3, LINK)"
16586,1,88,28,116,"(ed9952dd2505b0faf087a3e72abe9144b1b82b55, 2018-04-04 17:04:21 -0400, Edward Z. Yang, 88, 28, 116, LINK)"
16591,1,65,66,131,"(6efa40e07b8e0b3ec27e4d2818172e4ed4239a90, 2019-02-05 12:16:56 -0800, Zachary DeVito, 65, 66, 131, LINK)"
1660,1,1,1,2,"(7841fe4f27e0553179f2019da79f0f046d61c69d, 2019-01-11 08:25:08 -0800, Lu Fang, 1, 1, 2, LINK)"
16607,1,4,2,6,"(37529161326a001e8398bc5b4e75791db94c04b0, 2019-03-28 20:49:43 -0700, Hyungjoo Andrew Cho, 4, 2, 6, LINK)"
16608,1,12,5,17,"(d1e416ac73d9b3664c03efb8fc8c4083d3c35cdf, 2019-03-25 19:17:00 -0700, Tongzhou Wang, 12, 5, 17, LINK)"
1662,1,2,1,3,"(44894915d61630f99718e18742a15076ca44ea88, 2018-12-03 20:09:24 -0800, Lu Fang, 2, 1, 3, LINK)"
16627,1,1,1,2,"(8abfd28f588ccea9fcc11787acff2260b5ea9e55, 2019-02-13 20:42:45 -0800, ptrblck, 1, 1, 2, LINK)"
1664,2,167,171,338,"(e4a883e60104d95d9c364efa4ac49bd241894d75, 2020-03-05 16:58:41 -0800, Xiang Gao, 166, 170, 336, LINK), (3237103624f776016c5445c0b957f0ea6e9a02bd, 2018-12-04 18:35:46 -0800, Lu Fang, 1, 1, 2, LINK)"
16642,1,47,32,79,"(8f6ee88a1d14d2f783c65e487b5cbda3f7211980, 2019-02-10 19:32:15 -0800, Adam Paszke, 47, 32, 79, LINK)"
16647,1,6,1,7,"(c0a2452ffe1bf4202763bbfcafa5867461158de3, 2019-03-29 06:48:53 -0700, Stas Bekman, 6, 1, 7, LINK)"
16650,1,1,0,1,"(37890610b02fae2bd4b4eff3fd3747a3dc0ffaad, 2019-02-21 07:34:27 -0800, Tri Dao, 1, 0, 1, LINK)"
16662,5,514,17,531,"(9a8a26867212e3f3c01caabc1d244345c7015694, 2019-03-15 12:39:04 -0700, Michael Kösel, 157, 2, 159, LINK), (cd26200d1b01cd66c2c5d641feba836a8f2341d3, 2019-03-15 11:43:33 -0700, Michael Kösel, 42, 1, 43, LINK), (b18c60839d5a2aef9dc480d542044333cc4c290c, 2019-02-22 13:58:08 -0800, Michael Kösel, 151, 8, 159, LINK), (38139bc356b5dd59be7938be386f68138ef33ff3, 2019-02-15 10:25:37 -0800, Michael Kösel, 127, 4, 131, LINK), (ff2053dfa1d9d5e39215a297dfaf11b91f9fbb6e, 2019-02-14 13:42:27 -0800, Michael Kösel, 37, 2, 39, LINK)"
1667,1,1,1,2,"(3237103624f776016c5445c0b957f0ea6e9a02bd, 2018-12-04 18:35:46 -0800, Lu Fang, 1, 1, 2, LINK)"
1668,1,1,1,2,"(3237103624f776016c5445c0b957f0ea6e9a02bd, 2018-12-04 18:35:46 -0800, Lu Fang, 1, 1, 2, LINK)"
16683,1,11,1,12,"(fcd44ce6982fc47d153f13cfc1f962e85357e386, 2020-11-11 14:22:09 -0800, skyline75489, 11, 1, 12, LINK)"
1669,1,2,1,3,"(5be28ade66c8c63bf4ab34e35991b8224c3d3e9d, 2018-12-07 17:24:01 -0800, Lu Fang, 2, 1, 3, LINK)"
16707,1,30,8,38,"(bad4442a7cefebd1fae825f86b6b9667aa321896, 2019-02-12 00:12:03 -0800, Simeon Monov, 30, 8, 38, LINK)"
16712,1,1,0,1,"(717ae09184a5329f53d99bc56d0ab0118c3522e6, 2019-02-06 15:46:39 -0800, Soumith Chintala, 1, 0, 1, LINK)"
16756,1,3,0,3,"(0d366e1bde42265d764a6a9aad27a38753156fb0, 2019-02-07 01:33:41 -0800, Fritz Obermeyer, 3, 0, 3, LINK)"
16813,1,42,27,69,"(11c89dde55c11b8571f130d72d8e8cf2a3b6d767, 2019-03-11 11:30:08 -0700, Gao Xiang, 42, 27, 69, LINK)"
16828,1,4,1,5,"(41dddfd55fc59a0ebae7cda7e759b80011741a78, 2019-02-13 15:30:39 -0800, Boris Daskalov, 4, 1, 5, LINK)"
16845,1,72,4,76,"(cd2dca3cafb49fbf64a4714571717f2390625e72, 2019-02-08 11:34:40 -0800, Elias Ellison, 72, 4, 76, LINK)"
16849,1,106,38,144,"(abab9c1d78d6eb0eb9af2bad5212a9707272f305, 2019-03-12 10:36:38 -0700, Elias Ellison, 106, 38, 144, LINK)"
1685,1,8,3,11,"(cd9d0f45611d92dc006127b001dd9f5d84a6289e, 2018-01-09 12:17:04 -0800, Marat Dukhan, 8, 3, 11, LINK)"
16856,1,34,6,40,"(ee0e71bee7383c89148063102770491317614ab2, 2019-02-07 18:21:30 -0800, David Riazati, 34, 6, 40, LINK)"
16860,1,161,132,293,"(356a94b64e69aa2e87b33e7bbd0b302feca327a4, 2019-02-22 13:37:26 -0800, Zachary DeVito, 161, 132, 293, LINK)"
16921,1,85,34,119,"(4c6da649e537882c40223c7e1f66403d321a04bc, 2019-02-21 15:24:23 -0800, Zachary DeVito, 85, 34, 119, LINK)"
16952,1,1,1,2,"(c596683309d9f50406d395f2b93b7c12b0e68fee, 2019-02-28 13:27:27 -0800, Morgan Funtowicz, 1, 1, 2, LINK)"
1696,1,2,1,3,"(12e6c1ceeb74fc0a1ea6a1af9eb60174b26ce4f6, 2019-01-04 15:38:07 -0800, Lu Fang, 2, 1, 3, LINK)"
16962,1,142,81,223,"(26f5275644da200f83458dffd6b3216933200c36, 2019-05-06 13:25:57 -0700, Elias Ellison, 142, 81, 223, LINK)"
16983,1,2,2,4,"(a2c322e7357a897402e6bdf700f086eaaed48cfd, 2019-02-12 10:41:45 -0800, Karl Ostmo, 2, 2, 4, LINK)"
16996,1,179,6,185,"(1b25fdbcd0cd838096dbb8aa3943255e96556dc4, 2019-04-01 15:56:21 -0700, Jon Malmaud, 179, 6, 185, LINK)"
16998,1,8,0,8,"(594a4d7b5599f2ea58c7e8697d896f15c7b256fa, 2019-02-19 16:32:13 -0800, Jie, 8, 0, 8, LINK)"
17000,1,23,0,23,"(b57fe3cc66cfc348d56a7f41fa74b784119fa89a, 2019-03-11 08:55:01 -0700, bhushan, 23, 0, 23, LINK)"
17017,2,170,4,174,"(b36d9351b1568daa75f707d13791992571b4986e, 2019-02-28 14:43:05 -0800, David Riazati, 91, 2, 93, LINK), (dbd66c17bcae6015844f2603bb5db28af84ac7d7, 2019-02-22 14:38:33 -0800, David Riazati, 79, 2, 81, LINK)"
17038,1,3659,7,3666,"(01686db21b035d9cbeb1656beabe1e9b0be5c7a4, 2019-02-15 12:14:54 -0800, Karl Ostmo, 3659, 7, 3666, LINK)"
17051,2,27,45,72,"(698f9474636d46a4c8dd29ef3762e1cef3a476bb, 2019-03-01 10:33:58 -0800, peter, 4, 40, 44, LINK), (428b666814cea4b15860bf3485a613fadd5bfdee, 2019-02-19 16:54:02 -0800, peter, 23, 5, 28, LINK)"
17065,1,44,1,45,"(472cfc0f2cc617d70ef28bdf3a623e1ff2e759d5, 2019-02-15 11:09:12 -0800, Shen Li, 44, 1, 45, LINK)"
1707,2,9,5,14,"(12e6c1ceeb74fc0a1ea6a1af9eb60174b26ce4f6, 2019-01-04 15:38:07 -0800, Lu Fang, 2, 1, 3, LINK), (85a95d8a23ff5a58792932680e7769b57e668b78, 2017-06-05 09:13:40 -0700, Sam Gross, 7, 4, 11, LINK)"
17101,1,3,3,6,"(12d6725c15207e05c6d01e3d5b062db2f16fb5e9, 2019-03-12 06:28:54 -0700, Karl Ostmo, 3, 3, 6, LINK)"
17106,1,1,1,2,"(0955592243b8ed122a14ab6c1cd8e02ed49ec6d9, 2019-03-08 15:26:25 -0800, David Riazati, 1, 1, 2, LINK)"
17112,1,154,0,154,"(2e5a8cee82b21b917d3d5cf6b77577f798b596a5, 2019-02-28 12:59:34 -0800, Xiang Gao, 154, 0, 154, LINK)"
1712,1,2,1,3,"(c33512bdfc2d2bd702bea26d950032b407a5305f, 2019-01-21 09:43:40 -0800, Lu Fang, 2, 1, 3, LINK)"
17130,1,1,1,2,"(326c891d32e3a786b350c2f08bc296106d73739c, 2019-02-15 11:20:27 -0800, David Riazati, 1, 1, 2, LINK)"
17140,1,22,0,22,"(2c302b6ea68eb9024f5f1b9cdc41e3bf39556fa2, 2019-02-21 00:15:59 -0800, Michael Suo, 22, 0, 22, LINK)"
17144,1,17,1,18,"(237e5438f532418ecb465ca7209e3e2241e32501, 2019-02-20 03:06:53 -0800, Thomas Viehmann, 17, 1, 18, LINK)"
17152,1,81,14,95,"(b4572668b48b746802580263dafa12762d202379, 2019-02-27 11:39:37 -0800, Natalia Gimelshein, 81, 14, 95, LINK)"
1717,1,1,1,2,"(7841fe4f27e0553179f2019da79f0f046d61c69d, 2019-01-11 08:25:08 -0800, Lu Fang, 1, 1, 2, LINK)"
17179,1,555,224,779,"(fdeef45852578a068a62abba253a87aab857dc5f, 2019-11-04 09:18:09 -0800, Elias Ellison, 555, 224, 779, LINK)"
1721,3,65,43,108,"(719134f3c30f72a9a42100129f6ff8e851208f3f, 2019-01-29 13:17:59 -0800, Lu Fang, 2, 1, 3, LINK), (22949350b6e853f4dc881491e6726d5b2a398107, 2017-05-30 09:34:50 -0700, Christian Sarofeen, 45, 28, 73, LINK), (db620304b2bcbaf14ca643220b42aeff717e37ec, 2017-05-30 09:34:50 -0700, Christian Sarofeen, 18, 14, 32, LINK)"
17210,1,24,2,26,"(fad9eda7fbbeea08c810d2d048a41fd9b23f38fe, 2019-02-19 04:29:14 -0800, surgan12, 24, 2, 26, LINK)"
17223,1,2,2,4,"(43d5cd4d340c41970244c653aa2d1a5f81246c28, 2019-02-19 10:05:19 -0800, Karl Ostmo, 2, 2, 4, LINK)"
17229,1,203,85,288,"(2e97c82470966df6942f364102690460ea58403e, 2019-04-02 13:18:20 -0700, Igor Fedan, 203, 85, 288, LINK)"
17239,1,13,14,27,"(b3b692a80a5bdafc5d305048f1512ccd91f42bc3, 2019-02-20 20:16:50 -0800, Edward Yang, 13, 14, 27, LINK)"
1724,1,1,1,2,"(7841fe4f27e0553179f2019da79f0f046d61c69d, 2019-01-11 08:25:08 -0800, Lu Fang, 1, 1, 2, LINK)"
17247,1,81,16,97,"(16e50c78e7e06276e972ed8aa38fa5fb561637ec, 2019-03-14 06:29:03 -0700, bhushan, 81, 16, 97, LINK)"
17256,1,28,1,29,"(2b57bdb7abd18d1bf89c9b86e8f128146705211a, 2019-02-19 16:33:16 -0800, Tongzhou Wang, 28, 1, 29, LINK)"
17261,1,7,8,15,"(5fa78303edcfcc841c30ef27462f80904b3c79a2, 2019-02-21 14:35:20 -0800, Natalia Gimelshein, 7, 8, 15, LINK)"
17262,2,18,6,24,"(368dbb9ab3228c69b054725f0544d20c6b008ef4, 2019-07-10 13:09:36 -0700, Tongzhou Wang, 1, 2, 3, LINK), (6bcff88d3ea6af9c1b9ed99157a40450ba04088c, 2019-03-10 15:18:48 -0700, bhushan, 17, 4, 21, LINK)"
17265,1,11,11,22,"(3069c45069efb12d4e8f88da695ae6374c3a1981, 2019-02-21 09:53:24 -0800, Soumith Chintala, 11, 11, 22, LINK)"
17271,2,34,10,44,"(e3da16a99eb4b475a90fe424eaf9156c3f7370f4, 2019-03-22 07:46:50 -0700, Edward Yang, 9, 0, 9, LINK), (2934153f3508ac1710f358677d83de72789bb275, 2019-03-22 07:43:40 -0700, Edward Yang, 25, 10, 35, LINK)"
17274,1,4,4,8,"(36ddad3bfe57572d07945f2a523631b365d5c01b, 2019-02-20 13:31:23 -0800, Thomas Viehmann, 4, 4, 8, LINK)"
17322,1,961,959,1920,"(dd3acbc6d55e8df70fbbf643ec8510c8338c7398, 2019-02-22 11:22:14 -0800, Karl Ostmo, 961, 959, 1920, LINK)"
17332,1,5,1,6,"(6b07612cef8fc2d7c1a0d540a92f066cf7ea82a7, 2019-02-28 16:26:49 -0800, Sebastian Messmer, 5, 1, 6, LINK)"
17336,1,252,260,512,"(e1c272797b1078220b3333386450096062acd27f, 2019-03-25 18:01:39 -0700, Karl Ostmo, 252, 260, 512, LINK)"
1734,1,3,1,4,"(8f11df3cb7d43a433d12617078a263937f2734aa, 2019-01-15 17:10:56 -0800, Lu Fang, 3, 1, 4, LINK)"
17345,1,20,2,22,"(2e029db2f9a70959c0ba831d9d13e344ddab3c57, 2019-04-01 17:07:27 -0700, Soumith Chintala, 20, 2, 22, LINK)"
17357,1,60,3,63,"(a6e45a69a8b1efc7ed4eb9d9d10899d0ee164895, 2019-07-22 15:00:32 -0700, Guanheng Zhang, 60, 3, 63, LINK)"
17362,1,80,30,110,"(3d5968d3661fae5baa52b56af4535a648ca44b27, 2019-02-22 08:27:04 -0800, Tongzhou Wang, 80, 30, 110, LINK)"
1737,1,2,1,3,"(c33512bdfc2d2bd702bea26d950032b407a5305f, 2019-01-21 09:43:40 -0800, Lu Fang, 2, 1, 3, LINK)"
17399,1,0,373,373,"(d76b9395a0588170bfe3f3d7117234e7f2de902d, 2019-02-23 20:57:28 -0800, Thomas Viehmann, 0, 373, 373, LINK)"
1744,1,85,85,170,"(e7a77ac3b0d76254ea6413021d7eec369d9c1ac9, 2019-01-22 14:55:50 -0800, Lu Fang, 85, 85, 170, LINK)"
17449,1,70,25,95,"(173561ff123ecee5df334aac4c104e120984ea55, 2019-03-04 13:04:53 -0800, Wanchao Liang, 70, 25, 95, LINK)"
17466,1,24,1,25,"(a6c4ea66dd78b28c9c0aecec64d4cf0b14ba55ff, 2019-03-10 09:20:30 -0700, bhushan, 24, 1, 25, LINK)"
17483,1,112,41,153,"(03132c1f56df2124866382f1b3376c09ede0c534, 2019-02-27 21:36:37 -0800, Ailing Zhang, 112, 41, 153, LINK)"
17489,1,2,2,4,"(96faaa9d50fd4b5d96a9d400a544f8e229c52aa8, 2019-02-26 20:33:59 -0800, peter, 2, 2, 4, LINK)"
17492,2,2151,1226,3377,"(ea38fbfc5c38937a1deda9ee618af82b62a3336f, 2019-05-14 17:59:11 -0700, Jesse Hellemn, 198, 111, 309, LINK), (41486306d9167050723d2c294bdf2f5cd8da8508, 2019-04-24 10:05:07 -0700, Karl Ostmo, 1953, 1115, 3068, LINK)"
17520,1,39,10,49,"(a6170573c898a1367517d8daf8e777abaf96f752, 2019-03-01 08:38:06 -0800, bhushan, 39, 10, 49, LINK)"
17531,1,150,9,159,"(9a41f447327e146a7b255de1d435992424e3ef6c, 2019-06-03 12:54:12 -0700, BowenBao, 150, 9, 159, LINK)"
17558,1,13,1,14,"(e782f200f7a525af4d10ff79d066613d46e23356, 2019-03-14 16:45:31 -0700, David Riazati, 13, 1, 14, LINK)"
17571,1,80,2,82,"(029c8e7754625c4652a169888ea2c5806e043520, 2019-08-01 09:43:57 -0700, Elias Ellison, 80, 2, 82, LINK)"
17572,1,1,1,2,"(0e77c0f5de4d9d8ee63fc040de14578ca4eb6537, 2019-05-03 07:08:25 -0700, Guanheng Zhang, 1, 1, 2, LINK)"
17583,2,39,11,50,"(3badea6eb3b835814990291368b03fe63cf29e00, 2019-03-22 15:25:40 -0700, Elias Ellison, 33, 8, 41, LINK), (667763a63add80ac136dc5c138d6f79509744643, 2019-03-08 10:29:51 -0800, David Riazati, 6, 3, 9, LINK)"
17609,1,29,16,45,"(af2e347164462b9ba93a8ed084f5c6e0f5782c91, 2019-03-12 01:43:45 -0700, xuzhu, 29, 16, 45, LINK)"
1763,1,2,1,3,"(719134f3c30f72a9a42100129f6ff8e851208f3f, 2019-01-29 13:17:59 -0800, Lu Fang, 2, 1, 3, LINK)"
17639,1,179,6,185,"(1b25fdbcd0cd838096dbb8aa3943255e96556dc4, 2019-04-01 15:56:21 -0700, Jon Malmaud, 179, 6, 185, LINK)"
17650,1,27,0,27,"(10ea02facf024ad728c3d80de7c8b8ce0b0099c9, 2019-03-06 11:21:09 -0800, Elias Ellison, 27, 0, 27, LINK)"
17652,1,106,38,144,"(abab9c1d78d6eb0eb9af2bad5212a9707272f305, 2019-03-12 10:36:38 -0700, Elias Ellison, 106, 38, 144, LINK)"
17657,1,5,0,5,"(08fb9021da32e73bd7dec73104eea6a76dd44439, 2019-03-06 10:41:20 -0800, peter, 5, 0, 5, LINK)"
17662,2,123,35,158,"(e01fc56ecb7c7437fab5bd00665386e05e077ce4, 2019-11-11 11:24:43 -0800, eellison, 105, 33, 138, LINK), (930fb2f31986a716f9588aad4dd372c28550d7cb, 2019-04-08 14:44:45 -0700, Elias Ellison, 18, 2, 20, LINK)"
17669,1,6,7,13,"(fefaebabba293dd1f06e712404652a2764dcd310, 2019-03-05 20:47:02 -0800, Ailing Zhang, 6, 7, 13, LINK)"
1767,1,2,1,3,"(719134f3c30f72a9a42100129f6ff8e851208f3f, 2019-01-29 13:17:59 -0800, Lu Fang, 2, 1, 3, LINK)"
1768,1,2,1,3,"(719134f3c30f72a9a42100129f6ff8e851208f3f, 2019-01-29 13:17:59 -0800, Lu Fang, 2, 1, 3, LINK)"
17683,1,864,8,872,"(3d44305e9d3f0ecb9eb126dbf0125a0cdc513b2d, 2019-03-18 18:15:17 -0700, David Riazati, 864, 8, 872, LINK)"
1773,1,8,2,10,"(afc7574aed08a1a37ec132489a7010eed04da66f, 2019-03-22 00:07:57 -0700, Lu Fang, 8, 2, 10, LINK)"
17750,1,44,8,52,"(deb2140c6e1e4e7be928c4a66a92b5ccfbad1210, 2019-06-14 08:26:33 -0700, LeviViana, 44, 8, 52, LINK)"
1776,1,1,1,2,"(1409a2afc8d81d911dbcfc2d0b210cf62658237b, 2019-02-04 17:34:33 -0800, Lu Fang, 1, 1, 2, LINK)"
1782,1,15,2,17,"(7bee03fe1e3f8dfb93ea662705d2d6c2d7cf32e5, 2017-06-12 11:30:52 -0700, Edward Z. Yang, 15, 2, 17, LINK)"
1783,1,52,2,54,"(c0e7bda3f1ff267a1a2717066816a82c262ade02, 2017-06-12 14:25:32 -0700, Edward Z. Yang, 52, 2, 54, LINK)"
1784,1,1,1,2,"(1409a2afc8d81d911dbcfc2d0b210cf62658237b, 2019-02-04 17:34:33 -0800, Lu Fang, 1, 1, 2, LINK)"
17843,1,26,3,29,"(071971476d7431a24e527bdc181981678055a95d, 2019-05-20 06:49:21 -0700, fehiepsi, 26, 3, 29, LINK)"
1788,1,10,18,28,"(b5170c8bf11158cff722b1632bcd6954d87b7bbe, 2017-10-25 13:16:32 +0200, Dirk Weissenborn, 10, 18, 28, LINK)"
17882,2,1254,78,1332,"(149c646b7450296fc740ad476c438abde228bbe8, 2019-08-22 16:10:29 -0700, Pritam Damania, 627, 39, 666, LINK), (0a23151293d217c97d53e9dff57d6dda08b99734, 2019-08-20 20:35:40 -0700, Pritam Damania, 627, 39, 666, LINK)"
17893,1,20,1,21,"(05bf74a8904c6b3b054f33a79898d784848a5544, 2019-08-30 07:29:06 -0700, CamiWilliams, 20, 1, 21, LINK)"
17909,1,1752,443,2195,"(058beae4115afb76ee5f45dfa42c6ab4ee01895c, 2019-06-20 20:03:30 -0700, Tongzhou Wang, 1752, 443, 2195, LINK)"
17913,1,13,3,16,"(e3f150462185239f5a92d39916c3e3ca12fe80e0, 2019-04-23 09:47:37 -0700, Chandler Zuo, 13, 3, 16, LINK)"
17918,1,32,3,35,"(1e8ed021c6bbb74be3af23278c39ecdf68e57541, 2019-11-27 08:30:24 -0800, Bowen Bao, 32, 3, 35, LINK)"
17919,1,106,60,166,"(7be05b822c01e8db5e23c8a213ba2e83d17b0bd2, 2019-03-22 19:25:58 -0700, Will Feng, 106, 60, 166, LINK)"
17937,1,16,4,20,"(b21e9e4dae4ba439f7408e6d25b94bc8c6734d51, 2019-03-12 21:40:13 -0700, Karl Ostmo, 16, 4, 20, LINK)"
17950,1,106,60,166,"(7be05b822c01e8db5e23c8a213ba2e83d17b0bd2, 2019-03-22 19:25:58 -0700, Will Feng, 106, 60, 166, LINK)"
17962,1,31,19,50,"(a21e256e8db77a339e0e1975a4ea41b671f3b0d9, 2019-04-03 11:18:05 -0700, Wanchao Liang, 31, 19, 50, LINK)"
17988,1,3,0,3,"(40a3e14ade39ba1a32b99c5ff06aa4bd8dae8132, 2019-03-14 07:19:49 -0700, vaeksare, 3, 0, 3, LINK)"
17998,1,244,2,246,"(965b97f5f0313ac170cbd7772cf345d50fe6314c, 2019-07-22 12:52:11 -0700, Pavel Belevich, 244, 2, 246, LINK)"
1805,1,11,1,12,"(d73e6cb59d97897cedc28a811aa5183050ca3649, 2019-02-19 14:35:07 -0800, Lu Fang, 11, 1, 12, LINK)"
18057,1,12,3,15,"(8895bfba6aac8ca99c6d4483fa9b8b32c8a95c83, 2019-03-19 20:02:29 -0700, Ailing Zhang, 12, 3, 15, LINK)"
18064,2,1736,1446,3182,"(fc8834df4b9c129fb40ea26641ac8aaeeb702428, 2019-04-23 12:43:14 -0700, Stefan Krah, 889, 747, 1636, LINK), (75ce5173a9c3db50c9a96608d267aed60e017c67, 2019-04-23 07:34:12 -0700, Stefan Krah, 847, 699, 1546, LINK)"
18065,1,841,780,1621,"(7799ea5eb3464b5096e745a577bdd430791d9da4, 2019-05-13 11:16:38 -0700, Masaki Kozuki, 841, 780, 1621, LINK)"
18074,1,12,6,18,"(b5d8844bbee40410ea981464da7186ce31ad0311, 2019-04-03 12:27:19 -0700, Soumith Chintala, 12, 6, 18, LINK)"
18078,1,116,16,132,"(f212fd9fd64d4ad9f28444ee44a070a36b7477ac, 2019-03-19 13:35:55 -0700, Tongzhou Wang, 116, 16, 132, LINK)"
1809,1,6,2,8,"(4480aa31c2b46d8c5f6e80eb44ded8bfa71205c9, 2019-03-07 11:03:57 -0800, Lu Fang, 6, 2, 8, LINK)"
1810,1,11,1,12,"(d73e6cb59d97897cedc28a811aa5183050ca3649, 2019-02-19 14:35:07 -0800, Lu Fang, 11, 1, 12, LINK)"
18108,1,40,1,41,"(50df3e5e2e2c51db6389b5c47c048f9db112c5c3, 2019-03-25 10:22:54 -0700, Edward Yang, 40, 1, 41, LINK)"
1811,1,11,1,12,"(d73e6cb59d97897cedc28a811aa5183050ca3649, 2019-02-19 14:35:07 -0800, Lu Fang, 11, 1, 12, LINK)"
18111,1,33,5,38,"(8a9ea55b25667b1928dfc246d691c565f3636b69, 2019-06-06 13:55:47 -0700, Brian Vaughan, 33, 5, 38, LINK)"
1812,1,11,1,12,"(d73e6cb59d97897cedc28a811aa5183050ca3649, 2019-02-19 14:35:07 -0800, Lu Fang, 11, 1, 12, LINK)"
18142,1,5,0,5,"(9034b66f14096d39eb1a2bb8e273f4b78f93e58d, 2019-04-18 23:31:32 -0700, Lu Fang, 5, 0, 5, LINK)"
1817,1,1,1,2,"(07646e405e2318327b0c2d2aaa744ab5e80f9f28, 2018-02-25 08:58:23 +0800, PengBo, 1, 1, 2, LINK)"
1818,1,11,1,12,"(d73e6cb59d97897cedc28a811aa5183050ca3649, 2019-02-19 14:35:07 -0800, Lu Fang, 11, 1, 12, LINK)"
1819,1,91,50,141,"(d481afb125d7dc9e595d85996785baabd0cbcbaa, 2018-01-28 17:48:59 -0800, Yangqing Jia, 91, 50, 141, LINK)"
18214,1,10,3,13,"(19c13eee39ae0befa8e3698ef3ec4ff5d04cdd18, 2019-03-20 09:12:40 -0700, peter, 10, 3, 13, LINK)"
18215,3,292,106,398,"(6f5fb78e9ed7ee7b6a1dd7cacd0ba429206daedc, 2019-08-02 00:14:11 -0400, Tongzhou Wang, 133, 50, 183, LINK), (2e40857dad7e83370fbf4ce414848fa54606319c, 2019-07-31 11:56:48 -0700, Thomas Viehmann, 133, 50, 183, LINK), (0ac28c89661e53de90a99195e2c5e81c8145a714, 2019-06-24 15:18:26 -0700, Ziyang Hu, 26, 6, 32, LINK)"
18218,1,35,0,35,"(d17aa723730d9d72d032983abedf54735d86e345, 2019-05-30 11:29:31 -0700, Qian Hong, 35, 0, 35, LINK)"
1822,1,2,1,3,"(29c27d7b99d03a9bf1257376afadbd98543c61d8, 2019-02-25 11:05:10 -0800, Lu Fang, 2, 1, 3, LINK)"
18232,1,58,0,58,"(fd35814348c9738cee76847f56575a7155bdf5e8, 2019-03-20 14:48:52 -0700, David Riazati, 58, 0, 58, LINK)"
1824,1,2,1,3,"(29c27d7b99d03a9bf1257376afadbd98543c61d8, 2019-02-25 11:05:10 -0800, Lu Fang, 2, 1, 3, LINK)"
18254,1,2,1,3,"(c5d5d45f40969cbddbb7f87da343dfd422503c1c, 2019-06-06 13:44:29 -0700, Xingdong Zuo, 2, 1, 3, LINK)"
18263,1,30,4,34,"(bf2a30cb22afe88b696b41edad6c2c147f9425f2, 2019-03-25 20:36:44 -0700, Xiang Gao, 30, 4, 34, LINK)"
18270,1,326,59,385,"(5c9ab6f411c31e6c8f92ccca2608459f2ce963d8, 2019-05-06 14:54:10 -0700, Thomas Viehmann, 326, 59, 385, LINK)"
18275,2,228,13,241,"(43b07ff2c40f3520c24d88cf83a5a982ee5f60fd, 2019-09-26 12:06:34 -0700, vishwakftw, 16, 3, 19, LINK), (8b9b215dc50915ade01611448e672ae4235f50bb, 2019-06-10 15:10:08 -0700, Stefan Krah, 212, 10, 222, LINK)"
1829,1,8,2,10,"(afc7574aed08a1a37ec132489a7010eed04da66f, 2019-03-22 00:07:57 -0700, Lu Fang, 8, 2, 10, LINK)"
18293,1,10,6,16,"(a40e0a7f2d235586237122e92561eef13169bb8f, 2019-03-25 19:54:27 -0700, Gao Xiang, 10, 6, 16, LINK)"
1830,1,6,2,8,"(4480aa31c2b46d8c5f6e80eb44ded8bfa71205c9, 2019-03-07 11:03:57 -0800, Lu Fang, 6, 2, 8, LINK)"
18319,1,433,32,465,"(946f3a9ed7d0fbae9e43ac515fc903a90b0ea796, 2020-02-13 11:38:47 -0800, peter, 433, 32, 465, LINK)"
18320,1,41,8,49,"(ca962f0f95185e76b1f43a4423d28986ee0da191, 2019-03-24 14:28:22 -0700, Elias Ellison, 41, 8, 49, LINK)"
18352,1,1519,2202,3721,"(1b34ccfc78a1a7f6267847384d7d974e6e46ab92, 2019-06-24 07:04:36 -0700, Pearu Peterson, 1519, 2202, 3721, LINK)"
18353,3,6382,3786,10168,"(7daa96a3ce14bfee5b5c830d4954fc29438a85f1, 2019-06-25 10:18:58 -0700, Ivan Ogasawara, 2126, 1297, 3423, LINK), (f8f583cbae492a1cbe6ae2e5cabdfaf2431a4175, 2019-06-20 07:00:46 -0700, Ivan Ogasawara, 2380, 1360, 3740, LINK), (0f675f9cbc71f59eaff9930a6ee3c62176b18017, 2019-06-17 10:03:15 -0700, Ivan Ogasawara, 1876, 1129, 3005, LINK)"
18363,1,36,2,38,"(436723122e646b1100a07f04a59043a58a8bd1f0, 2019-03-26 15:23:43 -0700, Soumith Chintala, 36, 2, 38, LINK)"
18381,1,127,83,210,"(b80a4fa201d4a7755bfb82b7fbd502297cef41db, 2019-04-03 17:09:37 -0700, Elias Ellison, 127, 83, 210, LINK)"
18382,1,46,48,94,"(79533ef097bf3ff2f1d85782ae1f279fe15e8686, 2019-04-07 00:07:24 -0700, Arunava, 46, 48, 94, LINK)"
18388,1,11,0,11,"(81b73951f1aa081338807bdc10983dc4663938ea, 2019-03-29 16:02:02 -0700, Soumith Chintala, 11, 0, 11, LINK)"
18389,1,1,1,2,"(92c9fef860fca1084f4219dfa1debdc920156418, 2019-03-24 13:11:20 -0700, Soumith Chintala, 1, 1, 2, LINK)"
18408,1,74,1,75,"(0ffd20c268340c0d7fe0b388a6960ff2b271808a, 2019-05-29 13:37:36 -0700, Yashodhan Ghadge, 74, 1, 75, LINK)"
18416,1,5,0,5,"(d5861aa55ce1c39350084f2761bbc3211243cd1a, 2019-03-26 19:47:37 -0700, peterjc123, 5, 0, 5, LINK)"
18419,1,3,1,4,"(a4f83fff2b7fb0e7ca7b584648c98165b2576ed4, 2019-03-25 07:21:37 -0700, Sacha, 3, 1, 4, LINK)"
18425,1,6,0,6,"(17adce1b6945b647673bf2913b3a08c367bb0097, 2019-04-09 08:00:18 -0700, Shuichi KITAGUCHI, 6, 0, 6, LINK)"
18440,1,137,9,146,"(dd903eb64522827f947adaa97419298fd87a922e, 2019-05-29 12:12:58 -0700, Horace He, 137, 9, 146, LINK)"
18448,1,112,68,180,"(5292685d2f144d9781ab8b7991c0a1153098a477, 2019-03-26 15:25:26 -0700, Tongzhou Wang, 112, 68, 180, LINK)"
18450,1,112,68,180,"(5292685d2f144d9781ab8b7991c0a1153098a477, 2019-03-26 15:25:26 -0700, Tongzhou Wang, 112, 68, 180, LINK)"
18461,1,1,1,2,"(85d78a0532225fa195ad4d15285b685ee44bd63b, 2019-03-27 07:55:48 -0700, peter, 1, 1, 2, LINK)"
1848,1,8,2,10,"(afc7574aed08a1a37ec132489a7010eed04da66f, 2019-03-22 00:07:57 -0700, Lu Fang, 8, 2, 10, LINK)"
18490,1,138,24,162,"(fefa6d305ea3e820afe64cec015d2f6746d9ca88, 2019-04-05 10:40:19 -0700, Michael Suo, 138, 24, 162, LINK)"
1851,1,8,2,10,"(afc7574aed08a1a37ec132489a7010eed04da66f, 2019-03-22 00:07:57 -0700, Lu Fang, 8, 2, 10, LINK)"
18518,1,8,2,10,"(31ff0ecd2b400b4863741bcbc41748f2ad01745c, 2019-04-09 10:36:13 -0700, Omegastick, 8, 2, 10, LINK)"
18525,2,19,7,26,"(8986b9e38d78a4cc045eef69e8ee6868244aa319, 2019-08-29 23:15:13 -0700, Spandan Tiwari, 8, 2, 10, LINK), (df05c7fbac72d1b1695854492715d9b5e0f8f5bb, 2019-04-08 16:21:30 -0700, Spandan Tiwari, 11, 5, 16, LINK)"
1854,1,6,1,7,"(7dafb1217e2207847bd5ca59c61feb746f1324a2, 2018-02-06 17:47:31 -0800, Guillaume Dumont, 6, 1, 7, LINK)"
1856,1,8,2,10,"(afc7574aed08a1a37ec132489a7010eed04da66f, 2019-03-22 00:07:57 -0700, Lu Fang, 8, 2, 10, LINK)"
1857,1,18,3,21,"(3748b6d3ebf3e7132453db61b25666d32e774e65, 2017-07-05 08:46:00 -0700, Christian Sarofeen, 18, 3, 21, LINK)"
18591,1,328,22,350,"(7ae0263e1bf1482cba79361f991d11a85b35cde6, 2019-04-03 14:37:54 -0700, Shen Li, 328, 22, 350, LINK)"
1860,1,8,2,10,"(afc7574aed08a1a37ec132489a7010eed04da66f, 2019-03-22 00:07:57 -0700, Lu Fang, 8, 2, 10, LINK)"
18616,1,48,5,53,"(dd618216c526a78b6df85e006480250ee3ccb0f0, 2020-05-06 10:38:45 -0700, Ailing Zhang, 48, 5, 53, LINK)"
18627,5,345,10,355,"(c4237339672c96dd9972af3b940c430ef7bc95ad, 2021-02-25 21:07:34 -0800, nikithamalgi, 65, 10, 75, LINK), (e677b710565dc3bc7b6f7f5f85bce25f8d6c9665, 2021-02-21 19:53:57 -0800, nikithamalgi, 41, 0, 41, LINK), (d819a21692e78f8f4d390f12bbfcb129a6e28feb, 2021-02-21 15:46:57 -0800, nikithamalgi, 98, 0, 98, LINK), (83feaebfc3d825575d5cce0aed54a99edfe148c1, 2021-02-18 22:53:33 -0800, nikithamalgi, 41, 0, 41, LINK), (2378c120e6dacb8c42d2efae37cbcedf5fe28e99, 2019-06-10 14:51:57 -0700, Kartikey Pandey, 100, 0, 100, LINK)"
1864,1,2,1,3,"(a5a1c9a171874971b7ddf276c0332c064e3fffec, 2019-03-28 23:44:20 -0700, Lu Fang, 2, 1, 3, LINK)"
18659,1,1,1,2,"(edc7b4726bdd5bad93e065644bfdbb666d8bc34e, 2019-04-05 12:13:31 -0700, Pieter Noordhuis, 1, 1, 2, LINK)"
1866,1,8,2,10,"(afc7574aed08a1a37ec132489a7010eed04da66f, 2019-03-22 00:07:57 -0700, Lu Fang, 8, 2, 10, LINK)"
18671,1,11,3,14,"(8e873ce273c17cfc45f3c24043474e1b62222bb1, 2019-04-01 17:31:53 -0700, David Riazati, 11, 3, 14, LINK)"
1868,2,12,2,14,"(afc7574aed08a1a37ec132489a7010eed04da66f, 2019-03-22 00:07:57 -0700, Lu Fang, 8, 2, 10, LINK), (03c0f4fbe7f09f31db9dc918a09d0886eeac41f8, 2018-11-12 15:22:55 -0800, Will Feng, 4, 0, 4, LINK)"
18689,1,4,1,5,"(c0ad6747a9b3d011ef5d1b44d08a065188a4ee19, 2019-04-03 09:06:09 -0700, Shen Li, 4, 1, 5, LINK)"
18700,1,1,0,1,"(5f24f9a29b678603b0cd783cdd2a03b6b2085bd2, 2019-04-09 07:29:42 -0700, Edward Yang, 1, 0, 1, LINK)"
18701,1,38,27,65,"(5e33085f270edd4ee17db47eb7cd0d2fc0cdb196, 2019-04-03 08:19:45 -0700, peter, 38, 27, 65, LINK)"
1872,1,1,1,2,"(72e171dc52540093c8ad4b6b539ce30ea200e6fd, 2019-04-08 23:12:58 -0700, Lu Fang, 1, 1, 2, LINK)"
18725,1,107,0,107,"(0565141728abe8d9235538157077973e2aaa8081, 2019-04-08 09:45:49 -0700, Jon Malmaud, 107, 0, 107, LINK)"
1874,1,3,1,4,"(5a796d15be92a58a2387e0c05d9f0f613893df74, 2019-04-22 17:24:57 -0700, Lu Fang, 3, 1, 4, LINK)"
1878,1,8,2,10,"(afc7574aed08a1a37ec132489a7010eed04da66f, 2019-03-22 00:07:57 -0700, Lu Fang, 8, 2, 10, LINK)"
1882,1,1,1,2,"(eae7ad4ca8a4081802d239a489d05b5d835100d2, 2019-03-26 21:51:10 -0700, Lu Fang, 1, 1, 2, LINK)"
18823,1,18,2,20,"(930fb2f31986a716f9588aad4dd372c28550d7cb, 2019-04-08 14:44:45 -0700, Elias Ellison, 18, 2, 20, LINK)"
18851,1,103,77,180,"(0ffda97aa4bacc1b00bf93d5d2bf25d46601ae17, 2019-07-02 02:30:30 -0700, Pieter Noordhuis, 103, 77, 180, LINK)"
18873,1,62,21,83,"(00148825fc35ddada2cfc59a30d904e0d8cace7c, 2019-04-15 12:26:50 -0700, Karl Ostmo, 62, 21, 83, LINK)"
1889,2,285,13,298,"(2dc9152dbedced00a848c82c1c7642eed54e67f6, 2019-05-13 14:43:45 -0700, Lu Fang, 1, 1, 2, LINK), (bd0cc7d3649473fe1b38f4867cbfbd40149c81f4, 2018-04-18 13:41:27 +0200, Thomas Viehmann, 284, 12, 296, LINK)"
18903,1,29,6,35,"(0c5dc965a46da3ececbc7d6e43841d2e1adc5c4b, 2019-05-06 14:58:51 -0700, Orion Reblitz-Richardson, 29, 6, 35, LINK)"
18967,1,5,12171,12176,"(6ff0c6ca3fa3d5bd8eae73d32465ca5614244918, 2019-06-25 12:06:51 -0700, Pieter Noordhuis, 5, 12171, 12176, LINK)"
18983,1,6,0,6,"(7b5b1486c91683ad6ae94e54eddda68a1e060743, 2019-04-06 11:37:41 -0700, Soumith Chintala, 6, 0, 6, LINK)"
19003,1,42,8,50,"(fb9fbc009c9de3f4eb5fe49fc91fe73cbae51e0d, 2019-06-11 15:07:08 -0700, Ejaaz Merali, 42, 8, 50, LINK)"
19017,1,11,2,13,"(3bfdffe4870dda10e8b99a77cd6e0b034adbcd2b, 2019-04-08 23:10:51 -0700, peter, 11, 2, 13, LINK)"
1903,1,1,1,2,"(bb16e8dacb4fb62d1d1969f996e2f3387630b5db, 2019-04-04 12:57:31 -0700, Lu Fang, 1, 1, 2, LINK)"
19039,1,47,8,55,"(236c2b238724364129e9670b42a555e976fd635b, 2019-04-26 13:03:50 -0700, Wanchao Liang, 47, 8, 55, LINK)"
1905,1,1,1,2,"(bb16e8dacb4fb62d1d1969f996e2f3387630b5db, 2019-04-04 12:57:31 -0700, Lu Fang, 1, 1, 2, LINK)"
19076,1,22,8,30,"(2f5eefe525d2602222117de8ab990ec495763cc1, 2020-01-07 10:27:47 -0800, Sameer Deshmukh, 22, 8, 30, LINK)"
19077,1,8,1,9,"(1858773c0c1395bc7fdccc16c7d5ad08b6d37682, 2019-04-10 11:05:54 -0700, iurii zdebskyi, 8, 1, 9, LINK)"
1909,2,394,2,396,"(72e171dc52540093c8ad4b6b539ce30ea200e6fd, 2019-04-08 23:12:58 -0700, Lu Fang, 1, 1, 2, LINK), (8635078d9ed47266e6df89ad5ef887b598a76f25, 2019-03-27 19:47:43 -0700, Sam Pepose, 393, 1, 394, LINK)"
1910,1,1,1,2,"(72e171dc52540093c8ad4b6b539ce30ea200e6fd, 2019-04-08 23:12:58 -0700, Lu Fang, 1, 1, 2, LINK)"
1911,1,1,1,2,"(72e171dc52540093c8ad4b6b539ce30ea200e6fd, 2019-04-08 23:12:58 -0700, Lu Fang, 1, 1, 2, LINK)"
19161,1,1,1,2,"(6d790c3611ef26be9a9407e1d286ff528b3c056c, 2020-03-13 15:16:31 -0700, Nikita Shulga, 1, 1, 2, LINK)"
19184,1,26,53,79,"(87d10d49f476cdf6db0eda0f2dea57adf9ece057, 2019-06-06 13:45:41 -0700, ThisIsIsaac, 26, 53, 79, LINK)"
1919,1,1,1,2,"(789c438d868937810b8ffb00271de11d9f598b89, 2019-04-18 00:33:00 -0700, Lu Fang, 1, 1, 2, LINK)"
1920,1,1,1,2,"(2ad242bee9db420f451c9ac5fb7ee533d9b753ff, 2018-03-01 14:22:25 +0800, wjcskqygj2015, 1, 1, 2, LINK)"
19219,1,51,0,51,"(7caad0ed33f20c7ec4fab47a9ee7006973afce08, 2019-04-15 11:13:33 -0700, Sam Gross, 51, 0, 51, LINK)"
19224,1,238,92,330,"(973d51079b3c406d6bd6e627c4179e1011ebae78, 2019-04-18 06:33:08 -0700, Tongzhou Wang, 238, 92, 330, LINK)"
19227,1,40,0,40,"(272fb3635fd599f7d9832b6a0c9063d27ee30a9d, 2020-07-23 09:26:25 -0700, Edgar Andrés Margffoy Tuay, 40, 0, 40, LINK)"
19250,1,40,20,60,"(602394e996e9ac16ae2fb8c1c47b07c2db17d224, 2020-01-27 08:57:03 -0800, Sameer Deshmukh, 40, 20, 60, LINK)"
19253,1,36,19,55,"(b9291f55bb5e16e5acb9c8e9e2cb69bac56e8ab1, 2019-04-18 17:52:33 -0700, Thomas Viehmann, 36, 19, 55, LINK)"
19259,1,5,0,5,"(3fcee4875c4383bff78917284875f180ad41903c, 2019-04-17 04:31:46 -0700, Bharat123rox, 5, 0, 5, LINK)"
19260,1,85,2,87,"(ffdce79078438c8722eccc87d9d68396559b97e4, 2019-05-28 21:18:37 -0700, Hans Lee, 85, 2, 87, LINK)"
1928,1,1,1,2,"(80d067e70f0862e132bafd7b24563f168cd3a36b, 2017-07-14 21:45:25 +0100, Kai Arulkumaran, 1, 1, 2, LINK)"
1929,1,1,1,2,"(789c438d868937810b8ffb00271de11d9f598b89, 2019-04-18 00:33:00 -0700, Lu Fang, 1, 1, 2, LINK)"
1930,1,1,1,2,"(789c438d868937810b8ffb00271de11d9f598b89, 2019-04-18 00:33:00 -0700, Lu Fang, 1, 1, 2, LINK)"
19314,1,125,8,133,"(725ef26f344588884f9f803d687711af5a7f300a, 2019-05-01 17:54:28 -0700, Nikolay Korovaiko, 125, 8, 133, LINK)"
19326,1,3,2,5,"(ff4a4d615582e9d5d4941405323fea96da04d9d7, 2019-04-17 12:49:37 -0700, Vitaly Fedyunin, 3, 2, 5, LINK)"
19354,1,114,8,122,"(a5c4348d54cc7736e5574ac56d890695197339ed, 2019-04-18 14:51:37 -0700, Pieter Noordhuis, 114, 8, 122, LINK)"
19363,1,48,9,57,"(3a39ce0f419ef8dd88c10ed72aef83c9d5f22c7f, 2019-05-10 17:03:44 -0700, davidriazati, 48, 9, 57, LINK)"
19366,1,5,2,7,"(9ef8eb4cbcb3909e66cdc125cf00f7d1a471707b, 2019-04-25 16:24:10 -0700, Spandan Tiwari, 5, 2, 7, LINK)"
19372,1,68,0,68,"(5119cc7cdf01093747713410dc27c3ab22b28ba3, 2019-04-23 16:30:49 -0700, Elias Ellison, 68, 0, 68, LINK)"
19374,1,609,15,624,"(93d5503f34ab54c915b640d3bc45d41e6afe0dd2, 2019-05-23 14:45:22 -0700, Peyman Manikashani, 609, 15, 624, REGEX)"
19394,3,56,12,68,"(aa8b7ad9896cc0995d59f989e97a26da7a73e8c7, 2020-03-24 23:49:17 -0700, Gabe Schwartz, 25, 5, 30, LINK), (d6377b7cef0c7bc822df80eedd86689bc51e83d2, 2020-03-24 23:49:17 -0700, Gabe Schwartz, 25, 5, 30, LINK), (2dd71b18c4bfc07bc07cafbd14e83e23add9e88f, 2019-07-02 09:39:52 -0700, Dave Kotfis, 6, 2, 8, LINK)"
1941,1,1,1,2,"(789c438d868937810b8ffb00271de11d9f598b89, 2019-04-18 00:33:00 -0700, Lu Fang, 1, 1, 2, LINK)"
1942,1,3,1,4,"(5025d1d5e40e2fc298963fe0c93e8465edd95cdd, 2019-04-25 10:48:56 -0700, Lu Fang, 3, 1, 4, LINK)"
19462,1,1,1,2,"(c8083e029270b73a3166af5aaf53176003ff28af, 2019-06-06 09:43:00 -0700, Will Feng, 1, 1, 2, LINK)"
1950,2,6,3,9,"(5a796d15be92a58a2387e0c05d9f0f613893df74, 2019-04-22 17:24:57 -0700, Lu Fang, 3, 1, 4, LINK), (54cabb8bf3d866797347aeea28b0a202bea9d0a6, 2017-07-14 04:29:31 +0800, lynic, 3, 2, 5, LINK)"
19502,1,2,2,4,"(c571969148d3464060298640fd446808bff02345, 2019-04-24 23:09:26 -0700, Wanchao Liang, 2, 2, 4, LINK)"
1951,1,3,1,4,"(5a796d15be92a58a2387e0c05d9f0f613893df74, 2019-04-22 17:24:57 -0700, Lu Fang, 3, 1, 4, LINK)"
1952,1,15,9,24,"(9a726a0770ce43ea3e551accc188a8edd02dd7b8, 2018-02-13 11:41:52 -0800, Pieter Noordhuis, 15, 9, 24, LINK)"
1953,1,3,1,4,"(5a796d15be92a58a2387e0c05d9f0f613893df74, 2019-04-22 17:24:57 -0700, Lu Fang, 3, 1, 4, LINK)"
19540,1,190,0,190,"(b7b6b612a7ed28d7f6a794961690b92d60fe15e4, 2019-06-06 11:54:22 -0700, Shen Li, 190, 0, 190, LINK)"
19545,1,43,23,66,"(a48cf8f52ddf8f23d307c2bd086f80a101dc6092, 2019-07-08 10:16:40 -0700, Pavel Belevich, 43, 23, 66, LINK)"
1955,2,10,2,12,"(90a8cdfdbf7e4c81a105815d299226d1b5531388, 2020-05-27 18:52:03 -0700, Lu Fang, 5, 1, 6, LINK), (51274b501ad560a1f962dac5dd0294b433fe5532, 2020-05-26 20:09:44 -0700, Lu Fang, 5, 1, 6, LINK)"
1959,2,10,2,12,"(90a8cdfdbf7e4c81a105815d299226d1b5531388, 2020-05-27 18:52:03 -0700, Lu Fang, 5, 1, 6, LINK), (51274b501ad560a1f962dac5dd0294b433fe5532, 2020-05-26 20:09:44 -0700, Lu Fang, 5, 1, 6, LINK)"
1961,1,236,160,396,"(0d641145a1b21d3274072215b1f41c8a61ae81a9, 2018-02-21 00:39:00 -0500, Yangqing Jia, 236, 160, 396, LINK)"
1962,1,1,1,2,"(002009b5a99f225d898600f13c55087e2ab39cc9, 2019-05-01 22:07:53 -0700, Lu Fang, 1, 1, 2, LINK)"
1964,1,1,1,2,"(20c22bcae4c86c33b4698fefdb6ba41936ab1a2f, 2019-04-25 22:20:30 -0700, Lu Fang, 1, 1, 2, LINK)"
1965,1,1,1,2,"(20c22bcae4c86c33b4698fefdb6ba41936ab1a2f, 2019-04-25 22:20:30 -0700, Lu Fang, 1, 1, 2, LINK)"
19650,1,133,109,242,"(0effe1d4a4d2cc8e16168f69746c5bb738a30bc7, 2019-04-25 10:07:53 -0700, Ailing Zhang, 133, 109, 242, LINK)"
1977,2,7,3,10,"(965c3b27616be6ed3dbc0b0fa4823f2c41ac7895, 2019-04-30 11:53:35 -0700, Lu Fang, 1, 1, 2, LINK), (b07980334cd8e642883dcadf65fef832925bb39b, 2018-03-09 13:44:41 -0800, sf-wind, 6, 2, 8, LINK)"
1978,1,1,1,2,"(965c3b27616be6ed3dbc0b0fa4823f2c41ac7895, 2019-04-30 11:53:35 -0700, Lu Fang, 1, 1, 2, LINK)"
1979,2,11,9,20,"(965c3b27616be6ed3dbc0b0fa4823f2c41ac7895, 2019-04-30 11:53:35 -0700, Lu Fang, 1, 1, 2, LINK), (0074dc7fa8bcada785c26e3379369d8855ceb1e1, 2018-02-20 14:45:53 -0800, sf-wind, 10, 8, 18, LINK)"
1980,1,1,1,2,"(48e649b8039a29a48cdb8f9a6a8d44250a118461, 2019-05-07 17:26:20 -0700, Lu Fang, 1, 1, 2, LINK)"
1981,2,15,7,22,"(7e4ac8b851b9a4fa50addaf959842130d4920d7c, 2019-09-12 11:39:26 -0700, Lu Fang, 6, 1, 7, LINK), (5e4acd032beea29effd722ccb655b8aca5e96a37, 2018-02-20 21:49:05 -0800, bddppq, 9, 6, 15, LINK)"
1982,1,1,1,2,"(965c3b27616be6ed3dbc0b0fa4823f2c41ac7895, 2019-04-30 11:53:35 -0700, Lu Fang, 1, 1, 2, LINK)"
1984,1,1,1,2,"(002009b5a99f225d898600f13c55087e2ab39cc9, 2019-05-01 22:07:53 -0700, Lu Fang, 1, 1, 2, LINK)"
1985,1,1,1,2,"(48e649b8039a29a48cdb8f9a6a8d44250a118461, 2019-05-07 17:26:20 -0700, Lu Fang, 1, 1, 2, LINK)"
1988,1,1,1,2,"(48e649b8039a29a48cdb8f9a6a8d44250a118461, 2019-05-07 17:26:20 -0700, Lu Fang, 1, 1, 2, LINK)"
1989,1,4,2,6,"(7283d5194a71e5fb47baa7025f7d3874b8fab3c6, 2018-02-20 12:10:17 -0800, bddppq, 4, 2, 6, LINK)"
1991,3,4,4,8,"(2588f5de063a0c5aa64d56b82bd31e0050c9c78c, 2018-02-20 21:39:50 -0800, bddppq, 1, 1, 2, LINK), (6bcbecfb97040e2f03a04f40adebc6d2b6d0d5d8, 2017-08-25 05:04:53 +0800, Tzu-Wei Huang, 2, 2, 4, LINK), (c011d4f3d605199f06a063d69b43a1fa98fb1d23, 2017-07-13 21:57:33 +0800, Tzu-Wei Huang, 1, 1, 2, LINK)"
19947,1,10,0,10,"(916eee182c9dc8d335501f6672842c6d29f0af58, 2019-09-20 14:09:56 -0700, Rajan Singh, 10, 0, 10, LINK)"
1995,1,1,1,2,"(2dc9152dbedced00a848c82c1c7642eed54e67f6, 2019-05-13 14:43:45 -0700, Lu Fang, 1, 1, 2, LINK)"
19961,1,3,0,3,"(cf55670bddf6bb5f6199df2c543c8fb4ca21b08e, 2019-05-07 08:31:23 -0700, sdg, 3, 0, 3, LINK)"
1997,1,19,13,32,"(090850e89b9dba4f70ae9c53325136dc116cd3cc, 2018-02-21 18:48:30 -0800, Paul Jesse Hellemn, 19, 13, 32, LINK)"
1998,1,4,0,4,"(2344decc910c0e655d1076ae8dec76d14b0db9c5, 2018-02-21 21:10:50 -0800, Yinghai Lu, 4, 0, 4, LINK)"
19990,1,1,1,2,"(ff3cc795c8c1ba19814909dfaf63e1e0dd9dc4d8, 2019-07-24 18:27:03 -0700, Edward Yang, 1, 1, 2, LINK)"
19995,1,0,18,18,"(18cb0985883d338f6c0d9c199884e921e83e1083, 2019-05-01 16:21:52 -0700, davidriazati, 0, 18, 18, LINK)"
2,27,7087,3758,10845,"(0b93974075844601913c6df50f6566418a35eee8, 2021-02-25 14:32:13 -0800, Akao Kazutoshi, 2, 2, 4, LINK), (e41e780f7a88c11af380bbcf4b9a53fd9b126cc4, 2020-12-02 08:11:16 -0800, Ivan Yashchuk, 54, 12, 66, LINK), (a1db5b0f2bcd96f1e884ff63ebcf2b01f543a77a, 2020-11-11 10:54:29 -0800, Ivan Yashchuk, 499, 161, 660, LINK), (ad260ae7fd8e295015cef3a911431fb55752a63b, 2020-10-28 19:25:43 -0700, Pritam Damania, 3, 0, 3, LINK), (9e22d15f14a9a5ca4daf88137c25b34900d758ff, 2020-03-27 12:03:42 -0700, Nikolay Korovaiko, 779, 531, 1310, LINK), (336e0d2874c2e74fc98f60d20a3192471ee3300e, 2019-12-17 10:56:50 -0800, Mingbo Wan, 4, 4, 8, LINK), (71aacf7b82b9c6b1f2af7f73aabe3298698bae7e, 2019-11-13 13:50:19 -0800, Ivan Kobzarev, 155, 146, 301, LINK), (6dca14794658ae7a15d4780e0a601aa5f523de96, 2019-08-21 16:39:51 -0700, davidriazati, 755, 579, 1334, LINK), (1d53d0756668ce641e4f109200d9c65b003d05fa, 2019-08-20 21:39:09 -0700, davidriazati, 232, 75, 307, LINK), (465b4de9d4378ac58013b56ea45fe30f9beadb39, 2019-08-12 13:41:00 -0700, Brian Vaughan, 19, 14, 33, LINK), (efd20de2766be012bc539654e335e3807a08be6f, 2019-06-13 15:13:54 -0700, Natalia Gimelshein, 16, 2, 18, LINK), (bad67015fedfa9de0e75999f89a7b661bd6a860f, 2019-06-06 19:24:29 -0700, ptrblck, 5, 2, 7, LINK), (7e6d932208a866551ca1b9ea7f149d48eb3ad413, 2019-06-05 18:03:51 -0700, Junjie Bai, 7, 1, 8, LINK), (b90cbb841d98aeae435b1d02b1ff211e028cdf5b, 2019-04-05 12:44:49 -0700, Joakim Rishaug, 1, 1, 2, LINK), (9de4350b77cd7f257c1c60d325f267d50965531e, 2019-03-14 15:39:25 -0700, Lu Fang, 1, 1, 2, LINK), (be6ad7ddde64cebeec4cd9537ddc3bca9cbe18e5, 2019-02-22 07:54:47 -0800, Will Feng, 8, 8, 16, LINK), (3a47d5694691642c730bf99ccbcaa81f09fcb60e, 2019-02-21 16:05:16 -0800, Soumith Chintala, 17, 3, 20, LINK), (22477c6a7fc327cdf913751ab31b788ec710caa9, 2019-02-07 18:15:44 -0800, Freddie Mendoza, 1, 0, 1, LINK), (cb86ae304e3de685e7fb0d14d4c8d2191d494ae0, 2018-11-16 11:32:34 -0800, Michael Suo, 185, 82, 267, LINK), (cee19eb31cb661a0f7fb44b31ef5cc8fc9fabf15, 2018-10-11 09:44:45 -0700, Orion Reblitz-Richardson, 1024, 1033, 2057, LINK), (0b78ae86c59e7372f0b9d4cadcd0e50bc76f8667, 2018-09-10 15:30:08 -0700, Owen Anderson, 77, 29, 106, LINK), (b875fb281c92dbe88da279a0ff7ad342e7b28b9e, 2018-05-10 23:14:27 -0700, Paul Jesse Hellemn, 2549, 779, 3328, LINK), (4664808938b22c22abd216008926ecd81cb0c5e5, 2017-09-24 17:07:30 -0700, Igor Sugak, 1, 1, 2, LINK), (efda016108f16d4ac6087a3bcb0909729c1a7e11, 2017-09-13 23:17:05 -0700, Philip Pronin, 2, 2, 4, LINK), (d66fb63679cc9dbbaefc09d227e98f39d43a1f21, 2017-08-04 09:43:29 -0700, Sylvain Jeaugey, 3, 2, 5, LINK), (98d8e0b0402e757083574eb6bc59cd3b77d925a3, 2017-03-09 19:37:04 +0100, Filip Binkiewicz, 402, 263, 665, LINK), (0e298ec399ded7cd47009dd3c79c63f5cff8f259, 2016-11-21 10:48:05 -0800, Yangqing Jia, 286, 25, 311, LINK)"
20,3,590,545,1135,"(b186831c08e0e4e447eedb8a5cfab582995d37f9, 2020-10-07 09:53:52 -0700, Yinghai Lu, 1, 1, 2, LINK), (f2d7e949484826d5c1103d4c3be7736039a92b48, 2016-10-26 09:51:52 -0700, Sam Gross, 588, 472, 1060, LINK), (f5a7c8f633835d2297c51aad7bf1b1cb59531ab7, 2014-06-15 12:40:57 -0400, Soumith Chintala, 1, 72, 73, LINK)"
20017,1,50,1,51,"(410c7210db40622faf739d17a339b28058adafc6, 2019-05-20 16:03:16 -0700, davidriazati, 50, 1, 51, LINK)"
2002,1,8,5,13,"(cbd1fd6c859d8db9c970d65ea657429732e14dad, 2018-02-22 20:31:33 -0800, Yinghai Lu, 8, 5, 13, LINK)"
20030,1,38,10,48,"(9c62280ea832ad2ea8fc7746cfd515af5360976f, 2019-05-07 16:54:40 -0700, Jesse Hellemn, 38, 10, 48, LINK)"
20046,1,17,16,33,"(85f33a4738b6c654d87dac71b9ad15cf2a6aa571, 2019-10-09 16:35:42 -0700, Peter Bell, 17, 16, 33, LINK)"
20052,1,16,1,17,"(c406bf20a00ba69e4336a8ff9df18ca33ce57af9, 2019-05-09 07:04:23 -0700, Brian Vaughan, 16, 1, 17, LINK)"
2006,1,110,25,135,"(07513cfd1d284a058810efca9107f0697bba55ab, 2018-05-03 03:50:29 +0200, Thomas Viehmann, 110, 25, 135, LINK)"
20067,1,5,653,658,"(75868683dc84b2e5c7eaf9055ddbfd04be0fccdd, 2019-05-02 10:50:03 -0700, Jesse Hellemn, 5, 653, 658, LINK)"
20074,1,3,0,3,"(792bc56ec2edd2371c1bd8f5f8ef49e010341613, 2019-05-02 20:29:50 -0700, Amir Arsalan Soltani, 3, 0, 3, LINK)"
20075,1,229,30,259,"(8ca93ec351a8b97c0e961824e18b8012623d3ad7, 2019-09-11 13:37:20 -0700, Lara Haidar, 229, 30, 259, LINK)"
2009,1,1,1,2,"(428104c60a07938f97f33ab1b6c68c3ea91abb81, 2019-05-15 15:04:10 -0700, Lu Fang, 1, 1, 2, LINK)"
2011,1,10,6,16,"(38f18c1daa47b75ccd2cc04fe36b5c028db2e2eb, 2018-02-22 17:43:33 -0800, anderspapitto, 10, 6, 16, LINK)"
20113,1,100,49,149,"(479c3b0aa5b8d793230446c304903bd06ca1ba2a, 2020-03-05 14:42:56 -0800, Elias Ellison, 100, 49, 149, LINK)"
2013,1,34,17,51,"(51897e52da278c70722b8faeeec60c5cada73fab, 2018-02-22 17:43:53 -0800, Bram Wasti, 34, 17, 51, LINK)"
20130,1,26,0,26,"(0087069dce5ced2e6a09811e8727b612d4a654fc, 2019-05-09 06:01:57 -0700, Will Feng, 26, 0, 26, LINK)"
20132,1,74,60,134,"(41673d477c276ca7efb67bffb260cf2015011d48, 2019-05-13 08:16:04 -0700, Guanheng Zhang, 74, 60, 134, LINK)"
20153,1,120,53,173,"(a24f6c13a368c407b408045e0f82c8b18f991036, 2019-07-22 17:51:43 -0700, Horace He, 120, 53, 173, LINK)"
20155,1,11,8,19,"(8726b273334a1ae772d3a36784db89515ecd77d4, 2019-05-10 06:41:48 -0700, peter, 11, 8, 19, LINK)"
20169,1,1,1,2,"(f8aa6a8f44764713bdec006ac8014e453325ad28, 2019-05-13 08:00:34 -0700, Clément Pinard, 1, 1, 2, LINK)"
20178,1,3,3,6,"(be644d822b9912677c2cc7fa8b5f568f93728fe0, 2019-07-29 11:55:09 -0700, shihongzhi, 3, 3, 6, LINK)"
20198,1,1,4,5,"(ba3e6de4c230c140ca98ac7f12012db5faf4a680, 2019-05-07 15:55:30 -0700, Gao Xiang, 1, 4, 5, LINK)"
20202,1,33,3,36,"(d6f62b70f3f889b3c95495a99377a9bb13d8b273, 2019-05-08 06:05:01 -0700, peter, 33, 3, 36, LINK)"
20208,1,56,60,116,"(71260b98e2b215b166d5515b496ceee4a36dd86d, 2019-05-20 08:01:47 -0700, Iurii Zdebskyi, 56, 60, 116, LINK)"
2021,1,18,21,39,"(ff189b9023b05d40740cbaa4f897cb1e3a934e37, 2018-02-24 00:02:18 -0800, Yangqing Jia, 18, 21, 39, LINK)"
20215,2,24,27,51,"(899bddeeb6054e89c30cda704f9fe816b5e18f9c, 2019-05-09 09:10:18 -0700, Ailing Zhang, 20, 23, 43, LINK), (10715ffc308a40449772cdac554712b7950f15c1, 2019-05-08 07:16:08 -0700, Stefan Krah, 4, 4, 8, LINK)"
2025,1,5,3,8,"(37dec493a53b306f0178eadcdf0af4360bfda044, 2018-03-02 22:21:07 -0800, Pooya Davoodi, 5, 3, 8, LINK)"
20250,2,3,1,4,"(2a875fc126c73833e59756eea34c9bbcf54a6362, 2019-05-10 06:45:36 -0700, xkszltl, 1, 1, 2, LINK), (1e35ef07e9fa6781e85c3e915295adeca53bceb1, 2019-05-09 06:18:37 -0700, peter, 2, 0, 2, LINK)"
2027,1,58,14,72,"(e387d945c227a0e50672b9e6c28b79620b7d26c8, 2018-11-19 09:45:28 -0800, Ailing Zhang, 58, 14, 72, LINK)"
2028,1,1,1,2,"(810816a1f95e4bbbd9b7416d317875aecc5f40a5, 2019-05-22 11:33:49 -0700, Lu Fang, 1, 1, 2, LINK)"
20287,1,213,36,249,"(f0829f37c8cfe7c1da4d2b1d9b4c8329b190ed26, 2019-05-13 15:57:57 -0700, Edward Yang, 213, 36, 249, LINK)"
20301,1,1,1,2,"(2aea5b63350edac33f6455ef13636685f4d6e201, 2019-05-09 06:15:42 -0700, Zayd Hammoudeh, 1, 1, 2, LINK)"
2031,3,302,19,321,"(d6ee58494f816b9784a974c9d5a5c95376a3a55b, 2019-09-24 05:36:12 -0700, Lu Fang, 6, 1, 7, LINK), (c2721ab5039466ced3af077fae14d8ee578ff484, 2018-03-07 15:16:51 -0800, theweiho, 246, 2, 248, LINK), (ff3ef8301c69e9d6940da253ad44fc8e04ec0e30, 2018-02-23 18:47:14 -0800, Paul Jesse Hellemn, 50, 16, 66, LINK)"
2032,1,1,1,2,"(810816a1f95e4bbbd9b7416d317875aecc5f40a5, 2019-05-22 11:33:49 -0700, Lu Fang, 1, 1, 2, LINK)"
20322,2,10,1,11,"(c0f51142cd038792869fe98b6a6c0b98ea399644, 2019-06-18 13:38:35 -0700, Iurii Zdebskyi, 5, 0, 5, LINK), (4b45f08f8765549915417997c30ae8981f2ad125, 2019-06-13 13:07:57 -0700, Iurii Zdebskyi, 5, 1, 6, LINK)"
2035,1,2,1,3,"(07ac00d21ab07803fd2ebdb1cd4e86a1d7c98a48, 2019-05-30 17:29:53 -0700, Lu Fang, 2, 1, 3, LINK)"
20356,1,247,103,350,"(2a7a39c1af96fc7816c886644eaf127c5ab53b89, 2019-11-23 00:04:23 -0800, davidriazati, 247, 103, 350, LINK)"
20376,4,674,406,1080,"(ba1bd4176722f831a548dd69e34951189bc440e1, 2020-03-03 14:33:40 -0800, Edward Yang, 195, 114, 309, LINK), (6273ec11d9d68ba4b63675458c9cdc382676c8b4, 2020-02-28 11:59:00 -0800, Edward Z. Yang, 195, 114, 309, LINK), (86a1b588b586d3b303b3f5ad6e6471a214806e52, 2020-02-26 11:37:43 -0800, Edward Z. Yang, 142, 89, 231, LINK), (49c15a93cf299d41eb12f96a8eda3412b50bc615, 2020-02-26 11:36:12 -0800, Edward Z. Yang, 142, 89, 231, LINK)"
2038,1,3,0,3,"(0f0f7957e423cea1cbe3cfed700873d6e1fee32b, 2018-02-23 21:19:15 -0800, Yangqing Jia, 3, 0, 3, LINK)"
20408,1,8,0,8,"(101067703e1602f790b9a4e04017875916119bd3, 2019-05-15 07:25:46 -0700, peter, 8, 0, 8, LINK)"
20421,1,28,3,31,"(39d412194f1e51338bb0a897742480e11b8e5a2b, 2019-06-12 11:55:47 -0700, Shen Li, 28, 3, 31, LINK)"
20449,1,119,2,121,"(90ffab6e3713a40f47f4c9d3d3b16d56e83f97c4, 2019-09-25 17:34:50 -0700, Natalia Gimelshein, 119, 2, 121, LINK)"
2045,1,22,28,50,"(80430501c9ad17164860fcbbc86e9a027bff106c, 2018-02-24 16:15:28 -0800, Yangqing Jia, 22, 28, 50, LINK)"
20457,1,442,224,666,"(ad971a37d0c5732296dcfb186211cc6e285efc89, 2019-06-03 11:35:33 -0700, Natalia Gimelshein, 442, 224, 666, LINK)"
20465,1,35,21,56,"(87d3f6650648dbd44fd1d6e91bd65227e0d68214, 2019-07-24 14:42:46 -0700, Stefan Krah, 35, 21, 56, LINK)"
2049,1,8,44,52,"(1f9df59de99fab78f30030404c49c25e52997b16, 2018-02-24 23:31:36 -0800, Yangqing Jia, 8, 44, 52, LINK)"
20495,1,57,31,88,"(52d27890dc4bea72f58d7b861201ea5ab5986c29, 2019-05-28 12:21:55 -0700, Horace He, 57, 31, 88, LINK)"
20499,1,15,2,17,"(66c61332647daf311ac7bf475e02966a0bd3d034, 2019-05-16 09:27:27 -0700, Natalia Gimelshein, 15, 2, 17, LINK)"
2050,2,31,68,99,"(07ac00d21ab07803fd2ebdb1cd4e86a1d7c98a48, 2019-05-30 17:29:53 -0700, Lu Fang, 2, 1, 3, LINK), (c3320887fe9470f01519aa65ccbeb1bcafc60617, 2018-02-26 12:45:06 -0800, Yangqing Jia, 29, 67, 96, LINK)"
20500,2,308,89,397,"(0f42881269d10056108e51320533ea2e55ade221, 2019-09-19 15:44:44 -0700, Elias Ellison, 158, 42, 200, LINK), (a8073f34afc4e2a708af833e6d5ca773ddd9d72b, 2019-09-17 13:46:20 -0700, Elias Ellison, 150, 47, 197, LINK)"
20522,1,7,7,14,"(aa42742df0ea7bee8281f15265efae0351ebfbdc, 2019-05-29 05:07:39 -0700, Thomas Viehmann, 7, 7, 14, LINK)"
20523,1,4,1,5,"(4c806a9e8a0fd3a40a392bed3b3f0859188609d1, 2019-05-17 07:11:37 -0700, vishwakftw, 4, 1, 5, LINK)"
20525,1,5,1,6,"(f4b434a6a53d9fe45283aee8572174f94a79f558, 2019-05-27 23:41:27 -0700, peter, 5, 1, 6, LINK)"
20527,2,837,183,1020,"(28b1f586f669c6c14d5eabffa162b59f0f4d853d, 2019-10-04 08:51:03 -0700, Vincent Quenneville-Belair, 401, 92, 493, LINK), (939ae80de14deb87ae2fd5f90f32e5d504689bbb, 2019-09-13 07:31:35 -0700, Vincent Quenneville-Belair, 436, 91, 527, LINK)"
20529,1,4,1,5,"(3feb40d602490a99d2794b2b5d5fc35a2657b919, 2019-06-06 13:38:44 -0700, Thomas Viehmann, 4, 1, 5, LINK)"
20535,2,4,4,8,"(eb51131fb4be155005506a76a4d506e5dc1e7741, 2019-07-24 11:06:45 -0700, Jesse Hellemn, 2, 2, 4, LINK), (7203612f852e57b3f1667a614444bbb24beec7fb, 2019-07-24 08:06:31 -0700, Edward Yang, 2, 2, 4, LINK)"
2054,1,2,1,3,"(07ac00d21ab07803fd2ebdb1cd4e86a1d7c98a48, 2019-05-30 17:29:53 -0700, Lu Fang, 2, 1, 3, LINK)"
20548,1,1,1,2,"(4e0d098ace3492847d3d2a426441eac1de4c1977, 2019-05-22 11:23:46 -0700, Michael Kösel, 1, 1, 2, LINK)"
2055,2,11,7,18,"(ec547ce640581846d0c5afdc334beaec5da9e745, 2018-02-26 11:04:04 -0800, anderspapitto, 4, 4, 8, LINK), (f98c38497398ac2adb43e8d04b491d6f2e126fdf, 2017-07-13 21:56:12 +0800, lynic, 7, 3, 10, LINK)"
20568,1,3,1,4,"(3bc0bd953482e079827a96a9f6c5509c43b7c7c9, 2019-05-17 07:14:53 -0700, peter, 3, 1, 4, LINK)"
20579,1,1,1,2,"(99b3f5cd705018c96b5559daa89aa71e66fc7e8a, 2019-05-23 10:13:07 -0700, Federico Baldassarre, 1, 1, 2, LINK)"
2059,1,1737,0,1737,"(5e0a3e99bc8259a8d03096ca791446764e580ece, 2018-02-27 12:27:41 -0800, Di Yu, 1737, 0, 1737, LINK)"
2060,1,6,1,7,"(d6ee58494f816b9784a974c9d5a5c95376a3a55b, 2019-09-24 05:36:12 -0700, Lu Fang, 6, 1, 7, LINK)"
2062,1,1,1,2,"(0955e791d35adf783d660cd203fe81e162f306d6, 2018-02-27 15:04:01 -0800, Yinghai Lu, 1, 1, 2, LINK)"
20630,1,1,1,2,"(4c5b1e3460294a57141ebeafa77212a17a25eda5, 2019-05-26 12:57:26 -0700, Shen Li, 1, 1, 2, LINK)"
20635,1,15,5,20,"(8fcd80af200cea42759ef4fc8b1e7ee704eaa673, 2019-05-29 14:26:16 -0700, peter, 15, 5, 20, LINK)"
20642,1,1,1,2,"(5f83c5d8349fb0c3645146efe7ad4b4f20fca457, 2019-05-23 12:00:11 -0700, Jonas1312, 1, 1, 2, LINK)"
20651,1,46,10,56,"(8acaa286b76adda792dc59948efc5e8621d8447e, 2019-05-20 07:11:12 -0700, Shen Li, 46, 10, 56, LINK)"
20743,1,45,5,50,"(34536e207ae48564fb559b7801d69b3ada4af6be, 2019-06-19 00:06:08 -0700, hexiaoting, 45, 5, 50, LINK)"
20755,1,13,0,13,"(7a0c6d528a12037495847e83bdcd09f7acc1e736, 2019-05-21 14:47:41 -0700, Sam Gross, 13, 0, 13, LINK)"
20757,1,33,12,45,"(a16708a1ae85542794437b0ba5028359fdf3b156, 2019-05-23 09:39:09 -0700, Ailing Zhang, 33, 12, 45, LINK)"
2076,1,2,1,3,"(c2a08d339b373cf3df70283d0c479cecfa3104b3, 2019-06-11 16:50:07 -0700, Lu Fang, 2, 1, 3, LINK)"
20781,1,33,12,45,"(a16708a1ae85542794437b0ba5028359fdf3b156, 2019-05-23 09:39:09 -0700, Ailing Zhang, 33, 12, 45, LINK)"
20785,2,2347,1352,3699,"(74b65c32be68b15dc7c9e8bb62459efbfbde33d8, 2019-08-21 21:16:12 -0700, bnehoran, 1270, 684, 1954, LINK), (87217cfd2a16171ffed5fa6ead66afc9878534f4, 2019-08-19 09:44:09 -0700, Barak Nehoran, 1077, 668, 1745, LINK)"
20823,1,34,0,34,"(c68119387d7b1b24c796a041bdcfa1f6b627e5fa, 2019-06-25 10:41:16 -0700, Ailing, 34, 0, 34, LINK)"
2083,1,1,1,2,"(d4119f8fcbde15569b8f2993973439f2961ea22a, 2019-06-20 15:45:25 -0700, Lu Fang, 1, 1, 2, LINK)"
2085,1,1,1,2,"(d4119f8fcbde15569b8f2993973439f2961ea22a, 2019-06-20 15:45:25 -0700, Lu Fang, 1, 1, 2, LINK)"
20862,1,80,2,82,"(029c8e7754625c4652a169888ea2c5806e043520, 2019-08-01 09:43:57 -0700, Elias Ellison, 80, 2, 82, LINK)"
2088,1,1,1,2,"(d4119f8fcbde15569b8f2993973439f2961ea22a, 2019-06-20 15:45:25 -0700, Lu Fang, 1, 1, 2, LINK)"
20888,1,25,10,35,"(b93bdf6989ee96502512eb298dcfc267974dcc12, 2019-05-24 16:16:54 -0700, Sam Gross, 25, 10, 35, LINK)"
20895,1,9,1,10,"(ebc8d7170e352a0f403ed8e175094fde28ef5563, 2019-05-27 12:06:46 -0700, xiaobing.zhang, 9, 1, 10, LINK)"
2091,1,1,1,2,"(544aeaec62deda7279aea5d200a60f4a2379789f, 2018-02-28 22:44:13 -0800, Yinghai Lu, 1, 1, 2, LINK)"
20926,1,7,11,18,"(430d1a2761ab85ce8e8a3b6f81f7106481a4973a, 2019-05-24 15:46:33 -0700, Sam Gross, 7, 11, 18, LINK)"
2093,1,1,1,2,"(c96338ee2c18ed30e6162cde9ca33c36991ded72, 2018-02-28 23:59:01 -0800, Paul Jesse Hellemn, 1, 1, 2, LINK)"
20939,4,647,189,836,"(7a370dbb41ba14a5fc95c7a3d3fecd83489edad9, 2019-07-16 12:50:02 -0700, davidriazati, 69, 94, 163, LINK), (2f4824b2fb199e77424aabfddf42b73ffb1450ff, 2019-05-31 14:20:57 -0700, davidriazati, 275, 45, 320, LINK), (e13b483f58bf06bb368392710bb8b44e606a02c2, 2019-05-31 10:28:39 -0700, davidriazati, 21, 4, 25, LINK), (8d3388aef2b6b109e45d0c58da720601aa1e94cd, 2019-05-29 18:46:40 -0700, davidriazati, 282, 46, 328, LINK)"
2094,1,120,36,156,"(56096c2311d0f8477304ebeb57aee336e80d54c6, 2018-03-01 12:01:44 -0800, Yangqing Jia, 120, 36, 156, LINK)"
2095,1,1,0,1,"(72aa83d70237fc286f81070001b4535a2f20931e, 2018-03-01 00:09:33 -0800, bddppq, 1, 0, 1, LINK)"
20978,1,18,15,33,"(736bf7b46c0458875af2eee36072794f054c5bc4, 2019-05-29 13:48:34 -0700, davidriazati, 18, 15, 33, LINK)"
2098,1,1,1,2,"(9e18234109778fc5ab6f03fc00164d3468102e01, 2019-06-28 22:11:01 -0700, Lu Fang, 1, 1, 2, LINK)"
20988,1,1849,145,1994,"(44ce0b8883abb20d8ae71c3ab5f21b8bbadc6902, 2020-12-21 11:51:52 -0800, Alexander, 1849, 145, 1994, LINK)"
21,1,1,1,2,"(8a822d48f50694010c347add0deebfbe76a3be01, 2017-04-05 12:55:23 -0700, Pieter Noordhuis, 1, 1, 2, LINK)"
21026,1,54,23,77,"(51d0da2802c92d2e66826099729a43303218abc8, 2019-06-06 13:41:19 -0700, Mingzhe Li, 54, 23, 77, LINK)"
2104,2,5,1,6,"(d4119f8fcbde15569b8f2993973439f2961ea22a, 2019-06-20 15:45:25 -0700, Lu Fang, 1, 1, 2, LINK), (ec3c299baf66c22e721e364d2d7ca9823503e8e3, 2018-03-02 11:36:08 -0800, Paul Jesse Hellemn, 4, 0, 4, LINK)"
21044,1,12,0,12,"(b7d90332eabd2a2ddbe328e8ac60e09ad68e3b66, 2019-07-24 14:32:00 -0700, Ailing Zhang, 12, 0, 12, LINK)"
21076,1,119,47,166,"(af638ad5d7c8fc9ff97f0ad1cd2bbcfa3ced514e, 2019-07-30 21:11:36 -0700, Tongzhou Wang, 119, 47, 166, LINK)"
21081,1,208,83,291,"(8482efb2036475072f26c07e4d7d91e14e5e2c20, 2019-07-16 10:05:53 -0700, SsnL, 208, 83, 291, LINK)"
2110,2,45,41,86,"(bebc3d6aad8cd4b3ff3ccbaf5d8141bc10916df7, 2019-09-17 06:43:15 -0700, Lu Fang, 2, 1, 3, LINK), (fdfe1d09a09b31a1b4bc1282aa182f7c72bdd553, 2018-03-02 16:29:13 -0800, Yangqing Jia, 43, 40, 83, LINK)"
21108,1,40,4,44,"(51ebbe970ada230586aae0677814b4b66f5b00f6, 2019-06-01 10:29:26 -0700, Shen Li, 40, 4, 44, LINK)"
2115,3,52,17,69,"(9e18234109778fc5ab6f03fc00164d3468102e01, 2019-06-28 22:11:01 -0700, Lu Fang, 1, 1, 2, LINK), (9f2a35ee8b8036d9ac8663b88bc74babd8bba57d, 2018-03-05 20:03:43 -0800, Dmytro Dzhulgakov, 2, 4, 6, LINK), (d013e16cf47a61b7cd139b02afb2c14975469c0b, 2018-03-02 18:06:19 -0800, Qinqing Zheng, 49, 12, 61, LINK)"
21167,1,10,7,17,"(be7fc40621719fd881378756ee1945351bd14a99, 2019-06-01 09:44:17 -0700, peter, 10, 7, 17, LINK)"
2117,1,11,1,12,"(818171163701eda56498c3e078d3bef682369fa7, 2020-05-08 21:42:58 -0700, Lu Fang, 11, 1, 12, LINK)"
2119,2,328,596,924,"(7863c17b26c87e8b32fa1c9f6f4c5bbcd2645fe8, 2018-10-24 09:20:13 -0700, Richard Zou, 7, 1, 8, LINK), (558e2a92df05c2e32459bbcbef6b0d46cf84cded, 2018-03-02 16:07:45 -0800, Xiaomeng Yang, 321, 595, 916, LINK)"
2122,2,9,5,14,"(b93f0947a89b97a14b43c7b4ab79cf7a7163756d, 2019-09-24 17:12:27 -0700, Lu Fang, 1, 1, 2, LINK), (eededd3f976adaf19d56b8aa5fe9a36b712b5751, 2018-03-07 11:32:39 -0800, kevinbchen, 8, 4, 12, LINK)"
2124,1,11,14,25,"(e026cb18548e374b12ae844b575a39ee543e6285, 2018-03-03 01:48:57 +0100, Marat Dukhan, 11, 14, 25, LINK)"
21251,1,119,48,167,"(d48cbd62cd822740d9b4f48a243de84f75fdfbc1, 2019-07-07 19:05:20 -0700, SsnL, 119, 48, 167, LINK)"
21257,2,101,30,131,"(9737b166a4788ff57c24c1e59651453dc701d161, 2019-06-11 15:09:19 -0700, vishwakftw, 51, 15, 66, LINK), (bb1dbdb99bb56c49a585c496efe12c6d5115d04f, 2019-06-10 12:01:14 -0700, vishwakftw, 50, 15, 65, LINK)"
2126,1,6,1,7,"(7e4ac8b851b9a4fa50addaf959842130d4920d7c, 2019-09-12 11:39:26 -0700, Lu Fang, 6, 1, 7, LINK)"
21261,1,1,0,1,"(2e59a0a646883f6b20f2e0d0af9c795e629bc115, 2019-06-03 10:11:09 -0700, shihongzhi, 1, 0, 1, LINK)"
21269,1,1,7,8,"(ee15ad1bd614186ce48b776f9bda570a758e20da, 2019-06-06 09:58:49 -0700, Mads R. B. Kristensen, 1, 7, 8, LINK)"
2127,1,6,1,7,"(d6ee58494f816b9784a974c9d5a5c95376a3a55b, 2019-09-24 05:36:12 -0700, Lu Fang, 6, 1, 7, LINK)"
21271,1,97,0,97,"(76e01542ed1ff9892a766efad4bddcc061b9dbab, 2019-06-12 10:56:27 -0700, daquexian, 97, 0, 97, LINK)"
2132,1,1,1,2,"(5c769bd243510e54e757819a0cc9a35e40517ce0, 2018-03-05 15:27:59 -0800, bddppq, 1, 1, 2, LINK)"
2133,1,6,1,7,"(d6ee58494f816b9784a974c9d5a5c95376a3a55b, 2019-09-24 05:36:12 -0700, Lu Fang, 6, 1, 7, LINK)"
2138,1,1,1,2,"(9e18234109778fc5ab6f03fc00164d3468102e01, 2019-06-28 22:11:01 -0700, Lu Fang, 1, 1, 2, LINK)"
2141,2,56,9,65,"(7e4ac8b851b9a4fa50addaf959842130d4920d7c, 2019-09-12 11:39:26 -0700, Lu Fang, 6, 1, 7, LINK), (685ae4813ef634c20bb8892444faf9de1e80eb2c, 2017-07-18 09:08:23 -0700, Edward Z. Yang, 50, 8, 58, LINK)"
21418,1,26,6,32,"(6b9f46b2d0eca208386886c9cc9c76ed351533fb, 2019-06-05 15:13:57 -0700, Edward Yang, 26, 6, 32, LINK)"
21469,1,36,0,36,"(0998a32588a51f204d9b325ec265312420c73070, 2019-06-18 09:10:57 -0700, Igor Fedan, 36, 0, 36, LINK)"
2147,1,2,1,3,"(796a39ba85e6cb14d1fd3a6e7c6322e0b7e28ec2, 2019-07-17 13:57:18 -0700, Lu Fang, 2, 1, 3, LINK)"
21478,1,35,10,45,"(fddf73250d64580c330be50ec38cacddb4b2fa49, 2020-02-26 18:28:47 -0800, Elias Ellison, 35, 10, 45, LINK)"
2149,1,153,57,210,"(0c6e843028673eedce1c809bc36cdc1a8e8664b5, 2018-03-07 12:34:11 -0800, ilia-cher, 153, 57, 210, LINK)"
2150,1,1,1,2,"(58a3e4f71f17794c21386ab085bc0176899e21a0, 2019-07-25 18:22:44 -0700, Lu Fang, 1, 1, 2, LINK)"
21508,2,101,30,131,"(9737b166a4788ff57c24c1e59651453dc701d161, 2019-06-11 15:09:19 -0700, vishwakftw, 51, 15, 66, LINK), (bb1dbdb99bb56c49a585c496efe12c6d5115d04f, 2019-06-10 12:01:14 -0700, vishwakftw, 50, 15, 65, LINK)"
21526,1,11,1,12,"(74828be4a7d0d2dba3f0ec3f6e79265cdfae5329, 2019-06-08 08:36:25 -0700, Brennan Vincent, 11, 1, 12, LINK)"
2154,1,77,76,153,"(7d141d4243956fc200fa9f27c446926b1dfa3df2, 2018-03-06 01:23:54 -0800, Dmytro Dzhulgakov, 77, 76, 153, LINK)"
21545,1,44,0,44,"(902c1f9ef1c3fd4e8a7d2880b4bb44d83a75d740, 2019-11-14 18:26:24 -0800, Elias Ellison, 44, 0, 44, LINK)"
2155,1,1,1,2,"(58a3e4f71f17794c21386ab085bc0176899e21a0, 2019-07-25 18:22:44 -0700, Lu Fang, 1, 1, 2, LINK)"
2156,2,15,27,42,"(71ce3448d959ed97f77460d200dbdbdecd28cf12, 2017-07-20 16:38:36 -0700, Sam Gross, 1, 0, 1, LINK), (2efac3ed83a29f57f914e9044fdddd2ce7ecd6b7, 2017-07-20 16:38:36 -0700, Sam Gross, 14, 27, 41, LINK)"
21584,1,0,3,3,"(5f25a252d6847db951aecbeb0000c53821fb7b63, 2019-06-10 13:24:54 -0700, Sebastian Messmer, 0, 3, 3, LINK)"
21589,1,14,4,18,"(cf5c3bb3fe4c61943bc352005db03cb249acfba0, 2019-06-11 15:24:23 -0700, Natalia Gimelshein, 14, 4, 18, LINK)"
21596,1,557,124,681,"(a347c747df8302acc0007a26f23ecf3355a5bef9, 2021-01-25 16:31:30 -0800, Fritz Obermeyer, 557, 124, 681, LINK)"
21597,2,2,2,4,"(c3c0dcf6e35efdb843587a03522c37a7d1184539, 2019-10-12 02:39:09 -0700, Gu Jinghui, 1, 1, 2, LINK), (7f057f00cc1112dc5c68d2fa65f215ca058ab4f4, 2019-06-17 18:18:02 -0700, Gu Jinghui, 1, 1, 2, LINK)"
21644,1,56,15,71,"(2d5ce519f2175e7194be364f864750681c5866aa, 2019-06-14 07:30:29 -0700, Michael Carilli, 56, 15, 71, LINK)"
2166,1,7,7,14,"(632f8b5be7fcf572b335abf16ff6fe10a6638585, 2018-03-09 07:41:59 -0800, Jongsoo Park, 7, 7, 14, LINK)"
2167,2,140,2,142,"(58a3e4f71f17794c21386ab085bc0176899e21a0, 2019-07-25 18:22:44 -0700, Lu Fang, 1, 1, 2, LINK), (64b33672af33ef6b8b84fddd6e08e37898319d8e, 2018-03-09 07:42:17 -0800, Jongsoo Park, 139, 1, 140, LINK)"
21680,1,3,1,4,"(0c091380cc03b23e68dde7368f3b910c21deb010, 2019-07-18 08:21:45 -0700, Brian Vaughan, 3, 1, 4, LINK)"
21703,1,79,107,186,"(03f67e4b162f1d92808397d772214c44c8597475, 2019-08-30 13:38:43 -0700, Hong Xu, 79, 107, 186, LINK)"
21706,1,1,1,2,"(95b57180078d9decf47180cdf963b1341fe74614, 2019-06-26 07:25:19 -0700, peter, 1, 1, 2, LINK)"
21710,1,19,3,22,"(1c5fe2e8c4105ffd1672c828d4b67b29802d6594, 2019-06-21 14:14:34 -0700, davidriazati, 19, 3, 22, LINK)"
2172,1,1,1,2,"(58a3e4f71f17794c21386ab085bc0176899e21a0, 2019-07-25 18:22:44 -0700, Lu Fang, 1, 1, 2, LINK)"
21737,1,69,30,99,"(deba3bd1d009e6be474d144e3495e6afc0e58788, 2021-01-13 07:54:43 -0800, Gemfield, 69, 30, 99, LINK)"
21761,1,4,0,4,"(5d67c606ea7d0d4da7005d00570c8eb18333e058, 2019-06-19 21:26:23 -0700, Horace He, 4, 0, 4, LINK)"
2177,1,6,1,7,"(7e4ac8b851b9a4fa50addaf959842130d4920d7c, 2019-09-12 11:39:26 -0700, Lu Fang, 6, 1, 7, LINK)"
2178,1,695,192,887,"(60aa8c793dfeec46bea211c2fbb167c7218197bf, 2018-03-07 16:41:22 -0800, Alexander Sidorov, 695, 192, 887, LINK)"
21821,1,82,16,98,"(a51f047c7e54d8e96837706428d322e3099ac109, 2020-04-28 11:22:21 -0700, Peter Bell, 82, 16, 98, LINK)"
21857,1,37,11,48,"(2347a4032b160aaddfb8ba526a7e50af778d3cf8, 2019-06-24 12:02:45 -0700, Nikolay Korovaiko, 37, 11, 48, LINK)"
2186,2,332,16,348,"(58a3e4f71f17794c21386ab085bc0176899e21a0, 2019-07-25 18:22:44 -0700, Lu Fang, 1, 1, 2, LINK), (27cb06ae22382e97c2ccc2cb2dd37e60e215cd71, 2018-03-09 09:00:21 -0800, Jerry Zhang, 331, 15, 346, LINK)"
2188,1,6,1,7,"(7e4ac8b851b9a4fa50addaf959842130d4920d7c, 2019-09-12 11:39:26 -0700, Lu Fang, 6, 1, 7, LINK)"
21922,1,11,0,11,"(c9f41e9bc0c8296daede62ee936b9b7e32a8b658, 2019-07-03 01:58:41 -0700, Pieter Noordhuis, 11, 0, 11, LINK)"
21935,1,45,53,98,"(5adba33c01f460f52ac7eeb1124efb0e48f36ca8, 2019-07-17 13:19:06 -0700, Jan Schlüter, 45, 53, 98, LINK)"
21965,1,24,0,24,"(135bbc261d55c4ffbbb341af47a9c69215d3f1f0, 2019-09-12 15:51:27 -0700, Vincent Quenneville-Belair, 24, 0, 24, LINK)"
220,1,17,15,32,"(75497d624ed88e4d013591415ae0790eeb1f7f98, 2017-09-13 12:07:04 -0700, houseroad, 17, 15, 32, LINK)"
2201,1,425,0,425,"(f4b1e8b3346184bd17de03246dc7bd07bcf25af9, 2018-03-08 13:41:32 -0800, Jiyan Yang, 425, 0, 425, LINK)"
22032,1,28,36,64,"(2372e7ed2e7e104b5ad98da74fa7ac3424883c4b, 2019-06-24 15:20:16 -0700, Stefan Krah, 28, 36, 64, LINK)"
22053,1,1,1,2,"(273b6c5bae35196d0da279bb2775ebf2aa13b951, 2019-06-24 15:19:48 -0700, Hong Xu, 1, 1, 2, LINK)"
22066,1,25,14,39,"(83768f0756ed4c142db642923f9c7866ccd7db52, 2019-06-27 14:59:52 -0700, Spandan Tiwari, 25, 14, 39, LINK)"
22072,1,13,5,18,"(f5df0c9104b0c663db53be50981dd8119707517d, 2019-06-24 20:36:14 -0700, Thomas Viehmann, 13, 5, 18, LINK)"
22087,1,7,7,14,"(ac39869370be187046246c7202d37eb958fbd23c, 2019-06-27 13:48:20 -0700, Horace He, 7, 7, 14, LINK)"
2209,2,395,395,790,"(f93e820e7df9c8ee93a05cbca887f218ed948f12, 2018-03-27 01:15:52 -0700, Jason Gauci, 1, 394, 395, LINK), (6740126f5cc89a291cdcbba96d7dad2ad54b3fe2, 2018-03-27 00:19:17 -0700, harouwu, 394, 1, 395, LINK)"
2210,1,11,2,13,"(60299e03cfe86460736be75b552e4545ea4e5f7b, 2018-03-09 10:58:22 -0800, James Reed, 11, 2, 13, LINK)"
22107,2,837,183,1020,"(28b1f586f669c6c14d5eabffa162b59f0f4d853d, 2019-10-04 08:51:03 -0700, Vincent Quenneville-Belair, 401, 92, 493, LINK), (939ae80de14deb87ae2fd5f90f32e5d504689bbb, 2019-09-13 07:31:35 -0700, Vincent Quenneville-Belair, 436, 91, 527, LINK)"
22109,1,0,4,4,"(cd11109c2eedbe58ada092b1b8fc274006385c43, 2019-07-16 14:06:20 -0700, Horace He, 0, 4, 4, LINK)"
22124,1,28,12,40,"(f3f83ccb2370b12150797e85b70435306e7002a6, 2019-09-03 11:09:52 -0700, Horace He, 28, 12, 40, LINK)"
2213,1,1,1,2,"(359d54ea9790439577e2d6de1352edaabcf0fbe2, 2018-03-08 22:45:39 -0500, Marat Dukhan, 1, 1, 2, LINK)"
22158,4,161,2,163,"(81938ed80332609e44ba14f376f1b9048f0977a7, 2019-12-26 07:30:41 -0800, Gregory Chanan, 53, 0, 53, LINK), (29f345831e5a5eee388842d99e5065540baa878f, 2019-12-26 07:25:17 -0800, Gregory Chanan, 53, 0, 53, LINK), (ff9d072679d2e9e92261d4f881c0d44b62569148, 2019-12-23 11:55:28 -0800, Gregory Chanan, 4, 2, 6, LINK), (59a1195e93343f65e25daf56d214bd4483bacbd7, 2019-12-19 10:28:59 -0800, Gregory Chanan, 51, 0, 51, LINK)"
22192,1,64,10,74,"(29ec4769bbcf545e8727184b413f3b4b6a002b44, 2019-07-03 17:05:44 -0700, Shuaipeng Li, 64, 10, 74, LINK)"
222,1,126,111,237,"(6855d24ff1071259e1c76e9387d6c1fb4bd21734, 2017-09-13 22:41:54 -0700, houseroad, 126, 111, 237, LINK)"
2220,1,6,1,7,"(7e4ac8b851b9a4fa50addaf959842130d4920d7c, 2019-09-12 11:39:26 -0700, Lu Fang, 6, 1, 7, LINK)"
22200,1,1,29,30,"(b9ede6600e26b5a2b549737a4b343afb7f8b3c48, 2019-07-02 00:03:06 -0700, Hong Xu, 1, 29, 30, LINK)"
2222,1,58,18,76,"(1df99e541c1c0380d4bef796bc56d1aa31fb4f78, 2018-03-11 15:44:14 -0700, Paul Jesse Hellemn, 58, 18, 76, LINK)"
22301,1,264,198,462,"(f99bc714c7bacf9a74c85514ef70b677415d4f0c, 2019-09-26 16:03:43 -0700, Igor Fedan, 264, 198, 462, LINK)"
2231,1,6,1,7,"(7e4ac8b851b9a4fa50addaf959842130d4920d7c, 2019-09-12 11:39:26 -0700, Lu Fang, 6, 1, 7, LINK)"
22353,1,46,23,69,"(c33adf539c82fe26ed678a2aea4427fbbcbd7c97, 2019-08-22 11:33:53 -0700, Igor Fedan, 46, 23, 69, LINK)"
2236,1,2,0,2,"(5fc122bf3973504e619cd677ad4a7fc1011642cd, 2017-10-24 23:54:28 +0200, Mike Garmulewicz, 2, 0, 2, LINK)"
22389,1,2,1,3,"(818828e8a86a90c9f3fe23c7c1fba93ac81c87c8, 2019-07-19 13:26:29 -0700, Orion Reblitz-Richardson, 2, 1, 3, LINK)"
2243,1,16,21,37,"(8a9925f03f8871abcfec14e12c2e2ee83029e6df, 2018-03-14 10:17:32 -0700, Lu Fang, 16, 21, 37, LINK)"
22430,1,68,61,129,"(200cb836f1e31c877e9ac165c326927fa42a28fa, 2019-07-24 10:21:43 -0700, Iurii Zdebskyi, 68, 61, 129, LINK)"
22431,1,68,61,129,"(200cb836f1e31c877e9ac165c326927fa42a28fa, 2019-07-24 10:21:43 -0700, Iurii Zdebskyi, 68, 61, 129, LINK)"
2244,1,6,1,7,"(7e4ac8b851b9a4fa50addaf959842130d4920d7c, 2019-09-12 11:39:26 -0700, Lu Fang, 6, 1, 7, LINK)"
22483,1,74,21,95,"(d43480d6d16f1a9009ac0d39d394e61c5e831d27, 2019-09-25 15:39:06 -0700, Elias Ellison, 74, 21, 95, LINK)"
22489,1,9,6,15,"(94bd5ddf7f3ff8b129fc193fe46ac5e09fb2df2b, 2019-07-06 19:25:55 -0700, peter, 9, 6, 15, LINK)"
2249,1,2,1,3,"(bebc3d6aad8cd4b3ff3ccbaf5d8141bc10916df7, 2019-09-17 06:43:15 -0700, Lu Fang, 2, 1, 3, LINK)"
22496,2,150,15,165,"(8746f90cf6ce2f3e4c4eb29640b53fc311fff2eb, 2020-01-16 14:14:04 -0800, Xiang Gao, 78, 6, 84, LINK), (0b0f90f53c9e2a032ce98ace8256a5fd58ceeb3f, 2019-12-20 21:25:21 -0800, Xiang Gao, 72, 9, 81, LINK)"
2250,1,501,172,673,"(edd138ba00b649ef03bf53c2ede08215c37a33f0, 2018-03-13 13:20:26 -0700, Qinqing Zheng, 501, 172, 673, LINK)"
22507,1,24,32,56,"(ce8c9d9bd5fa78392d5fb7028ef7f69d0c7a71dd, 2019-07-08 07:03:20 -0700, peter, 24, 32, 56, LINK)"
2251,1,1,1,2,"(dd921f65ba286bc7c62b03a4f23d20bbd197be6b, 2018-03-13 18:07:07 -0700, Yangqing Jia, 1, 1, 2, LINK)"
22526,1,29,8,37,"(1b1e3d565c11b302b090735e6c4970ab7d9e17ab, 2019-10-31 00:58:10 -0700, Jie, 29, 8, 37, LINK)"
22529,1,58,48,106,"(9bafe5d4da28fe127e95de924e34a4a44a0ba1d9, 2019-07-08 08:18:36 -0700, vishwakftw, 58, 48, 106, LINK)"
22534,1,20,0,20,"(4f62cbe7de8f867809ca601c996dd48a5a28ffca, 2020-03-09 22:22:36 -0700, Colin Jermain, 20, 0, 20, LINK)"
22538,1,12,10,22,"(927fb56ee0307422bb9a49daff63f93b998d083b, 2019-08-19 13:42:05 -0700, Yuxin Wu, 12, 10, 22, LINK)"
22553,1,1,3,4,"(ba38445cfd3581934f870fd3b9c49ed3261d8de5, 2019-07-16 10:12:53 -0700, davidriazati, 1, 3, 4, LINK)"
2257,1,6,1,7,"(7e4ac8b851b9a4fa50addaf959842130d4920d7c, 2019-09-12 11:39:26 -0700, Lu Fang, 6, 1, 7, LINK)"
22570,1,4,2,6,"(d4464d3418cd02a09ac75f60b9661b6671e60b11, 2019-07-07 20:52:06 -0700, peter, 4, 2, 6, LINK)"
22581,1,36,17,53,"(f8ad65adb1b6e4d34b3e6544f9cfc4e2a8c24992, 2019-07-16 09:52:48 -0700, vishwakftw, 36, 17, 53, LINK)"
2261,2,8,3,11,"(7e4ac8b851b9a4fa50addaf959842130d4920d7c, 2019-09-12 11:39:26 -0700, Lu Fang, 6, 1, 7, LINK), (5022b32b62df1a2dfb8c65d894ac59ed345275e7, 2018-03-14 09:49:49 -0700, Yinghai Lu, 2, 2, 4, LINK)"
22615,1,16,2,18,"(30bc65271de884345e2d6fcf0622ff37c151631a, 2019-08-26 05:05:26 -0700, Pavel Belevich, 16, 2, 18, LINK)"
22681,1,8,0,8,"(c36552c4cbc8fd9c9346d213b11654c126615d5d, 2019-10-17 09:10:54 -0700, Ryan J. Evans, 8, 0, 8, LINK)"
2271,1,6,1,7,"(7e4ac8b851b9a4fa50addaf959842130d4920d7c, 2019-09-12 11:39:26 -0700, Lu Fang, 6, 1, 7, LINK)"
22710,1,26,4,30,"(236149edc500830fb23a0e8a24adc051544e78fb, 2019-07-29 11:54:56 -0700, Hong Xu, 26, 4, 30, LINK)"
22745,1,57,19,76,"(8aa09de19e125f3ea165e0030dccc86c21583c69, 2020-02-26 12:48:06 -0800, Wojciech Baranowski, 57, 19, 76, LINK)"
22753,1,12,0,12,"(520982d1df0cf62b464fa4bf5a3ae58327d96d4d, 2019-08-05 07:27:43 -0700, Xiang Gao, 12, 0, 12, LINK)"
22809,1,30,0,30,"(f2f3e8ad8c7c99503138c5f1e41036610e147d75, 2019-07-19 14:08:11 -0700, Elias Ellison, 30, 0, 30, LINK)"
2281,1,6,1,7,"(7e4ac8b851b9a4fa50addaf959842130d4920d7c, 2019-09-12 11:39:26 -0700, Lu Fang, 6, 1, 7, LINK)"
2283,1,119,71,190,"(c18dba9fe708ed7c8bd21b6d3df6e8a85146fb9b, 2018-03-17 17:26:37 -0700, Paul Jesse Hellemn, 119, 71, 190, LINK)"
22833,1,5,233,238,"(cf50249bde47b9ad0168ac4d8c142cfe5fffb22c, 2019-07-25 08:51:47 -0700, Thomas Viehmann, 5, 233, 238, LINK)"
22843,1,10,1,11,"(4e5f70089f136d277b3850d4218d4fbaa6976e6a, 2019-07-20 06:14:28 -0700, ngimel, 10, 1, 11, LINK)"
22844,1,17,17,34,"(0ea8e61f0338a08ed5e8476c768970284efcbbf9, 2019-07-16 09:44:50 -0700, HaoTang@descartes, 17, 17, 34, LINK)"
22853,1,118,14,132,"(c7787f7fbf388f9fe326d581726e7ef3f2dce74b, 2020-08-28 06:40:53 -0700, kshitij12345, 118, 14, 132, LINK)"
2286,1,22,1,23,"(d11fc903176e524cd10d7bd72d6ba2cf9caed1a8, 2018-03-26 19:26:09 -0700, mlappelbaum, 22, 1, 23, LINK)"
22963,1,19,1,20,"(329757a9074157b41a4176a4966a5b7582db383c, 2019-08-30 08:51:39 -0700, CamiWilliams, 19, 1, 20, LINK)"
22970,1,10,5,15,"(632aeb034dd57c0586fc3e979e65c362b936396a, 2019-08-22 08:15:01 -0700, Vaibhav Sinha, 10, 5, 15, LINK)"
22992,1,34,13,47,"(22f7c9e31bc652744add515eccfaca9e7080a800, 2019-07-22 07:45:44 -0700, Iurii Zdebskyi, 34, 13, 47, LINK)"
23016,1,1,1,2,"(c9e62f6988c2ac8a6ca6b288621b0df6d26b82b6, 2019-07-23 05:31:38 -0700, Soumith Chintala, 1, 1, 2, LINK)"
2302,1,9,6,15,"(dad57a414b7a3f8b7833161eb207e41942fdbea6, 2018-03-18 17:38:23 -0700, Yangqing Jia, 9, 6, 15, LINK)"
2304,2,21,11,32,"(d6ee58494f816b9784a974c9d5a5c95376a3a55b, 2019-09-24 05:36:12 -0700, Lu Fang, 6, 1, 7, LINK), (e431c982055335a21d1208dea2f1c4622098ed7e, 2018-03-18 18:23:40 -0700, Alexander Sidorov, 15, 10, 25, LINK)"
2305,1,8,2,10,"(3f667176cc53debe1c72638c1697a0a7262dbb05, 2018-03-19 09:32:32 -0700, Paul Jesse Hellemn, 8, 2, 10, LINK)"
23063,1,44,10,54,"(064d156511068035ed486d09342c4258e8479ece, 2019-08-14 21:01:50 -0700, Jie, 44, 10, 54, LINK)"
2307,1,2,1,3,"(bebc3d6aad8cd4b3ff3ccbaf5d8141bc10916df7, 2019-09-17 06:43:15 -0700, Lu Fang, 2, 1, 3, LINK)"
2310,1,2,1,3,"(bebc3d6aad8cd4b3ff3ccbaf5d8141bc10916df7, 2019-09-17 06:43:15 -0700, Lu Fang, 2, 1, 3, LINK)"
2313,1,6,2,8,"(a749bde0b1bdd496b748c68bec86aaa0aa89bc3a, 2018-03-20 01:34:12 -0700, Jongsoo Park, 6, 2, 8, LINK)"
2314,2,201,2,203,"(3cade9cdd4bb809cd1bf94da2baa4f94a6537270, 2020-05-07 20:01:58 -0700, Lu Fang, 3, 2, 5, LINK), (fb77b423f40ed25cd127618a1e5154dfccfadb56, 2018-03-19 16:04:58 -0700, Yan Zhu, 198, 0, 198, LINK)"
23141,1,10,0,10,"(8c07a98adc4d0e8c79e204a3cb31afe7e78d915e, 2020-05-18 14:51:59 -0700, Donna Choi, 10, 0, 10, LINK)"
2315,1,2,1,3,"(bebc3d6aad8cd4b3ff3ccbaf5d8141bc10916df7, 2019-09-17 06:43:15 -0700, Lu Fang, 2, 1, 3, LINK)"
2316,2,8,4,12,"(bebc3d6aad8cd4b3ff3ccbaf5d8141bc10916df7, 2019-09-17 06:43:15 -0700, Lu Fang, 2, 1, 3, LINK), (23631eee5ae484d8397769492b3ea36f9eca282d, 2018-03-19 16:38:55 -0700, Qinqing Zheng, 6, 3, 9, LINK)"
23160,1,1,1,2,"(7b229342ca8bf86ab5f2d9f59d5101b10a7fd79d, 2019-07-23 14:43:09 -0700, Pavel Belevich, 1, 1, 2, LINK)"
2317,1,12,0,12,"(b0fe67aca845df011842a8bfcb8726a2e2dae439, 2018-03-19 22:46:26 -0700, Yinghai Lu, 12, 0, 12, LINK)"
2322,1,7,8,15,"(b43d6162fb766324284b4c1c2d76ce51bd1c8ec4, 2018-03-19 20:46:43 -0700, Yangqing Jia, 7, 8, 15, LINK)"
23231,1,6,0,6,"(1dd4d5556513692bccfc0376ee36b28ce43ac9fc, 2019-07-25 04:38:44 -0700, Gu Jinghui, 6, 0, 6, LINK)"
2324,1,2,1,3,"(cda2f02f891a309f3cbfdb3d5d958047fd6fc522, 2018-03-20 00:13:31 -0700, Lu Fang, 2, 1, 3, LINK)"
2330,1,6,1,7,"(d6ee58494f816b9784a974c9d5a5c95376a3a55b, 2019-09-24 05:36:12 -0700, Lu Fang, 6, 1, 7, LINK)"
23300,1,0,3,3,"(7c383ba4a05a3fe1e6cc1738481a8f14631a0c75, 2019-07-25 11:18:04 -0700, Pieter Noordhuis, 0, 3, 3, LINK)"
2332,1,6,2,8,"(f62d6f057891a404c39a59f3fcc378fac6d34576, 2018-03-20 12:48:10 -0700, Jongsoo Park, 6, 2, 8, LINK)"
2333,1,4,1,5,"(3aa393f7e26aeb68dd2a6dfaee1256c6ff4274c1, 2018-03-21 01:50:16 -0700, Marat Dukhan, 4, 1, 5, LINK)"
2335,1,1,1,2,"(b93f0947a89b97a14b43c7b4ab79cf7a7163756d, 2019-09-24 17:12:27 -0700, Lu Fang, 1, 1, 2, LINK)"
2339,1,7,8,15,"(1c0862c301c4955bd9532dce70088152e424d821, 2018-03-21 17:24:39 -0700, Lu Fang, 7, 8, 15, LINK)"
23393,1,39,23,62,"(7b081e5d1e4670f8b26c8f611c2fff7ac6aada4d, 2019-07-29 22:21:40 -0700, Will Feng, 39, 23, 62, LINK)"
23401,1,52,43,95,"(bb119d957e331a1dbca91fbdf00f298088218e5b, 2019-11-11 07:32:28 -0800, Peter Bell, 52, 43, 95, LINK)"
2343,2,3,2,5,"(b93f0947a89b97a14b43c7b4ab79cf7a7163756d, 2019-09-24 17:12:27 -0700, Lu Fang, 1, 1, 2, LINK), (b1684e9a3a656ffd01aede0499769b37600a9233, 2018-03-21 09:24:06 -0700, Lu Fang, 2, 1, 3, LINK)"
2344,1,3,1,4,"(75a65ffe0fb491da67ea3929fb952fa156f74e48, 2018-03-21 02:41:58 -0400, Marat Dukhan, 3, 1, 4, LINK)"
23453,2,96,14,110,"(756bdcbca4770b6ef5bd08daeeea24927b16a22a, 2019-07-30 17:20:16 -0700, davidriazati, 49, 8, 57, LINK), (52b95fd4beaee2c170d96f0a847bd6d2f17982d1, 2019-07-29 17:46:04 -0700, davidriazati, 47, 6, 53, LINK)"
2348,2,61,44,105,"(8ec041405391d999478d88ca936d0ba5bdf0ea71, 2019-09-27 03:29:55 -0700, Lu Fang, 1, 1, 2, LINK), (611a89c4b63f262f7c81614006b9fbd2d5c6a35f, 2018-03-21 10:29:45 -0700, Yangqing Jia, 60, 43, 103, LINK)"
23480,2,2,2,4,"(cdb032efeaf55ff780d0f592b1dd94ad5e481bbb, 2019-08-07 13:39:25 -0400, gchanan, 1, 1, 2, LINK), (fc82ec298bd9101d8de25b43f8823cdbae894252, 2019-08-07 06:58:02 -0700, Gregory Chanan, 1, 1, 2, LINK)"
2354,1,46,33,79,"(2d03ae2f85ba8a059026dc40caeae291d4bcc889, 2018-03-21 17:05:14 -0700, Yangqing Jia, 46, 33, 79, LINK)"
23545,1,10,1,11,"(9130ab380a4af0c67036ea8fce937156cfd0a8c8, 2019-07-31 09:55:40 -0700, ptrblck, 10, 1, 11, LINK)"
23582,2,81,19,100,"(f8852c947bf527a994002aa04f8e77b78ac75f01, 2019-08-27 18:21:56 -0700, Owen Anderson, 73, 15, 88, LINK), (d9ec37adc4bb493f63d0ab90a0c47df5f4c47075, 2019-08-02 12:29:18 -0700, Owen Anderson, 8, 4, 12, LINK)"
2359,1,1,27,28,"(0ea8964fd61d807d049d84ca924d66fffeee4682, 2018-03-21 16:11:29 -0700, Orion Reblitz-Richardson, 1, 27, 28, LINK)"
23603,1,13,1,14,"(10b1254edd9bcb4d3ab6a47f2bab31edef6485d0, 2019-08-07 09:03:17 -0700, Ojas Ahuja, 13, 1, 14, LINK)"
23607,2,12,2,14,"(ccc7b5c22551c181429da28e07f5526fd6794a45, 2019-08-02 00:14:32 -0400, Tongzhou Wang, 6, 1, 7, LINK), (0a12ff7c5b59cbd47dc865603e45178903f6dfa8, 2019-07-31 19:00:36 -0700, Ailing Zhang, 6, 1, 7, LINK)"
23631,1,22,1,23,"(489cc46686e7e689e7130e78b73fe77a9edac5ed, 2019-08-05 19:25:58 -0700, James Reed, 22, 1, 23, LINK)"
2366,1,115,52,167,"(21918b94e4c4091b98e5d84a840bca92eb2e0d78, 2018-03-22 22:50:27 -0700, Yinghai Lu, 115, 52, 167, LINK)"
2367,1,1,1,2,"(564384fe12ddb4d37b96b90852b7cb94429a62ae, 2019-11-07 12:07:29 -0800, Lu Fang, 1, 1, 2, LINK)"
2369,1,1,1,2,"(8cc9d276476a2793cdc8e073ce4346bd16258cf9, 2019-10-07 14:14:55 -0700, Lu Fang, 1, 1, 2, LINK)"
237,2,49,21,70,"(c96afa3322dc9528c13aa7db0cee3e37c68af7c4, 2018-10-09 11:57:20 -0700, iotamudelta, 45, 17, 62, LINK), (ab5f26545b5c565990b5c81f372a175dda0bd656, 2016-12-13 11:32:42 +0000, Joost van Amersfoort, 4, 4, 8, LINK)"
23731,2,43,12,55,"(b10761d8900af1dc48bee807ab39c80fd4334b79, 2020-02-27 06:56:28 -0800, JeongUkJae, 35, 9, 44, LINK), (e87887ccb42e916cd3397600e5411ff65566e337, 2020-02-03 08:57:20 -0800, Nikolay Novik, 8, 3, 11, LINK)"
2375,1,1,1,2,"(8cc9d276476a2793cdc8e073ce4346bd16258cf9, 2019-10-07 14:14:55 -0700, Lu Fang, 1, 1, 2, LINK)"
2379,1,22,1,23,"(d11fc903176e524cd10d7bd72d6ba2cf9caed1a8, 2018-03-26 19:26:09 -0700, mlappelbaum, 22, 1, 23, LINK)"
23795,2,2,2,4,"(14e75fbdb98a3f748b98f95c5099643501cdc74b, 2020-07-28 08:20:18 -0700, alkad, 1, 2, 3, LINK), (0f5d071d5280737ea73a11e2dd0e1b25caea6ced, 2019-08-07 12:30:37 -0700, Hugo, 1, 0, 1, LINK)"
23815,1,326,70,396,"(bc57967e07ce0c1ad1e0b494373250da245b6921, 2019-10-21 11:26:04 -0700, Igor Fedan, 326, 70, 396, LINK)"
2382,1,23,0,23,"(e35212ebd0e3bbf698ba5efaf63118fdef3fc8ef, 2018-03-22 15:09:54 -0700, Lu Fang, 23, 0, 23, LINK)"
23825,2,124,70,194,"(38b2bc14519bffe5389b492b0e65427edbb78480, 2019-09-16 08:58:50 -0700, Gu Jinghui, 1, 1, 2, LINK), (6ba60ec9b0fa3c5280d35ad77ad20e3fc9887fdc, 2019-08-06 11:11:45 -0700, James Reed, 123, 69, 192, LINK)"
23836,3,249,7,256,"(bc92ce9e0733c2aaae41febf83d196712ca39327, 2019-08-15 08:36:26 -0700, Hong Xu, 7, 7, 14, LINK), (338f9c860fe465787514a1d80d6dffb9d578ee91, 2019-08-15 08:36:26 -0700, Hong Xu, 123, 0, 123, LINK), (1f4c73618cba1048ce08634e5b022f5d924f51e6, 2019-08-15 08:36:26 -0700, Hong Xu, 119, 0, 119, LINK)"
2385,1,1,1,2,"(8cc9d276476a2793cdc8e073ce4346bd16258cf9, 2019-10-07 14:14:55 -0700, Lu Fang, 1, 1, 2, LINK)"
23881,1,0,22,22,"(a0556782a04ab269265e05131f861be76edf556b, 2019-08-09 09:05:19 -0700, Daya Khudia, 0, 22, 22, LINK)"
23882,1,43,17,60,"(e81f29680784bbae53b2354851c4ae4cec84c2a0, 2019-08-09 12:14:40 -0700, Gregory Chanan, 43, 17, 60, LINK)"
23901,2,1380,1382,2762,"(b9a006f947a1708baa118c070f95c8d14b4fdfc4, 2019-08-12 08:05:33 -0700, Pavel Belevich, 690, 691, 1381, LINK), (be4e6aff126108a1e8e4657a5115c0fcc5ed3496, 2019-08-09 08:57:39 -0700, Pavel Belevich, 690, 691, 1381, LINK)"
23915,1,42,44,86,"(d3f6d5885d68d47d38a475d4fc9cf1611c91920c, 2019-08-09 18:18:25 -0700, Mikhail Zolotukhin, 42, 44, 86, LINK)"
23925,1,76,28,104,"(f597ac6efc70431e66d945c16fa12b767989b032, 2020-02-26 10:07:59 -0800, Barak Nehoran, 76, 28, 104, LINK)"
2394,1,0,118,118,"(bbb7c722df9fc502ed5204f1bed60f0f2b5c04c1, 2018-03-22 21:08:05 -0700, bddppq, 0, 118, 118, LINK)"
2396,1,178,53,231,"(810edb615d28468f998f950ffb684b0c4cc93f1e, 2018-03-23 13:25:58 -0700, Yinghai Lu, 178, 53, 231, LINK)"
23965,1,4,253,257,"(bee6344d4eb22c1cf9db2626ffd89c1b04db02e9, 2019-12-12 13:30:46 -0800, Elias Ellison, 4, 253, 257, LINK)"
23986,1,1,6,7,"(dcfc121fd792393205104a9f07fc4ee0da0ced69, 2020-04-16 19:01:46 -0700, Supriya Rao, 1, 6, 7, LINK)"
23993,2,33,20,53,"(bd220b336b74337935a74f35dc74db7713a267b0, 2020-05-05 13:34:45 -0700, Michael Suo, 17, 3, 20, LINK), (4bfa51d40595d41d6bec6d4a9b1ade72adde4ebc, 2020-04-28 23:50:44 -0700, Michael Suo, 16, 17, 33, LINK)"
24000,1,39,1,40,"(d2a8435c08f9d87603d4d9a9179a989b632bc2cb, 2019-08-30 11:32:10 -0700, Elias Ellison, 39, 1, 40, LINK)"
24001,1,0,1,1,"(478c7930658a892b366e84ce46ccf56710206fbe, 2019-08-09 07:44:15 -0700, Stefan Krah, 0, 1, 1, LINK)"
2403,1,1,1,2,"(564384fe12ddb4d37b96b90852b7cb94429a62ae, 2019-11-07 12:07:29 -0800, Lu Fang, 1, 1, 2, LINK)"
24035,1,20,12,32,"(4358cbe01b55673556208ade69287acba64ca19b, 2019-08-19 15:00:36 -0700, Vishwak Srinivasan, 20, 12, 32, LINK)"
24073,1,3,3,6,"(6be24be9ff7c7100e08971ca2031d4b720a139ac, 2019-08-10 14:27:38 -0700, Leo Mao, 3, 3, 6, LINK)"
2411,1,1,1,2,"(204939b40132b9c764e765073b1a4df9ed05b86e, 2019-12-26 21:23:22 -0800, Lu Fang, 1, 1, 2, LINK)"
2413,1,17,4,21,"(f9d02903b7c56360ab8f2e774751b71c19fd7fd9, 2017-08-15 02:46:25 -0400, Sam Gross, 17, 4, 21, LINK)"
24132,5,821,381,1202,"(b01520ac9c23499d1c9ed5f411950a0c6cb54ca9, 2019-09-13 13:50:03 -0700, Sebastian Messmer, 206, 96, 302, LINK), (fcbf93ce4e5ddb3ba03c7fa0e0e6307ad771f6d8, 2019-09-13 00:02:39 -0700, Sebastian Messmer, 206, 96, 302, LINK), (1c1d7c88e8086c9ea573e71d02dcabfda971cded, 2019-09-13 00:02:39 -0700, Sebastian Messmer, 7, 7, 14, LINK), (d55f79d03d7a9faa69f0b643a0bef564387dd09b, 2019-09-12 14:16:33 -0700, Sebastian Messmer, 201, 91, 292, LINK), (ef96139b5801f07b7a16bb005009c38d4fe639b3, 2019-09-12 12:34:04 -0700, Sebastian Messmer, 201, 91, 292, LINK)"
24140,1,21,0,21,"(5fd3251c50ec0b1d6c182dcf705aec18d88edac2, 2019-08-23 15:45:53 -0700, Wanchao Liang, 21, 0, 21, LINK)"
2416,3,648,332,980,"(d11fc903176e524cd10d7bd72d6ba2cf9caed1a8, 2018-03-26 19:26:09 -0700, mlappelbaum, 22, 1, 23, LINK), (a73f9af5ab693826e6d46fbce28c1fd24e81ecfa, 2018-03-23 20:43:43 -0700, Xiaomeng Yang, 607, 326, 933, LINK), (b09d7c890ef78c864ab73c1fd4eaa31a6806ee33, 2017-08-15 10:34:15 -0700, Edward Z. Yang, 19, 5, 24, LINK)"
24164,1,24,17,41,"(e0e5813b72fd3eaa336f3f2c23ca3b2ee708d041, 2019-08-19 16:31:36 -0700, davidriazati, 24, 17, 41, LINK)"
24173,1,42,25,67,"(1f87e823b8c93af0ef5ad19a6270e93533007ffa, 2019-12-11 10:55:45 -0800, David Riazati, 42, 25, 67, LINK)"
24175,1,1,2,3,"(c771d50ca26048647e7bfeb70f597c33769030bc, 2019-08-13 20:30:01 -0700, Orion Reblitz-Richardson, 1, 2, 3, LINK)"
24177,1,207,8,215,"(0cc92de447962ea9fdcaacb2f4101190f1d5cd8c, 2019-08-28 12:38:27 -0700, Meteorix, 207, 8, 215, LINK)"
2418,1,6,1,7,"(674dca0831874314bf34b94f58f3a311708df34a, 2020-02-07 02:16:46 -0800, Lu Fang, 6, 1, 7, LINK)"
24192,1,95,1,96,"(3acbcb96d418bfce434b964eb5cb85e1ba6010e9, 2019-09-27 09:35:29 -0700, Will Feng, 95, 1, 96, LINK)"
24239,1,30,17,47,"(abadf0079fd1a21bb6c311bf3aaa61937936a069, 2019-08-14 11:14:32 -0700, Elias Ellison, 30, 17, 47, LINK)"
24247,7,119,124,243,"(31d2f4e8e81f0441184729ab3473c49e47d512e8, 2019-09-24 13:16:19 -0700, Rohan Varma, 0, 0, 0, LINK), (ed5db23c43b94205cc8bdc558689d1168dd211e1, 2019-09-23 22:18:00 -0700, Rohan Varma, 2, 4, 6, LINK), (8933b916211a5c434de94a6d1f514f3aaaa5a43b, 2019-09-23 22:06:32 -0700, Rohan Varma, 86, 76, 162, LINK), (c7cb865ab1be3426b53d8b474c45755526bc2dfe, 2019-09-23 00:36:03 -0700, Rohan Varma, 5, 5, 10, LINK), (312e124e829451a299d9434ab3ecbf46d8948593, 2019-09-20 15:39:45 -0700, Rohan Varma, 2, 2, 4, LINK), (265c4c7fbb6b97122baf63b574c70f91e33df8b8, 2019-09-20 14:49:24 -0700, Rohan Varma, 2, 2, 4, LINK), (05c86bf56c1d67a67349c58f2900d04c2d67bcb4, 2019-09-20 14:47:02 -0700, Rohan Varma, 22, 35, 57, LINK)"
2425,1,1,1,2,"(564384fe12ddb4d37b96b90852b7cb94429a62ae, 2019-11-07 12:07:29 -0800, Lu Fang, 1, 1, 2, LINK)"
24256,1,89,25,114,"(e8ea44796e168eaac8d4133283439245d886fba5, 2019-08-22 10:15:40 -0700, Elias Ellison, 89, 25, 114, LINK)"
2426,3,47,10,57,"(d11fc903176e524cd10d7bd72d6ba2cf9caed1a8, 2018-03-26 19:26:09 -0700, mlappelbaum, 22, 1, 23, LINK), (1e417e23bce452107d8a160b488153f43533e178, 2018-03-26 13:52:16 -0700, bddppq, 21, 9, 30, LINK), (7310ebb66f07743b126a9bbfc753315161677be0, 2017-08-21 20:04:31 -0700, Zach DeVito, 4, 0, 4, LINK)"
24268,1,2,2,4,"(83bfd76b2f7a9b388537eb00022622d9c6989890, 2019-08-15 11:51:34 -0700, BowenBao, 2, 2, 4, LINK)"
2428,1,4,4,8,"(f393c90cda045881bd5dc5f252c64faa39776609, 2018-03-27 07:48:23 -0700, Paul Jesse Hellemn, 4, 4, 8, LINK)"
2430,1,0,0,0,"(3c577fccf3c7b5630c8fc2e1aa97803cbe499131, 2018-03-27 18:51:50 -0400, Edward Z. Yang, 0, 0, 0, LINK)"
24309,1,38,5,43,"(c845984271a551ac1c61b9eb06a17fb57aafbd7e, 2019-08-29 07:34:10 -0700, Stefan Krah, 38, 5, 43, LINK)"
2435,1,18,18,36,"(9e2001683e6cf8f98971fa667226d319436ac4c7, 2018-03-26 21:07:40 -0700, Orion Reblitz-Richardson, 18, 18, 36, LINK)"
2436,1,11,1,12,"(818171163701eda56498c3e078d3bef682369fa7, 2020-05-08 21:42:58 -0700, Lu Fang, 11, 1, 12, LINK)"
24369,1,28,1,29,"(2e44630d35b652af7aa2ae91b00e5126619ff158, 2019-08-16 13:27:37 -0700, Elias Ellison, 28, 1, 29, LINK)"
24394,1,5,5,10,"(1a74bd407de335019afdcb748a758107092a8019, 2019-08-15 17:25:24 -0700, Zafar Takhirov, 5, 5, 10, LINK)"
24403,1,53,3,56,"(d1e079e2e09fe811a1026d6b1372921a951a4247, 2019-09-03 17:33:08 -0700, vishwakftw, 53, 3, 56, LINK)"
24429,1,232,75,307,"(1d53d0756668ce641e4f109200d9c65b003d05fa, 2019-08-20 21:39:09 -0700, davidriazati, 232, 75, 307, LINK)"
2460,2,6,15,21,"(c34ef1aa2edb4792d7bd0cb3a75d7a68e859212b, 2019-12-10 10:13:15 -0800, Lu Fang, 3, 1, 4, LINK), (d3f92eebeefead9e0d22eab7450f81a240aaf0ab, 2018-03-27 22:44:39 -0700, Yinghai Lu, 3, 14, 17, LINK)"
2462,1,6,0,6,"(5e54d9330f93123306d88176394cdbd258f94615, 2017-08-23 13:18:21 +0200, yogi81, 6, 0, 6, LINK)"
2468,1,3,1,4,"(c34ef1aa2edb4792d7bd0cb3a75d7a68e859212b, 2019-12-10 10:13:15 -0800, Lu Fang, 3, 1, 4, LINK)"
2473,1,3,1,4,"(c34ef1aa2edb4792d7bd0cb3a75d7a68e859212b, 2019-12-10 10:13:15 -0800, Lu Fang, 3, 1, 4, LINK)"
2479,1,0,9,9,"(2ed2624c280bbe0725ae9fc330ee03b9081cbbba, 2018-03-29 14:09:32 -0700, Orion Reblitz-Richardson, 0, 9, 9, LINK)"
24802,5,1271,165,1436,"(40e44c5f0a84ce657c76d0c2b9ac761c84d2aec3, 2020-09-17 14:00:30 -0700, Kurt Mohler, 34, 62, 96, LINK), (28a23fce4ca5b5550df5cb4ef4859677b2a940ef, 2020-09-10 00:30:31 -0700, Kurt Mohler, 51, 28, 79, LINK), (68297eeb1a33a51217f8ad1f76b5d5019e937ee4, 2020-09-05 23:13:03 -0700, Kurt Mohler, 20, 23, 43, LINK), (68b9daa9bf1694bc481c48b5bffdc5100e0c278c, 2020-08-28 18:26:41 -0700, Kurt Mohler, 928, 10, 938, LINK), (206db5c1272a536fc668a1b5822a7de2c4fc5934, 2020-08-01 01:52:06 -0700, Kurt Mohler, 238, 42, 280, LINK)"
24806,1,25,19,44,"(012526dd6bf677fd029e9c27ecb49e401b210d2f, 2019-08-20 14:12:49 -0700, microsheep, 25, 19, 44, LINK)"
24807,1,10,7,17,"(b0afe945a7770ca64da9b8e1065ce0f572dedd49, 2021-03-09 11:28:03 -0800, Philip Meier, 10, 7, 17, LINK)"
2483,1,3,1,4,"(eca84e2532f715b83761df9148ac58d3f4dde70e, 2018-03-30 07:29:55 -0700, Orion Reblitz-Richardson, 3, 1, 4, LINK)"
2484,1,1,1,2,"(3aca8f3b40b4ccc78ac6dcd29b04c9713380dd5f, 2018-03-30 01:05:21 -0700, Svetoslav Kolev, 1, 1, 2, LINK)"
24853,1,15,4,19,"(8edf149f7fd43a04d1a181b8de94500980b88f03, 2019-09-03 17:44:41 -0700, zou3519, 15, 4, 19, LINK)"
24856,2,132,29,161,"(167722d36ede25a865e96a88a828130257da97d7, 2019-09-25 13:46:44 -0700, Basil Hosmer, 126, 26, 152, LINK), (91db62a8bb80675df7c652096d5050cae0e27a3e, 2019-08-28 17:35:46 -0700, Basil Hosmer, 6, 3, 9, LINK)"
2486,2,2,12,14,"(204939b40132b9c764e765073b1a4df9ed05b86e, 2019-12-26 21:23:22 -0800, Lu Fang, 1, 1, 2, LINK), (4da3fa50958a78bc1929bf4fe672689399eb0f8e, 2018-03-29 21:49:33 -0700, bddppq, 1, 11, 12, LINK)"
24861,2,117,14,131,"(0a159b0a3a78a80fb0f9082087a98f87f2dea986, 2020-05-14 08:52:15 -0700, Peter Bell, 91, 11, 102, LINK), (63b1ae69831cd21bc4d6059a5854bc1155a152c9, 2020-05-08 16:44:33 -0700, Xiao Wang, 26, 3, 29, LINK)"
24881,1,8,1,9,"(d33623f7c12b16fd49f74594e0e89ceecb817be9, 2019-08-20 09:20:34 -0700, Max Balandat, 8, 1, 9, LINK)"
2491,1,1,1,2,"(204939b40132b9c764e765073b1a4df9ed05b86e, 2019-12-26 21:23:22 -0800, Lu Fang, 1, 1, 2, LINK)"
24933,1,259,457,716,"(8cb05e72c69fdd837548419770f3f1ba9807c16d, 2020-01-29 12:56:43 -0800, Kurt Mohler, 259, 457, 716, LINK)"
24962,1,1,1,2,"(c84dfa8fa347824ec16e4e0acc9c9f8da92c418d, 2019-08-29 08:15:35 -0700, Zayd Hammoudeh, 1, 1, 2, LINK)"
24968,1,14,7,21,"(f583f2e657f3edea03009df3742d69fb14894925, 2019-08-23 08:54:16 -0700, Mads R. B. Kristensen, 14, 7, 21, LINK)"
24987,1,54,20,74,"(43c4b9f2a59e3ab4478508e8f12db9609f35c3b5, 2019-08-28 17:12:28 -0700, davidriazati, 54, 20, 74, LINK)"
25,1,467,97,564,"(5e6fcd02b5d5db9c2bb9e4bfce7e5774aae67825, 2016-11-27 11:43:13 +0100, Janusz Marcinkiewicz, 467, 97, 564, LINK)"
2500,1,3,2,5,"(f6f1e0aef59350df466495b4c35e2905b537eff8, 2020-01-14 15:17:37 -0800, Lu Fang, 3, 2, 5, LINK)"
25016,4,545,42,587,"(7101f6b5c0578debfe9d4bc7a7194160f62a04f0, 2020-02-03 09:00:44 -0800, Hong Xu, 59, 6, 65, LINK), (1c017f0c14c91bd5125ab387a90441b0c0e2f3ad, 2020-01-22 09:01:33 -0800, Hong Xu, 130, 12, 142, LINK), (1578a286925b7967fc5405abd8e386ead55e4344, 2019-12-05 09:53:21 -0800, Hong Xu, 178, 12, 190, LINK), (28741eaeecc37d773c230c3190f3cdeec84468e0, 2019-12-04 12:58:29 -0800, Hong Xu, 178, 12, 190, LINK)"
2504,1,6,1,7,"(674dca0831874314bf34b94f58f3a311708df34a, 2020-02-07 02:16:46 -0800, Lu Fang, 6, 1, 7, LINK)"
25067,1,13,12,25,"(efe808b326b9d1c2a6979bc7831cf06a9c05ec20, 2019-08-28 20:45:56 -0700, davidriazati, 13, 12, 25, LINK)"
25086,1,7,2,9,"(ab38059bc7174e08fd08a021a61a13dfa71ef5f4, 2019-08-23 13:12:51 -0700, Elias Ellison, 7, 2, 9, LINK)"
25097,1,1,0,1,"(44a7879b6efbea28e5a9d4ba841c5763cd4674cb, 2019-08-27 09:07:59 -0700, Edward Yang, 1, 0, 1, LINK)"
251,1,35,15,50,"(2fc3c19a24616d20f71e099a467ad5ad2bd5e947, 2016-04-17 01:33:48 +0800, Kaiyu Yang, 35, 15, 50, LINK)"
2510,1,3,2,5,"(f6f1e0aef59350df466495b4c35e2905b537eff8, 2020-01-14 15:17:37 -0800, Lu Fang, 3, 2, 5, LINK)"
25101,1,1,1,2,"(38b2bc14519bffe5389b492b0e65427edbb78480, 2019-09-16 08:58:50 -0700, Gu Jinghui, 1, 1, 2, LINK)"
2517,1,81,13,94,"(b17dfa07baf48058d429b1095a47c0471759908f, 2017-09-20 15:28:37 -0700, Edward Z. Yang, 81, 13, 94, LINK)"
25172,1,8,3,11,"(36bdde255e09c26ce5de417fd3a50c44a73e1815, 2019-09-09 19:20:45 -0700, vishwakftw, 8, 3, 11, LINK)"
25186,1,114,104,218,"(b9bf91feb8e866e030aacfaa9ad4fa9e0a5c84df, 2019-09-11 12:08:00 -0700, jiayisun, 114, 104, 218, LINK)"
2519,1,3,2,5,"(f6f1e0aef59350df466495b4c35e2905b537eff8, 2020-01-14 15:17:37 -0800, Lu Fang, 3, 2, 5, LINK)"
25214,1,73,4,77,"(7a921ba17d799cbc2553195e221747f75e9f7dd8, 2019-08-30 16:43:45 -0700, davidriazati, 73, 4, 77, LINK)"
25242,1,1,1,2,"(38b2bc14519bffe5389b492b0e65427edbb78480, 2019-09-16 08:58:50 -0700, Gu Jinghui, 1, 1, 2, LINK)"
2526,1,6,1,7,"(674dca0831874314bf34b94f58f3a311708df34a, 2020-02-07 02:16:46 -0800, Lu Fang, 6, 1, 7, LINK)"
2527,1,3,2,5,"(f6f1e0aef59350df466495b4c35e2905b537eff8, 2020-01-14 15:17:37 -0800, Lu Fang, 3, 2, 5, LINK)"
2529,1,3,2,5,"(f6f1e0aef59350df466495b4c35e2905b537eff8, 2020-01-14 15:17:37 -0800, Lu Fang, 3, 2, 5, LINK)"
25293,1,2,9,11,"(cad3abb0366075bd84d2865735dce634c308ea1d, 2019-08-29 10:45:47 -0700, ShahriarSS, 2, 9, 11, LINK)"
25301,1,52,9,61,"(7bf1dd582ac0d66364a409deb2d0b939889c2ec9, 2020-06-22 20:46:14 -0700, Vitaly Fedyunin, 52, 9, 61, LINK)"
25304,2,18,15,33,"(9d37179061ae577942a955fd2934972b9cfa5fb4, 2019-09-02 08:18:23 -0700, vishwakftw, 1, 3, 4, LINK), (53ac931af233cb9043b896d5a4988d4d4556b95c, 2019-08-28 11:03:36 -0700, Edward Yang, 17, 12, 29, LINK)"
25315,1,119,2,121,"(90ffab6e3713a40f47f4c9d3d3b16d56e83f97c4, 2019-09-25 17:34:50 -0700, Natalia Gimelshein, 119, 2, 121, LINK)"
25320,1,3,0,3,"(861194e3f8fe59b6877f62722fa1cd28b69ba45b, 2019-08-30 14:31:45 -0700, Cloud Han, 3, 0, 3, LINK)"
25360,1,28,12,40,"(f3f83ccb2370b12150797e85b70435306e7002a6, 2019-09-03 11:09:52 -0700, Horace He, 28, 12, 40, LINK)"
25399,1,3,0,3,"(4fac61a886c94456a2a9c49fe6e0a6eec502455d, 2019-09-09 07:39:37 -0700, Theo, 3, 0, 3, LINK)"
25427,1,1,2,3,"(53cacb6a591f1e6515acee4116ca0732afca6ed7, 2019-09-03 00:52:39 -0700, Justin Chiu, 1, 2, 3, LINK)"
25433,1,19,0,19,"(141f6151617098b663464da517ed0a45de9374b0, 2021-02-09 11:35:12 -0800, nikithamalgi, 19, 0, 19, LINK)"
25454,1,1,0,1,"(4fb28e5df913e742d60b120e0e31c4d6b4a2d595, 2019-08-30 07:57:52 -0700, Yaroslav Bulatov, 1, 0, 1, LINK)"
25463,1,81,24,105,"(500e72aaa5eece39bf7cfc533f74077234f578de, 2019-09-03 12:22:25 -0700, Pieter Noordhuis, 81, 24, 105, LINK)"
25525,2,151,38,189,"(c5d3be1102cc25c884eea472a5b28a0eb157d39a, 2019-12-16 15:04:23 -0800, Shihao Xu, 33, 24, 57, LINK), (b5e0fd4c5619a7b2786360a228dacc236ce238ef, 2019-10-14 10:41:34 -0700, Rohan Varma, 118, 14, 132, LINK)"
2553,1,1,0,1,"(466f0a823adec91a1fb78b7004d9ad01dc0a4d3c, 2017-08-30 10:54:16 -0700, Edward Z. Yang, 1, 0, 1, LINK)"
25531,1,107,12,119,"(fd0f9811ad0bde23588f850814fc0a561628e79c, 2019-11-04 14:41:17 -0800, Rohan Varma, 107, 12, 119, LINK)"
2555,1,6,1,7,"(674dca0831874314bf34b94f58f3a311708df34a, 2020-02-07 02:16:46 -0800, Lu Fang, 6, 1, 7, LINK)"
25580,1,3,0,3,"(4fac61a886c94456a2a9c49fe6e0a6eec502455d, 2019-09-09 07:39:37 -0700, Theo, 3, 0, 3, LINK)"
25605,1,61,16,77,"(b8ae4d0f1cdf1bed61ddfaeea68a7b69251dcea0, 2019-09-18 06:07:01 -0700, Zecong Hu, 61, 16, 77, LINK)"
25621,1,67337,0,67337,"(825f4714f92818975c5a900bba45297299a4fa8e, 2019-09-07 16:41:59 -0700, Ashkan Aliabadi, 67337, 0, 67337, LINK)"
25637,1,47,23,70,"(82c8949a9d16886086ea3d7b24bb2fc9c9437894, 2019-09-05 17:14:18 -0700, Elias Ellison, 47, 23, 70, LINK)"
2567,1,6,1,7,"(674dca0831874314bf34b94f58f3a311708df34a, 2020-02-07 02:16:46 -0800, Lu Fang, 6, 1, 7, LINK)"
2568,1,6,1,7,"(674dca0831874314bf34b94f58f3a311708df34a, 2020-02-07 02:16:46 -0800, Lu Fang, 6, 1, 7, LINK)"
25694,1,1,1,2,"(511d1875c5c00e5186abf7f092d0ae611dbc569d, 2019-09-06 09:25:55 -0700, Yuma Hiramatsu, 1, 1, 2, LINK)"
2571,1,6,1,7,"(674dca0831874314bf34b94f58f3a311708df34a, 2020-02-07 02:16:46 -0800, Lu Fang, 6, 1, 7, LINK)"
2572,1,6,1,7,"(674dca0831874314bf34b94f58f3a311708df34a, 2020-02-07 02:16:46 -0800, Lu Fang, 6, 1, 7, LINK)"
2573,1,11,1,12,"(818171163701eda56498c3e078d3bef682369fa7, 2020-05-08 21:42:58 -0700, Lu Fang, 11, 1, 12, LINK)"
25758,1,52,0,52,"(68f40fb2c89324eab2ca1da44a832d025f370e35, 2019-09-11 14:07:06 -0700, davidriazati, 52, 0, 52, LINK)"
2577,1,6,1,7,"(674dca0831874314bf34b94f58f3a311708df34a, 2020-02-07 02:16:46 -0800, Lu Fang, 6, 1, 7, LINK)"
25801,1,42,2,44,"(97b39a296f83cc8afa1281abff7acdb292eadd67, 2019-10-16 10:36:06 -0700, Hiroshi Ogawa, 42, 2, 44, LINK)"
25804,1,83,79,162,"(bb51980766182b42f631e3f156233d0fdcc881bc, 2019-10-02 11:27:58 -0700, Egor Peshkov, 83, 79, 162, LINK)"
25805,1,6,0,6,"(58e8d5588acc2ab0840380c3a89848292a73af3e, 2020-02-04 14:38:35 -0800, Ehsan Azar, 6, 0, 6, LINK)"
25807,1,171,24,195,"(735463f210584d44ca3460d7319f5eaa213842c4, 2019-10-16 11:16:56 -0700, Lara, 171, 24, 195, LINK)"
25810,1,1,0,1,"(ba59d720cd5c5c81601b53d2c3397c46c1f87883, 2019-10-21 13:01:10 -0700, Sameer Deshmukh, 1, 0, 1, LINK)"
2583,1,6,1,7,"(674dca0831874314bf34b94f58f3a311708df34a, 2020-02-07 02:16:46 -0800, Lu Fang, 6, 1, 7, LINK)"
25831,1,22,28,50,"(c389156fc4872ad4400046bf146abb6b9ec9e075, 2019-10-04 08:21:10 -0700, Sameer Deshmukh, 22, 28, 50, LINK)"
25833,1,138,47,185,"(f461184505149560803855f3a40d9e0e54c64826, 2019-10-15 11:30:43 -0700, Thomas Viehmann, 138, 47, 185, LINK)"
25836,1,32,10,42,"(26f67e7aa755cc29a161b08f8e92ab595cf9daa4, 2019-09-10 11:22:06 -0700, Ailing Zhang, 32, 10, 42, LINK)"
25854,1,2,2,4,"(9815739d83c7daf9723135046b1fc30b56844c7c, 2019-09-10 21:40:13 -0700, vishwakftw, 2, 2, 4, LINK)"
25859,1,18,4,22,"(b14c5943d463d358b0a7f75cf80bf24e5d5cc384, 2019-11-07 08:32:51 -0800, Alban Desmaison, 18, 4, 22, LINK)"
25865,1,134,69,203,"(1eaaf8b68bd0c3490f1be37c6f8c89ab315e83e2, 2019-09-23 17:22:20 -0700, Ailing Zhang, 134, 69, 203, LINK)"
25886,1,32,7,39,"(63170431f975e6ec1d5f612b9cafafeefb45ac2a, 2020-01-28 01:23:37 -0800, Michael Suo, 32, 7, 39, LINK)"
259,1,125,30,155,"(67468212e37eeaf740db98fe32e8c1b9219e4b67, 2017-04-11 11:36:22 -0700, Aaron Markham, 125, 30, 155, LINK)"
2591,1,82,0,82,"(e1148db7f257c9cec1bd85b725aa647557bf2178, 2018-05-15 04:08:14 +0200, Thomas Viehmann, 82, 0, 82, LINK)"
25917,1,3,2,5,"(66d27504e3feddfc731457fc0cea7b1c1dff7dbe, 2019-09-24 09:09:58 -0700, David Pollack, 3, 2, 5, LINK)"
2592,1,2,1,3,"(e5c7b7b8b523cab3ef6697aab0595bbeb7ece76c, 2020-02-13 21:00:42 -0800, Lu Fang, 2, 1, 3, LINK)"
2596,1,2,1,3,"(e5c7b7b8b523cab3ef6697aab0595bbeb7ece76c, 2020-02-13 21:00:42 -0800, Lu Fang, 2, 1, 3, LINK)"
2598,1,2,1,3,"(e5c7b7b8b523cab3ef6697aab0595bbeb7ece76c, 2020-02-13 21:00:42 -0800, Lu Fang, 2, 1, 3, LINK)"
260,1,47,136,183,"(e362a6497572f9a351bdaf35c88558788383f76d, 2017-04-11 13:40:03 -0700, Aaron Markham, 47, 136, 183, LINK)"
2603,1,1,1,2,"(6647a44e8cf96237851999a1d606c094b2809f5b, 2020-02-27 12:16:06 -0800, Lu Fang, 1, 1, 2, LINK)"
26032,1,1,2,3,"(9f1da984ef8eba63b874377b5c71610ad14a574b, 2019-09-24 10:09:05 -0700, Ailing, 1, 2, 3, LINK)"
26036,1,92,16,108,"(a06e1c3af7b2e0059248fe87046576f783587186, 2019-09-17 14:48:44 -0700, Elias Ellison, 92, 16, 108, LINK)"
26038,2,16,0,16,"(3c8ce2a57e8be913a6d3209fc8b0a8225d7234df, 2019-09-30 07:32:09 -0700, Vitaly Fedyunin, 8, 0, 8, LINK), (275e0c1c8f01e4bc24e7be54814849806577e237, 2019-09-30 07:32:09 -0700, Vitaly Fedyunin, 8, 0, 8, LINK)"
26052,1,221,0,221,"(f42768f8c0f4f74efa55530af8230c1a2e5753f4, 2019-10-29 11:52:31 -0700, Xiang Gao, 221, 0, 221, LINK)"
2607,1,11,1,12,"(818171163701eda56498c3e078d3bef682369fa7, 2020-05-08 21:42:58 -0700, Lu Fang, 11, 1, 12, LINK)"
26076,1,70,56,126,"(e72b0be2e1c6f63d410cb176fe2380b9990c8f2b, 2019-09-19 15:26:46 -0700, Natalia Gimelshein, 70, 56, 126, LINK)"
2608,1,11,1,12,"(818171163701eda56498c3e078d3bef682369fa7, 2020-05-08 21:42:58 -0700, Lu Fang, 11, 1, 12, LINK)"
2609,1,11,1,12,"(818171163701eda56498c3e078d3bef682369fa7, 2020-05-08 21:42:58 -0700, Lu Fang, 11, 1, 12, LINK)"
26123,1,6,0,6,"(e67064a96f675bfffbae8e8a31701209435d66a2, 2019-12-19 13:24:53 -0800, Richard Zou, 6, 0, 6, LINK)"
2613,1,5,4,9,"(1b013c0b520ad7925e918f5ebe1ca8560672cb02, 2017-09-05 16:13:56 +0200, Iacopo Poli, 5, 4, 9, LINK)"
2615,1,11,1,12,"(818171163701eda56498c3e078d3bef682369fa7, 2020-05-08 21:42:58 -0700, Lu Fang, 11, 1, 12, LINK)"
2616,1,11,1,12,"(818171163701eda56498c3e078d3bef682369fa7, 2020-05-08 21:42:58 -0700, Lu Fang, 11, 1, 12, LINK)"
26199,1,2,0,2,"(7f3c423541647b4018fbee807b7875e2b37babc9, 2019-09-14 19:28:07 -0700, Yaroslav Bulatov, 2, 0, 2, LINK)"
2620,1,11,1,12,"(818171163701eda56498c3e078d3bef682369fa7, 2020-05-08 21:42:58 -0700, Lu Fang, 11, 1, 12, LINK)"
26206,1,20,26,46,"(1cae5195a658aa361e0a0e9ec1c27804698ce55a, 2019-09-25 10:57:29 -0700, Edward Yang, 20, 26, 46, LINK)"
2623,1,11,1,12,"(818171163701eda56498c3e078d3bef682369fa7, 2020-05-08 21:42:58 -0700, Lu Fang, 11, 1, 12, LINK)"
2627,1,11,1,12,"(818171163701eda56498c3e078d3bef682369fa7, 2020-05-08 21:42:58 -0700, Lu Fang, 11, 1, 12, LINK)"
26302,1,62,61,123,"(848d1ba13a3f77bb6f14656f2d84e2228e37a8ef, 2019-10-13 21:17:24 -0700, Ethan Steinberg, 62, 61, 123, LINK)"
26304,2,26,21,47,"(945672bf3e8991a292ff466c04c84558c0e24b39, 2020-05-06 14:23:00 -0700, Wojciech Baranowski, 17, 19, 36, LINK), (db84689c09f00b59d9464ddf4e1510393b339cf1, 2020-04-21 09:41:23 -0700, Wojciech Baranowski, 9, 2, 11, LINK)"
26328,1,30,7,37,"(1a114948ce1cebab7a8b0fad35f284ccb1e4e012, 2019-09-20 13:30:22 -0700, BowenBao, 30, 7, 37, LINK)"
2633,1,4373,1,4374,"(06fdce04ca14bfd6c64a04736214046787966fb9, 2017-09-20 09:44:01 -0400, Sam Gross, 4373, 1, 4374, LINK)"
26359,1,110,90,200,"(fde94e75568b527b424b108c272793e096e8e471, 2020-01-05 00:27:42 -0800, Pritam Damania, 110, 90, 200, LINK)"
2637,2,10,2,12,"(90a8cdfdbf7e4c81a105815d299226d1b5531388, 2020-05-27 18:52:03 -0700, Lu Fang, 5, 1, 6, LINK), (51274b501ad560a1f962dac5dd0294b433fe5532, 2020-05-26 20:09:44 -0700, Lu Fang, 5, 1, 6, LINK)"
2639,2,10,2,12,"(90a8cdfdbf7e4c81a105815d299226d1b5531388, 2020-05-27 18:52:03 -0700, Lu Fang, 5, 1, 6, LINK), (51274b501ad560a1f962dac5dd0294b433fe5532, 2020-05-26 20:09:44 -0700, Lu Fang, 5, 1, 6, LINK)"
2640,1,11,1,12,"(818171163701eda56498c3e078d3bef682369fa7, 2020-05-08 21:42:58 -0700, Lu Fang, 11, 1, 12, LINK)"
26401,4,599,324,923,"(b9f099ed936a116ffd1c0ebb0d065b50fa753332, 2019-10-28 14:43:51 -0700, Xiang Gao, 93, 44, 137, LINK), (d855a0dbb22bb3a93a6c9a6efb829a988b935930, 2019-10-24 11:52:07 -0700, Xiang Gao, 96, 44, 140, LINK), (5760e8b702b16478b32b7f1a43935bae3b542d16, 2019-10-22 10:20:15 -0700, Xiang Gao, 205, 118, 323, LINK), (a3a32ff695fc4eabae7aef57406395832ee0bed4, 2019-10-19 20:15:51 -0700, Xiang Gao, 205, 118, 323, LINK)"
26433,1,3,0,3,"(ce16d689b362a1d675942d1ab016e5112db913bf, 2019-10-07 17:11:49 -0700, David, 3, 0, 3, LINK)"
26437,1,67,13,80,"(4c40dbcb755bc9c7391ca373db542094f3439add, 2019-09-20 10:46:14 -0700, davidriazati, 67, 13, 80, LINK)"
26495,1,9,3,12,"(e2515a4d6dc1895f1bc2c8b4d7950ca03ee9cc3d, 2019-09-20 07:36:32 -0700, Richard Zou, 9, 3, 12, LINK)"
2651,3,16,3,19,"(90a8cdfdbf7e4c81a105815d299226d1b5531388, 2020-05-27 18:52:03 -0700, Lu Fang, 5, 1, 6, LINK), (51274b501ad560a1f962dac5dd0294b433fe5532, 2020-05-26 20:09:44 -0700, Lu Fang, 5, 1, 6, LINK), (c0a2452ffe1bf4202763bbfcafa5867461158de3, 2019-03-29 06:48:53 -0700, Stas Bekman, 6, 1, 7, REGEX)"
26578,1,49,4,53,"(4a84ac5f5d5fe488dd42d04bb531cdfb9d9c7c08, 2020-03-24 14:32:40 -0700, Wanchao Liang, 49, 4, 53, LINK)"
26596,1,17,0,17,"(ed1552a48fb68c4a92821c14751fc63e3428800a, 2020-10-06 23:09:36 -0700, Kurt Mohler, 17, 0, 17, LINK)"
266,2,7230,85,7315,"(deb1327b6ea1f2871b22ef8c25856c8f28534ca3, 2017-04-25 20:49:42 -0700, Yangqing Jia, 42, 85, 127, LINK), (b93a7b134a697a6c846ebf2199da0b000c11c869, 2017-04-14 16:30:33 -0700, Aaron Markham, 7188, 0, 7188, LINK)"
2666,2,10,2,12,"(90a8cdfdbf7e4c81a105815d299226d1b5531388, 2020-05-27 18:52:03 -0700, Lu Fang, 5, 1, 6, LINK), (51274b501ad560a1f962dac5dd0294b433fe5532, 2020-05-26 20:09:44 -0700, Lu Fang, 5, 1, 6, LINK)"
26669,1,0,3,3,"(5500b62f28c2cf49f50c752a7c0f2a57b46b8bb5, 2020-10-14 11:28:14 -0700, ashish, 0, 3, 3, LINK)"
2667,2,10,2,12,"(90a8cdfdbf7e4c81a105815d299226d1b5531388, 2020-05-27 18:52:03 -0700, Lu Fang, 5, 1, 6, LINK), (51274b501ad560a1f962dac5dd0294b433fe5532, 2020-05-26 20:09:44 -0700, Lu Fang, 5, 1, 6, LINK)"
26671,1,68,0,68,"(cd6b37afa7168eb34e1d098e50fc730ab097c722, 2019-10-14 13:06:30 -0700, Elias Ellison, 68, 0, 68, LINK)"
26673,1,16,14,30,"(f522bde1213fcc46f2857f79be7b1b01ddf302a6, 2019-10-08 11:49:08 -0700, Nathan Goldbaum, 16, 14, 30, LINK)"
26693,1,74,21,95,"(d43480d6d16f1a9009ac0d39d394e61c5e831d27, 2019-09-25 15:39:06 -0700, Elias Ellison, 74, 21, 95, LINK)"
26698,1,9,9,18,"(eb9320032113bbb551c2f74163ca8285ce8a2cbb, 2019-10-08 11:57:34 -0700, Guanheng Zhang, 9, 9, 18, LINK)"
267,1,1,2,3,"(dd80310681dbc92b5891f6ff16ce7ed8818c3b3e, 2017-04-16 10:06:56 -0700, Aaron Markham, 1, 2, 3, LINK)"
26721,1,1,1,2,"(8f359a48a6843702e61eeefc8294f73c1a13cac1, 2019-09-25 20:35:53 -0700, Arnaud Bonnet, 1, 1, 2, LINK)"
26725,2,78,80,158,"(544c16cdbfe3ecbcea2d048ac9a39ba06f223368, 2019-10-06 20:01:53 -0700, eellison, 39, 40, 79, LINK), (990f4ca76d5bd627a295ce3aa847834d0c33af6a, 2019-09-30 17:16:10 -0700, Elias Ellison, 39, 40, 79, LINK)"
2674,2,10,2,12,"(90a8cdfdbf7e4c81a105815d299226d1b5531388, 2020-05-27 18:52:03 -0700, Lu Fang, 5, 1, 6, LINK), (51274b501ad560a1f962dac5dd0294b433fe5532, 2020-05-26 20:09:44 -0700, Lu Fang, 5, 1, 6, LINK)"
26764,7,515,3,518,"(d0d8b8c31c60786a32ada40031656a18e45020e0, 2019-10-22 14:04:38 -0700, Jiakai Liu, 6, 0, 6, LINK), (04bfc213abca624092a80025949b916497f9fd29, 2019-10-22 14:04:38 -0700, Jiakai Liu, 0, 3, 3, LINK), (38433e33a1c48d608f956c660b979bd48f17bbf4, 2019-10-22 14:04:38 -0700, Jiakai Liu, 8, 0, 8, LINK), (ccf3a6de3d41e3133beda5b630f40c08bc02bb96, 2019-10-06 20:06:22 -0700, Jiakai Liu, 6, 0, 6, LINK), (7bd7a3d80639b4010bd9ef6f8ab86ed22342201b, 2019-10-03 12:21:48 -0700, Jiakai Liu, 6, 0, 6, LINK), (9159a601ca4953ecf0d3dc568cd0b966de2d4686, 2019-09-30 12:25:50 -0700, Edward Yang, 482, 0, 482, LINK), (38f7a51cf25a8b781ac1119a6feab457c0aae70d, 2019-09-27 15:12:52 -0700, Jiakai Liu, 7, 0, 7, LINK)"
26792,1,84,5,89,"(8cdc262063d9c5e3381f0e383f89f1f07c2b083b, 2019-10-16 10:34:54 -0700, davidriazati, 84, 5, 89, LINK)"
26797,1,138,47,185,"(f461184505149560803855f3a40d9e0e54c64826, 2019-10-15 11:30:43 -0700, Thomas Viehmann, 138, 47, 185, LINK)"
2680,1,5,1,6,"(51274b501ad560a1f962dac5dd0294b433fe5532, 2020-05-26 20:09:44 -0700, Lu Fang, 5, 1, 6, LINK)"
26807,1,11,1,12,"(bf1d957dc8f64fb6dd006ce523cf844c722afa7f, 2019-09-26 14:09:01 -0700, Ethan Steinberg, 11, 1, 12, LINK)"
26811,1,107,106,213,"(188d0a9add7e10578dc1d6989bb3b22f59850eb9, 2019-11-21 13:42:35 -0800, Mike Ruberry, 107, 106, 213, LINK)"
26817,1,976,41,1017,"(76a76a6cb95ef63c073838a11418681b289878e6, 2019-09-27 07:23:03 -0700, Edward Yang, 976, 41, 1017, LINK)"
2682,2,10,2,12,"(90a8cdfdbf7e4c81a105815d299226d1b5531388, 2020-05-27 18:52:03 -0700, Lu Fang, 5, 1, 6, LINK), (51274b501ad560a1f962dac5dd0294b433fe5532, 2020-05-26 20:09:44 -0700, Lu Fang, 5, 1, 6, LINK)"
26838,2,2,1,3,"(2171f910531be28f7d5dd8e6ab8bff3a5486e6fd, 2019-12-05 10:08:01 -0800, Natalia Gimelshein, 0, 1, 1, LINK), (a573f8f7d7ca807ef14feb924c4853df79762131, 2019-11-18 07:35:52 -0800, Edward Yang, 2, 0, 2, LINK)"
26884,1,112,58,170,"(0046092178c67422d9e34b55d76c8545116fe19f, 2019-10-07 13:50:23 -0700, davidriazati, 112, 58, 170, LINK)"
26892,2,28,2,30,"(b6e976ae2dde7b18d58930fe3233396ca65f8b27, 2019-10-03 22:06:11 -0700, Hong Xu, 14, 1, 15, LINK), (73347e0ae558428078c3e842e3a27634c34bccf1, 2019-09-30 11:08:24 -0700, Hong Xu, 14, 1, 15, LINK)"
26922,1,163,83,246,"(63c957cd94e4870fcef3a735dec752ddcfd4c4d8, 2019-11-19 15:49:20 -0800, Pritam Damania, 163, 83, 246, LINK)"
26944,1,166,17,183,"(2491dd50ee381c531787677c2ab04d8203044879, 2019-10-02 13:12:58 -0700, Shen Li, 166, 17, 183, LINK)"
26996,1,20,14,34,"(a7cf04ec40e487286ad3f8068fa18321f3474dd2, 2021-01-25 13:32:12 -0800, Heitor Schueroff, 20, 14, 34, LINK)"
26998,3,35,17,52,"(831566ec90aeef8e22a7e28ca98442b11c718e33, 2019-10-04 13:03:59 +0800, peterjc123, 15, 7, 22, LINK), (ec07d144baa20de9bbdd102ccbe24e5b139c6dbc, 2019-10-01 08:49:08 -0700, peter, 15, 7, 22, LINK), (1afe3fc01eb194a3e7ce58240462de2121646233, 2019-09-30 07:50:40 -0700, Yoshiaki Nakamura, 5, 3, 8, LINK)"
27,1,9,86,95,"(d5e507fc7f9579ae442db80a3f1b96b2b79c9465, 2016-06-07 16:27:51 -0700, Sylvain Jeaugey, 9, 86, 95, LINK)"
27048,1,89,1,90,"(cc5c34a0d0bb353a700dbc41875c1a3c7906462b, 2019-10-14 08:37:31 -0700, Gaurav Tamba, 89, 1, 90, LINK)"
27073,2,10,12,22,"(1ba6fc4ca6415c64ea7653a02211439801ea4a92, 2019-10-06 23:05:33 -0400, iurii zdebskyi, 5, 6, 11, LINK), (293e35a87cbe440ee9b57e9b3dda7dc2fb67803a, 2019-10-02 14:17:59 -0700, Iurii Zdebskyi, 5, 6, 11, LINK)"
27074,2,10,12,22,"(1ba6fc4ca6415c64ea7653a02211439801ea4a92, 2019-10-06 23:05:33 -0400, iurii zdebskyi, 5, 6, 11, LINK), (293e35a87cbe440ee9b57e9b3dda7dc2fb67803a, 2019-10-02 14:17:59 -0700, Iurii Zdebskyi, 5, 6, 11, LINK)"
27077,2,146,2,148,"(d4d4bf5686b090f5cb5ef7172617c24d932c3707, 2019-10-06 23:04:42 -0400, iurii zdebskyi, 73, 1, 74, LINK), (5e776d8a45249306eddc7156f47f2fe926ab5f89, 2019-10-02 13:33:32 -0700, iurii zdebskyi, 73, 1, 74, LINK)"
27078,1,119,0,119,"(bd6f9e1d6c9145a2ed7df7916caab5296c15b744, 2019-10-18 09:39:00 -0700, naresh, 119, 0, 119, LINK)"
27081,1,70,8,78,"(803f7bfaacdd3e18788191a5ced483e8b533806b, 2019-10-02 17:26:27 -0700, Zino Benaissa, 70, 8, 78, LINK)"
27082,1,23,0,23,"(18eea8269ae60faef1cba0f9d0f00fbb9dac16f2, 2019-10-01 07:03:40 -0700, jon-tow, 23, 0, 23, LINK)"
27157,1,10,4,14,"(fc249c79245af10eeb564ab0f1d42b025a8e07f4, 2019-10-02 23:03:58 -0700, Yanli Zhao, 10, 4, 14, LINK)"
27182,1,45,13,58,"(3214f134b68358942ebc9d0dff2a2d52e8731812, 2019-10-16 16:48:03 -0700, Yanli Zhao, 45, 13, 58, LINK)"
27215,3,393,305,698,"(38986e1deabd83d27f1886dc8547522324fe0630, 2019-12-04 08:03:10 -0800, Edward Yang, 160, 117, 277, LINK), (ec30d9028a53b5b998a726a52df8b20ef564dadb, 2019-11-21 11:11:19 -0800, Edward Yang, 231, 158, 389, LINK), (a5d356cb39d521c25786c9ef14981f02ca3459be, 2019-11-06 15:00:18 -0800, Edward Yang, 2, 30, 32, LINK)"
27232,2,9,9,18,"(130127ca5991f1fb342496e2eb0e605a24551280, 2019-10-11 19:48:03 -0700, Shihao Xu, 8, 8, 16, LINK), (75effdc4fa3c586678ab3315cbc45e2ea09ef7d2, 2019-10-11 16:35:48 -0700, Shihao Xu, 1, 1, 2, LINK)"
27255,1,98,95,193,"(60cb56d128f319505946d77a753fb03311b1a60e, 2019-11-04 14:37:23 -0800, Elias Ellison, 98, 95, 193, LINK)"
27266,1,1,0,1,"(23f2fb0aecb1cb2d99fcca307b1748807c432d26, 2019-10-07 18:39:38 -0700, Pavel Belevich, 1, 0, 1, LINK)"
27350,2,398,352,750,"(6bae48c1279d547b3b307c1cca06b01fb809a68a, 2019-10-07 16:58:27 -0700, David Reiss, 199, 176, 375, LINK), (1ffa81d772e2e85648537fe6db4e247b264811a0, 2019-10-07 16:58:27 -0700, David Reiss, 199, 176, 375, LINK)"
27355,1,477,415,892,"(7f183a978f31a87a7350c526386cec92bb6b2740, 2019-10-08 09:50:28 -0700, Mike Ruberry, 477, 415, 892, LINK)"
27356,1,39,47,86,"(d5c4a80cfdc0b253c43d0a198f26abec9e35cdce, 2020-12-10 09:53:27 -0800, Jeff Daily, 39, 47, 86, LINK)"
27366,1,33,1,34,"(c1c176d91bc7a7f47aecf01454548381f4c20e16, 2019-10-08 12:17:53 -0700, Heungsub Hans Lee, 33, 1, 34, LINK)"
27401,1,555,224,779,"(fdeef45852578a068a62abba253a87aab857dc5f, 2019-11-04 09:18:09 -0800, Elias Ellison, 555, 224, 779, LINK)"
27405,1,44,39,83,"(06c7420fa24235b2bdbf4e4abe7ca20d291f86aa, 2019-12-10 08:02:14 -0800, hxia11, 44, 39, 83, LINK)"
27442,2,50,2,52,"(e66e00cd1700df179816a1555f28691cdec029c1, 2019-10-09 19:25:15 -0700, Thomas Viehmann, 25, 1, 26, LINK), (17613ad73c30700123cbae2120d128325d2d5084, 2019-10-07 10:35:49 +0200, Thomas Viehmann, 25, 1, 26, LINK)"
27463,2,30,2,32,"(2a4aad746623018163d943bad9503de99b599186, 2020-02-24 21:53:29 -0800, peter, 20, 0, 20, LINK), (ebed008dd4a13634de2b0639b417423f0c476455, 2020-02-10 11:26:19 -0800, peterjc123, 10, 2, 12, LINK)"
27464,1,49,0,49,"(136bb07a93b779acbc84ff341bc397551a8cfcc2, 2019-10-24 09:26:37 -0700, Anjali Chourdia, 49, 0, 49, LINK)"
27493,1,74,3,77,"(31b57e38cbf042074ca057f0d72df5fd3f88847f, 2020-05-15 17:51:16 -0700, Jason Ansel, 74, 3, 77, LINK)"
27495,1,205,124,329,"(148bcd3ee50ca547288da64d7e3ecb65178e3b40, 2019-12-18 15:22:44 -0800, davidriazati, 205, 124, 329, LINK)"
27506,1,555,224,779,"(fdeef45852578a068a62abba253a87aab857dc5f, 2019-11-04 09:18:09 -0800, Elias Ellison, 555, 224, 779, LINK)"
27512,1,85,4,89,"(f48a8901c580fc7d192477de1ff8806bdd1c5164, 2019-12-10 07:49:11 -0800, Elias Ellison, 85, 4, 89, LINK)"
27551,1,21,0,21,"(17d4ef9e9e9b2c59ae1473a509d085c4d397bee3, 2020-02-07 17:06:44 -0800, Brian Stark, 21, 0, 21, LINK)"
27568,2,13,2,15,"(732a3d8f8cba05026638f07d34f50e60ea59b02c, 2019-10-30 14:07:36 -0700, peter, 2, 1, 3, LINK), (b9b9fd4fadc4d4fa0b030941a35011956eafa10b, 2019-10-09 09:30:02 -0700, peter, 11, 1, 12, LINK)"
27569,1,128,0,128,"(a472f0201f51064b8d35a6179da05c9abf32ed8b, 2020-01-13 19:39:46 -0800, Brian Stark, 128, 0, 128, LINK)"
27605,1,9,1,10,"(f7d7c4b72fd936181416f55b4f15c05de7076110, 2019-10-10 15:36:05 -0700, auroraustc, 9, 1, 10, LINK)"
27623,1,2,1,3,"(71af538e31547e5b1bc814c9e00323a21905baf3, 2020-06-02 13:32:38 -0700, Nayef Ahmed, 2, 1, 3, LINK)"
27627,1,2,2,4,"(72eff0021e8fb1e77a557b82f89f6fae2dc1a821, 2019-11-11 10:10:41 -0800, Peter Bell, 2, 2, 4, LINK)"
27691,1,59,20,79,"(5e73e1fff86d27a92ea9901b078202aec963abca, 2019-10-22 09:06:01 -0700, iurii zdebskyi, 59, 20, 79, LINK)"
27737,1,7,6,13,"(4bcedb66702a49c6c7e89f0a35321312bc5efcdb, 2019-10-14 06:56:06 -0700, Michael Steininger, 7, 6, 13, LINK)"
27753,1,3,4,7,"(cedca377bd005d68f553648c5b36dbd58a62a520, 2019-11-11 13:30:00 -0800, Richard Zou, 3, 4, 7, LINK)"
27811,3,42,0,42,"(9d45ee1d8116d15499e6f7484ecc118fb9f49d0f, 2019-10-14 11:23:56 -0700, Dmytro Dzhulgakov, 14, 0, 14, LINK), (80ae6d294b37d712400b3d84e8d4e8e6a410efe4, 2019-10-14 11:23:56 -0700, Dmytro Dzhulgakov, 14, 0, 14, LINK), (169327f557bcf9f0a1300e23336d07479320b0a7, 2019-10-14 11:23:56 -0700, Dmytro Dzhulgakov, 14, 0, 14, LINK)"
27820,2,7,2,9,"(6a275b696e3e5bd043b97ddbab0d1f6dbcfd6675, 2020-02-24 07:57:31 -0800, DuckSoft, 3, 2, 5, LINK), (498ca083a6595569497540c77ea0c7de074c2a32, 2019-10-15 08:36:20 -0700, DuckSoft, 4, 0, 4, LINK)"
27824,2,91,50,141,"(cc98c93bf358ea155651853c8f7ad626770c8a3c, 2019-10-31 23:56:18 -0400, Brian Vaughan, 77, 40, 117, LINK), (70e4548fd75682ee0196f59f391e8f3747e2b742, 2019-10-24 15:15:56 -0700, Brian Vaughan, 14, 10, 24, LINK)"
27844,1,16,3,19,"(d2eceee54b0545b4a12ad8b2b9d2263e9af4dd7d, 2019-10-18 10:16:35 -0700, Ailing Zhang, 16, 3, 19, LINK)"
27875,1,8,1,9,"(b141754b7fa1f048fb27dfbd5cb3491419156273, 2019-11-11 08:09:29 -0800, Edward Yang, 8, 1, 9, LINK)"
27954,2,110,94,204,"(821f8bfc2fe9b57712a40723ae4983712f568fc7, 2019-11-07 13:42:04 -0800, James Reed, 58, 47, 105, LINK), (f17e02fd947511f50e22542f8e2bc6df706954d1, 2019-11-06 17:00:21 -0800, James Reed, 52, 47, 99, LINK)"
27963,2,18,8,26,"(b37fbd2d190a96c9d166498234c1f5a82b6e0b00, 2019-11-13 17:54:37 -0800, Jianyu Huang, 9, 4, 13, LINK), (30cdfc013a4baec48b9f8eb92d0be5cd6eec4d23, 2019-11-13 17:54:31 -0800, Jianyu Huang, 9, 4, 13, LINK)"
28009,1,10,8,18,"(2d2fe14a60d5deae092d4605caeba698c73245d7, 2019-10-16 10:00:29 -0700, Gao Xiang, 10, 8, 18, LINK)"
28010,2,138,71,209,"(cc98c93bf358ea155651853c8f7ad626770c8a3c, 2019-10-31 23:56:18 -0400, Brian Vaughan, 77, 40, 117, LINK), (3fce612cb12c455d69803466cd18bd09a2e4613d, 2019-10-22 10:35:14 -0700, Brian Vaughan, 61, 31, 92, LINK)"
28015,1,17,1,18,"(07b5666a87078de0fda8d25b1f0757a5acb3661d, 2019-10-17 14:09:58 -0700, Zafar Takhirov, 17, 1, 18, LINK)"
28060,1,177,177,354,"(86c64440c9169d94bffb58b523da1db00c896703, 2019-11-07 09:18:38 -0800, vishwakftw, 177, 177, 354, LINK)"
2809,1,1,0,1,"(6a800be748761ab4d09b7e0473968befb94905f9, 2017-09-28 18:11:15 -0700, Jiaming Liu, 1, 0, 1, LINK)"
28216,1,2,2,4,"(1c53a74e266ec90c57f32f041ff7747b86246f47, 2019-10-23 13:37:13 -0700, Timothy Man, 2, 2, 4, LINK)"
28271,2,30,2,32,"(2a4aad746623018163d943bad9503de99b599186, 2020-02-24 21:53:29 -0800, peter, 20, 0, 20, LINK), (ebed008dd4a13634de2b0639b417423f0c476455, 2020-02-10 11:26:19 -0800, peterjc123, 10, 2, 12, LINK)"
28280,1,31,1,32,"(8d66f88eb160016b9c7c184dd2cef554c9f3bbcd, 2020-04-15 17:29:24 -0700, davidriazati, 31, 1, 32, LINK)"
28288,1,33,12,45,"(a074080d5739a9e2bbe90ffa82aeb173e35bfdff, 2019-11-22 04:04:25 -0800, Pieter Noordhuis, 33, 12, 45, LINK)"
28294,1,200,8,208,"(70013415c7acc109985a86f42d835fbbcfa45bf3, 2019-12-13 19:23:52 -0800, Yinglin Sun, 200, 8, 208, LINK)"
28305,4,24,0,24,"(68ab162099618f4e35fe37ae1318c5b1a40bdac3, 2019-10-25 10:09:48 -0700, Edward Yang, 8, 0, 8, LINK), (186fd3f1832ca712611e69c2deabc0b913c2bd92, 2019-10-24 10:32:42 -0400, Edward Z. Yang, 4, 0, 4, LINK), (44042fef8540fe7418258d821a41b7f9086bb473, 2019-10-24 10:32:42 -0400, Edward Z. Yang, 8, 0, 8, LINK), (935bef419187a601d59d2629b56491b7c7d10a38, 2019-10-24 10:24:37 -0400, Edward Z. Yang, 4, 0, 4, LINK)"
28313,2,109,2,111,"(03ff3eb94d193572dd8029b02e02c34c17bada33, 2020-01-10 11:35:17 -0800, Jiakai Liu, 3, 1, 4, LINK), (3694749cd1b2bfbb4537ea767fdbbe925b815923, 2019-12-18 08:03:39 -0800, Kurt Mohler, 106, 1, 107, LINK)"
28347,1,27,4,31,"(0fdbb762d1a9e6b9c262760b6b67bcb3d0814407, 2019-11-21 13:04:42 -0800, Prasun Anand, 27, 4, 31, LINK)"
28360,2,534,335,869,"(02c3493a84d28f5c930b076a3890f4272a7e6db4, 2020-01-14 16:20:58 -0800, Nikolay Korovaiko, 447, 323, 770, LINK), (319cc21108da87bea879700107a30ddeff3bfb92, 2020-01-08 16:44:58 -0800, Elias Ellison, 87, 12, 99, LINK)"
28365,1,3,11,14,"(a5354adb08be1fd66391c6b8dae7aac3be7ac258, 2019-10-22 13:59:14 -0700, Hong Xu, 3, 11, 14, LINK)"
28389,1,61,0,61,"(dcd1216efeffe4302d6e3c8806af617fc3b27cf7, 2019-12-03 15:20:47 -0800, Peter Bell, 61, 0, 61, LINK)"
28502,2,91,50,141,"(cc98c93bf358ea155651853c8f7ad626770c8a3c, 2019-10-31 23:56:18 -0400, Brian Vaughan, 77, 40, 117, LINK), (70e4548fd75682ee0196f59f391e8f3747e2b742, 2019-10-24 15:15:56 -0700, Brian Vaughan, 14, 10, 24, LINK)"
28518,1,16,1,17,"(28be2d4994cffd2cc31d41c3995d0953b7c23849, 2019-10-30 16:45:47 -0700, Zafar Takhirov, 16, 1, 17, LINK)"
28537,1,178,83,261,"(883fb5434ab5f046e8c224bc606fe4976d8a626b, 2020-01-08 15:39:32 -0800, davidriazati, 178, 83, 261, LINK)"
28550,1,1,0,1,"(991c2ac383801ecd3b0bf40c0c8595dd216bb988, 2019-11-08 13:46:14 -0800, Mike Ruberry, 1, 0, 1, LINK)"
28559,1,133,15,148,"(2181dd516e2b3b0ea1e11008bdaf40415584475c, 2019-10-24 22:22:07 -0700, Michael Suo, 133, 15, 148, LINK)"
28575,1,29,7,36,"(2c3c702d297b6a784474a092eea2bf2fbb980322, 2019-11-05 07:09:00 -0800, Hiroshi Ogawa, 29, 7, 36, LINK)"
28583,1,1,1,2,"(f5edb62a7fe422e7e60c06698f310697cf268b77, 2019-10-30 13:54:24 -0700, Alban Desmaison, 1, 1, 2, LINK)"
28646,2,46,4,50,"(bd9766a36a6b87ce7818bceb50c09fde252b168f, 2019-10-31 23:46:19 -0400, Richard Zou, 23, 2, 25, LINK), (5da932ad728ed61f3fe09ccb7dfa8a4795a45efb, 2019-10-28 06:59:33 -0700, Richard Zou, 23, 2, 25, LINK)"
28649,1,55,4,59,"(3cf8382984087dcff095b6b0681da241682d5df6, 2019-12-03 15:36:01 -0800, Prasun Anand, 55, 4, 59, LINK)"
28714,1,14,6,20,"(5d70b11d36dce08c896415ca7254b8c727803501, 2019-11-07 08:16:23 -0800, Igor Fedan, 14, 6, 20, LINK)"
28753,1,1,0,1,"(50fd20b64a97cc75a94f95c5b08cbf9d0580340c, 2019-10-30 10:47:09 -0700, qzhong0605, 1, 0, 1, LINK)"
28789,1,1,1,2,"(d8d7af0811c31d030c04bf60d016f7e88b00dce3, 2019-11-01 13:47:47 -0700, Xiang Gao, 1, 1, 2, LINK)"
28792,1,2,356,358,"(1c8ef29ac5e23acaee20109196263dd13336cf7d, 2019-10-31 21:25:13 -0700, Xiang Gao, 2, 356, 358, LINK)"
28819,1,54,16,70,"(e1a309a647c5096bddaf44c423cc5dea8d6cae6c, 2019-11-14 23:00:41 -0800, Shen Li, 54, 16, 70, LINK)"
28885,1,82,174,256,"(63675b1969d5437384851e0e543b2fe9785334ce, 2019-11-08 08:28:54 -0800, Shen Li, 82, 174, 256, LINK)"
28928,1,163,83,246,"(63c957cd94e4870fcef3a735dec752ddcfd4c4d8, 2019-11-19 15:49:20 -0800, Pritam Damania, 163, 83, 246, LINK)"
28958,1,2,1,3,"(cddda17394d4d763d47059678d2ce2d8c9c677b0, 2019-11-01 13:57:25 -0700, Kevin Wilfong, 2, 1, 3, LINK)"
28969,1,10,6,16,"(0fbce158288250f076420dc3794a0f13c250830d, 2019-11-04 08:26:30 -0800, Edward Yang, 10, 6, 16, LINK)"
2898,1,0,1,1,"(a0831219cf8e06ab8438d50dbf4617db78d931c1, 2017-10-08 21:03:19 -0400, Edward Z. Yang, 0, 1, 1, LINK)"
28998,1,160,64,224,"(057fd5e10d99ff54bb3881516fec19a8608cde39, 2020-02-26 18:04:42 -0800, Elias Ellison, 160, 64, 224, LINK)"
29004,1,1,1,2,"(31c932d9abb9e0cfb64da0286d0d7438a2999234, 2019-11-01 07:58:49 -0700, HanGuo97, 1, 1, 2, LINK)"
29008,1,114,7,121,"(584be86c3f2855c2c0cb8b32edb548cb011b6e30, 2019-11-25 20:59:25 -0800, BowenBao, 114, 7, 121, LINK)"
29031,2,442,240,682,"(80e3f173015836aecff0de09a23501adffd03107, 2019-11-19 18:50:44 -0800, Shihao Xu, 221, 120, 341, LINK), (21dc1d4543c1aebdb0952c20984a3b552e1f49b1, 2019-11-19 00:58:21 -0800, Shihao Xu, 221, 120, 341, LINK)"
29032,1,33,12,45,"(eccf42fd1532b2a34822118d6fb4fcbfa8c18832, 2019-11-25 20:41:28 -0800, Raghuraman Krishnamoorthi, 33, 12, 45, LINK)"
29035,1,85,43,128,"(f27403d761ca6263b47ffff1af01e29eacff8ebb, 2020-03-27 16:57:16 -0700, davidriazati, 85, 43, 128, LINK)"
29058,1,6,0,6,"(d05da7dad347ffecc3ea0f1f191d1cdb2ad5d89f, 2019-11-06 09:00:52 -0800, peter, 6, 0, 6, LINK)"
29065,1,189,163,352,"(f4b9690f2d609094a6d952a9c8d247447a6e1b2d, 2019-11-21 13:07:18 -0800, Alan Du, 189, 163, 352, LINK)"
29083,1,91,3,94,"(63f4b607aa1c334a843fadd1d351c8c3eed3c206, 2019-11-18 20:09:27 -0800, Pritam Damania, 91, 3, 94, LINK)"
29099,1,4,2,6,"(e3d40f857b7e51b1eec2a63e1b81a4afdebf869a, 2019-12-10 14:33:32 -0800, Michael Suo, 4, 2, 6, LINK)"
29153,1,38,13,51,"(adfb8a4888c5c471aae0201f5a5a62ee1def8f0b, 2019-11-18 12:37:04 -0800, Brian Vaughan, 38, 13, 51, LINK)"
29159,2,223,209,432,"(d8732b3b43983dd16d8f3c4bfd3970adc4c03b89, 2019-11-12 22:46:38 -0800, Ivan Kobzarev, 155, 146, 301, LINK), (5249c43d9396bc19c8778b5c1fe0c2213af76314, 2019-11-11 18:24:58 -0800, Ivan Kobzarev, 68, 63, 131, LINK)"
29161,1,254,209,463,"(f531815526c69f432e46fadece44f5d3a9b70e30, 2019-12-05 10:53:32 -0800, Nathan Goldbaum, 254, 209, 463, LINK)"
29162,1,177,177,354,"(86c64440c9169d94bffb58b523da1db00c896703, 2019-11-07 09:18:38 -0800, vishwakftw, 177, 177, 354, LINK)"
29187,1,73,52,125,"(37ca5a8a644a21efcb1bf37c1da66ef81133af06, 2019-11-19 09:36:52 -0800, Peter Bell, 73, 52, 125, LINK)"
29211,1,21,6,27,"(ae6af8d55faa6efa6018d20fec3a4909acd36a4e, 2019-11-20 13:04:02 -0800, vishwakftw, 21, 6, 27, LINK)"
29252,1,66,27,93,"(945ce71b18357454bf9ac353ae2556ea7719cb57, 2019-12-11 15:34:02 -0800, Brian Vaughan, 66, 27, 93, LINK)"
29271,1,55,30,85,"(267fd4a06cec5cea4749c8f6375acd62ce453656, 2019-11-18 21:50:29 -0800, neginraoof, 55, 30, 85, LINK)"
29326,1,1,0,1,"(4515edfe1596db609b1a4c4601026ce2befc089b, 2019-11-06 21:28:40 -0800, Supriya Rao, 1, 0, 1, LINK)"
29352,1,127,70,197,"(2032482eb97f0b650f11fd117791c9bc62125dee, 2019-11-09 23:10:46 -0800, Xiang Gao, 127, 70, 197, LINK)"
29367,1,32,31,63,"(782e80e6e71ab05b53bd5f0ca2db079f8e86b243, 2019-11-07 16:27:39 -0800, James Reed, 32, 31, 63, LINK)"
29435,1,8,3,11,"(82913a266d76279d282a10edbb59e405d7cec648, 2019-11-12 13:14:03 -0800, Jerry Zhang, 8, 3, 11, LINK)"
29475,1,23,5,28,"(69e343f2cc26f7a090fa0a4c4f8cf5064d4df1c9, 2019-11-15 11:15:02 -0800, vishwakftw, 23, 5, 28, LINK)"
29578,1,28,7,35,"(a9ad2e2f00e9b7d9b30af5c0c6db348432ad7964, 2019-11-18 23:06:18 -0800, Natalia Gimelshein, 28, 7, 35, LINK)"
29646,1,4,4,8,"(7023e13fbba56fade9db82ac32052e7ef635597c, 2019-12-03 11:31:40 -0800, Jerry Zhang, 4, 4, 8, LINK)"
29649,1,20,10,30,"(2d6b2f39e92cc7a15cd006dbe642ae4adc87124b, 2019-11-26 16:52:12 -0800, Daya Khudia, 20, 10, 30, LINK)"
29712,1,96,51,147,"(c6f41ae01b2014e4001996b30fd0f429002ecb87, 2020-01-10 08:13:19 -0800, Tongzhou Wang, 96, 51, 147, LINK)"
29744,1,6,3,9,"(0f0972051a7eaf3da645b2f18cc77be188d59b8d, 2020-01-30 16:55:02 -0800, root, 6, 3, 9, LINK)"
29764,1,3,3,6,"(f1860aea83dbf880cff242c18cb286cc502544e6, 2019-11-15 17:47:34 -0800, Zachary DeVito, 3, 3, 6, LINK)"
29823,1,3,3,6,"(1f1ce53e8e93c80b3f88b9e6c84013a037e9c074, 2019-12-04 16:38:50 -0800, Nathan Goldbaum, 3, 3, 6, LINK)"
29905,1,7,0,7,"(fea963d3aee26ab27a79050357dbc9a363b7c162, 2019-11-21 16:20:39 -0800, Shen Li, 7, 0, 7, LINK)"
29906,1,118,13,131,"(609d5a44763da34a99548ee2d2891437885a0c50, 2020-05-08 00:03:13 -0700, Tzu-Wei Huang, 118, 13, 131, LINK)"
29909,1,52,11,63,"(d4c25add458f65fb9de1f1310cd536d4c073d3aa, 2019-12-03 14:57:21 -0800, Nikolay Korovaiko, 52, 11, 63, LINK)"
29924,1,23,2,25,"(b410d864c979dd0fcc2938c1453e2a9856fdd100, 2019-11-19 21:31:58 -0800, Yanli Zhao, 23, 2, 25, LINK)"
29968,2,9,35,44,"(daf00beabaf82da5fac19098de045c872bd0bd34, 2020-01-03 08:46:17 -0800, Hong Xu, 7, 35, 42, LINK), (3455231e9cd67e03fe86262d8fe19432ca4789a7, 2019-11-22 07:04:49 -0800, Hong Xu, 2, 0, 2, LINK)"
29994,1,607,0,607,"(22ac071d9a173ea2358dd7c88a3a47fb1e2a2fe1, 2020-04-27 07:39:50 -0700, Pavel Izmailov, 607, 0, 607, LINK)"
29995,1,24,10,34,"(d97413eb7ae34355022c47da1dd5c8eba2a220f7, 2020-01-13 11:59:46 -0800, Richard Zou, 24, 10, 34, LINK)"
3,12,199,128,327,"(0b93974075844601913c6df50f6566418a35eee8, 2021-02-25 14:32:13 -0800, Akao Kazutoshi, 2, 2, 4, LINK), (c18af03a412110d6e264fb54f8b74d6693fdb8c7, 2020-12-17 00:35:20 -0800, Ansha Yu, 17, 0, 17, LINK), (e34e32850e8b546f3b7ba264c4ee627ebf948ab0, 2020-06-17 16:47:24 -0700, Pavel Belevich, 26, 53, 79, LINK), (70192c651ce247f01de594d5ceeb74bfdee27cfb, 2020-06-17 12:07:11 -0700, Pavel Belevich, 53, 26, 79, LINK), (336e0d2874c2e74fc98f60d20a3192471ee3300e, 2019-12-17 10:56:50 -0800, Mingbo Wan, 4, 4, 8, LINK), (7e6d932208a866551ca1b9ea7f149d48eb3ad413, 2019-06-05 18:03:51 -0700, Junjie Bai, 7, 1, 8, LINK), (b90cbb841d98aeae435b1d02b1ff211e028cdf5b, 2019-04-05 12:44:49 -0700, Joakim Rishaug, 1, 1, 2, LINK), (9de4350b77cd7f257c1c60d325f267d50965531e, 2019-03-14 15:39:25 -0700, Lu Fang, 1, 1, 2, LINK), (be6ad7ddde64cebeec4cd9537ddc3bca9cbe18e5, 2019-02-22 07:54:47 -0800, Will Feng, 8, 8, 16, LINK), (0b78ae86c59e7372f0b9d4cadcd0e50bc76f8667, 2018-09-10 15:30:08 -0700, Owen Anderson, 77, 29, 106, LINK), (4664808938b22c22abd216008926ecd81cb0c5e5, 2017-09-24 17:07:30 -0700, Igor Sugak, 1, 1, 2, LINK), (efda016108f16d4ac6087a3bcb0909729c1a7e11, 2017-09-13 23:17:05 -0700, Philip Pronin, 2, 2, 4, LINK)"
30015,1,85,35,120,"(85107e72b4abb1007de94287707985dd06e977db, 2019-12-11 20:05:55 -0800, Elias Ellison, 85, 35, 120, LINK)"
30022,1,7,14,21,"(a561a8448b6b7bb8f6068178fe7bc9e2bf348304, 2020-01-06 22:16:37 -0800, Rohan Varma, 7, 14, 21, LINK)"
30044,1,4,0,4,"(a5272cb6433efe0bdaf76bff428ce961538daa25, 2019-11-22 11:16:42 -0800, Brian Vaughan, 4, 0, 4, LINK)"
30102,1,212,85,297,"(37435d36eddca3778014503aeaeef1f0dccb8bb2, 2019-12-06 11:43:10 -0800, Sebastian Messmer, 212, 85, 297, LINK)"
3026,1,58,1,59,"(e44f901b55873ebb6b1b0d3bab30fd89d487b71c, 2018-04-19 04:09:03 -0700, Armen, 58, 1, 59, LINK)"
30296,1,3,3,6,"(99a46b44eaeb36689ca99f97e41fccaa51d3c127, 2019-11-25 07:32:24 -0800, Edward Yang, 3, 3, 6, LINK)"
30462,4,264,116,380,"(21acca4528396a3fe8aed611de690125b79293d5, 2019-12-02 21:57:28 -0800, Will Feng, 82, 56, 138, LINK), (f7107575574275c14a1db746cace5da6fb5b7917, 2019-11-27 21:18:45 -0800, Will Feng, 50, 2, 52, LINK), (18ec4632b335521c8497ca2760a386c6d0d10a64, 2019-12-02 21:57:28 -0800, Will Feng, 82, 56, 138, LINK), (7ac8efa689de7f62993dc3241127f911166585b1, 2019-11-27 21:18:45 -0800, Will Feng, 50, 2, 52, LINK)"
30477,1,27,6,33,"(f30b14dead12776981bb0a9449deb52b2fd9f17d, 2019-12-12 18:17:42 -0800, Alexander Stante, 27, 6, 33, LINK)"
30480,3,233,113,346,"(323b0e0a0f8a7531bb58780dbf8eacbf5ed882e6, 2020-02-12 12:41:29 -0800, lixinyu, 124, 4, 128, LINK), (ec1e9a1ae2cd53fa787beeef3a821a5b6b058322, 2020-02-06 06:59:11 -0800, Richard Zou, 2, 107, 109, LINK), (3c17cbb6c8d62066c55b82c6a2c3609046327f63, 2020-02-05 23:44:53 -0800, lixinyu, 107, 2, 109, LINK)"
30508,4,264,116,380,"(21acca4528396a3fe8aed611de690125b79293d5, 2019-12-02 21:57:28 -0800, Will Feng, 82, 56, 138, LINK), (f7107575574275c14a1db746cace5da6fb5b7917, 2019-11-27 21:18:45 -0800, Will Feng, 50, 2, 52, LINK), (18ec4632b335521c8497ca2760a386c6d0d10a64, 2019-12-02 21:57:28 -0800, Will Feng, 82, 56, 138, LINK), (7ac8efa689de7f62993dc3241127f911166585b1, 2019-11-27 21:18:45 -0800, Will Feng, 50, 2, 52, LINK)"
30512,1,42,2,44,"(1d5af9599dcfd5b1e9688ff0bfc66f0e44589123, 2019-12-12 15:25:21 -0800, Lara, 42, 2, 44, LINK)"
30526,1,75,115,190,"(affd598c1fc781919b88aa2efc4a2c1f2d2c96a7, 2020-01-30 00:26:16 -0800, Basil Hosmer, 75, 115, 190, LINK)"
30562,1,49,2,51,"(74d69e296e71896bbe29b92fd6dae41cbbee21e3, 2020-01-07 11:28:46 -0800, Peter Bell, 49, 2, 51, LINK)"
30572,1,5,4,9,"(2011cc1e91b313702cb11392bad90d920a22babb, 2019-12-06 00:24:27 -0800, Xiang Gao, 5, 4, 9, LINK)"
30583,1,53,25,78,"(a64d0ffe81b250889a3e6670daa9c7d07d946e32, 2020-02-11 11:58:19 -0800, ptrblck, 53, 25, 78, LINK)"
3059,1,115,46,161,"(ddff4efa26d527c99cd9892278a32529ddc77e66, 2020-01-09 07:26:25 -0800, Edward Yang, 115, 46, 161, LINK)"
30627,1,3,3,6,"(1f1ce53e8e93c80b3f88b9e6c84013a037e9c074, 2019-12-04 16:38:50 -0800, Nathan Goldbaum, 3, 3, 6, LINK)"
30682,2,4,8,12,"(fb8aa0e98c1199bb05bccab4f318615542ad9999, 2019-12-03 14:49:37 -0800, Will Feng, 2, 4, 6, LINK), (03a73cb9ac75400fe5ee88de4d1271d45c785e10, 2019-12-03 14:49:37 -0800, Will Feng, 2, 4, 6, LINK)"
307,1,2,2,4,"(fa78ede747d31e1e5ded88d74534a07babebe746, 2015-07-28 14:30:20 +0200, Soumith Chintala, 2, 2, 4, LINK)"
30704,2,245,142,387,"(2471ddc96c56162861f41f3b6b772b4b4e773ea7, 2020-01-29 11:41:47 -0800, Dylan Bespalko, 101, 52, 153, LINK), (11b30653236c1f401ee9cf0966482c06249da081, 2019-12-06 07:21:19 -0800, Edward Yang, 144, 90, 234, LINK)"
30717,1,3,1,4,"(8693164acbc797c75a08381c7735337a8a58621f, 2020-01-29 12:00:04 -0800, Ailing Zhang, 3, 1, 4, LINK)"
30755,1,42,0,42,"(960f4b51e3403f14b407328823bd38e8e1067592, 2020-05-14 21:10:14 -0700, Michael Voznesensky, 42, 0, 42, LINK)"
30764,1,1,1,2,"(6d9a9e379d01ab66365d8e98dc3566fab9465a0d, 2020-01-08 17:11:46 -0800, Supriya Rao, 1, 1, 2, LINK)"
30775,1,105,26,131,"(2111c4ff0ca3b134e363c592e81a7b7b5bd7d24f, 2020-02-28 19:02:39 -0800, davidriazati, 105, 26, 131, LINK)"
30813,3,4301,3014,7315,"(385165ec674b764eb42ffe396f98fadd08a513eb, 2020-04-24 10:19:05 -0700, Jerry Zhang, 1899, 1274, 3173, LINK), (97d3a8495deb634267e2a5e4c4517647d0567c44, 2020-04-21 13:12:23 -0700, Jerry Zhang, 1204, 870, 2074, LINK), (f6daa6220e2689e5a964f365e8c7167b11b33815, 2020-04-19 08:31:10 -0700, Aleksandr Fedorov, 1198, 870, 2068, LINK)"
30818,1,10,7,17,"(bf6a156f6412c203af8fba8a3945171431600b55, 2020-11-10 17:19:51 -0800, Heitor Schueroff, 10, 7, 17, LINK)"
30820,1,6,4,10,"(9dc3d8738cafe84f89e36c5358f13ae3355825cc, 2019-12-15 11:49:49 -0800, Natalia Gimelshein, 6, 4, 10, LINK)"
30845,1,2,12,14,"(e8b00023b2ac46e25f2e00592d5f8c38ff53278a, 2020-12-09 00:38:47 -0800, Jeff Daily, 2, 12, 14, LINK)"
30886,3,5,5,10,"(e025f393f6078fe8ccdb5e43e575d9f074bc4e53, 2020-02-07 00:39:39 -0800, Michael Ranieri, 1, 1, 2, LINK), (c62759ca73aca0ee01aa46f1b1a9c8b4ae27ab59, 2020-01-10 10:34:11 -0500, Edward Z. Yang, 2, 2, 4, LINK), (b261012b21241c9fc6e35f3d9a6da537c7797422, 2020-01-10 10:34:02 -0500, Edward Z. Yang, 2, 2, 4, LINK)"
309,2,24,182,206,"(29827e19711ce5a73adcd54f4b0ec694d0b21e79, 2019-02-05 01:51:52 -0800, James Reed, 4, 0, 4, LINK), (d58141ec4c626a97459ae2be6847e576bd93a51b, 2017-04-19 11:40:51 -0700, Aaron Markham, 20, 182, 202, LINK)"
30910,1,2,0,2,"(9a5fd2eb07e6f7ff7516e1a59831464594191d65, 2019-12-10 22:20:56 -0800, peterjc123, 2, 0, 2, LINK)"
30931,2,482,92,574,"(a06f26560cc6503f45974b1bbfc1f682d76b7a4b, 2019-12-11 20:29:04 -0800, Will Feng, 241, 46, 287, LINK), (49a5841a9f2e444eb2ac8c7ca2efca084457c490, 2019-12-11 20:29:04 -0800, Will Feng, 241, 46, 287, LINK)"
30932,1,26,12,38,"(c4121ed8dbe5a1b8e0ad3d28be2c9b7b54db6389, 2019-12-19 12:08:12 -0800, peterjc123, 26, 12, 38, LINK)"
30943,1,1,1,2,"(3a400b8dc34db23c697fcf2be0b900f4f5d769d5, 2020-04-17 11:16:37 -0700, Tzu-Wei Huang, 1, 1, 2, LINK)"
30960,1,40,48,88,"(285cc13435ed62ae00e627e57d6db0ccd21bc15c, 2019-12-18 09:21:07 -0800, Natalia Gimelshein, 40, 48, 88, LINK)"
30986,1,424,444,868,"(a38c6e04549f13949b6ea27b5772e77cf8c3ae9a, 2020-04-23 06:20:00 -0700, Gao Xiang, 424, 444, 868, LINK)"
30988,1,22,8,30,"(ad78c0f4fc880c0da5064ccb85290c38dbe252ab, 2020-01-31 16:51:37 -0800, Omkar Salpekar, 22, 8, 30, LINK)"
31006,1,424,444,868,"(a38c6e04549f13949b6ea27b5772e77cf8c3ae9a, 2020-04-23 06:20:00 -0700, Gao Xiang, 424, 444, 868, LINK)"
31021,1,102,28,130,"(1296e2d55ef66d711e993f1c799d0a1a72a7171f, 2020-01-09 13:13:56 -0800, TH3CHARLie, 102, 28, 130, LINK)"
31027,1,1,1,2,"(4ead2e8996c7dd8a0d3a07541449da48c2b9f3c6, 2019-12-12 11:27:18 -0800, Ivan Kobzarev, 1, 1, 2, LINK)"
3104,1,171,87,258,"(57ffe64cbe67c6ab4e6bf0a73cf801b93c41fe7d, 2017-10-18 23:38:07 +0200, Marcin Elantkowski, 171, 87, 258, LINK)"
31079,1,7,1,8,"(f6c31f61c5c2309701a14597913e32a88193225d, 2019-12-12 13:44:04 -0800, Iurii Zdebskyi, 7, 1, 8, LINK)"
311,2,27,19,46,"(d47c1362c516b02aa2c590e8ee5d0cf7cb62e1bc, 2017-04-19 11:49:59 -0700, Aaron Markham, 15, 15, 30, LINK), (20fffc8bb7fecdd218057745c7076075df2ab034, 2016-12-19 09:27:47 -0500, Sam Gross, 12, 4, 16, LINK)"
31103,1,8,6,14,"(b44c0f328e6145e8961a1dc1f072bbcf12fb4634, 2020-01-03 12:41:05 -0800, Junjie Bai, 8, 6, 14, LINK)"
31108,3,174,13,187,"(bf53784e3cebbf5c79c987c0e30a4bfb0af96451, 2020-04-29 01:50:36 -0700, peter, 20, 3, 23, LINK), (21c2481dfe8165883939faab5943671dfa93c468, 2020-01-09 05:30:07 +0800, peterjc123, 77, 5, 82, LINK), (7a3ed36309f48cb833f1690991c7b0f59da6ce11, 2019-12-31 10:50:17 -0800, peterjc123, 77, 5, 82, LINK)"
3111,1,114,64,178,"(e970d350914833aed4847520cba84123eb0c149c, 2017-10-19 17:22:01 -0400, Sam Gross, 114, 64, 178, LINK)"
31112,1,11,10,21,"(fe76af96eddbf62df0d2722220b907e56e3ee8e6, 2019-12-22 17:59:50 -0800, Rohan Varma, 11, 10, 21, LINK)"
31132,1,2,2,4,"(851a7e861be120c74787ef533ebf7a20e1e0b2c2, 2020-01-15 19:37:15 -0800, h6197627, 2, 2, 4, LINK)"
31181,1,65,27,92,"(b77c25dec056bf08b857f66b42ec6d2b21e547ff, 2020-01-22 08:32:01 -0800, peter, 65, 27, 92, LINK)"
31184,2,20,8,28,"(0541546ac59877c3d254616155a8bf9a73d38913, 2019-12-19 19:09:28 -0500, Vishwak Srinivasan, 10, 4, 14, LINK), (455e85a2f181a66e7505d0e7eeb0ad0825bc4a41, 2019-12-16 12:32:30 -0800, vishwakftw, 10, 4, 14, LINK)"
31198,1,11,1,12,"(ec92711aac5537bb509535c74bf59ccbf4d72db2, 2019-12-14 22:49:24 -0800, Rohan Varma, 11, 1, 12, LINK)"
31268,1,31,6,37,"(1f34801460661201782cebc61deff2b38c5ab32e, 2020-01-13 11:10:09 -0800, Jerry Zhang, 31, 6, 37, LINK)"
31283,1,4,2,6,"(e509c58a1ce9eea27750bed42f7b12b922277179, 2020-06-23 07:08:44 -0700, Nikita Shulga, 4, 2, 6, LINK)"
31295,1,2,1,3,"(49fe7a74014cd2aa803df14d547d0899c5582051, 2019-12-19 12:26:16 -0800, anjali411, 2, 1, 3, LINK)"
31325,1,209,40,249,"(4e07c3567960d5e1917e2e7ecea7b1b6ca4fe915, 2020-03-12 10:09:38 -0700, Shihao Xu, 209, 40, 249, LINK)"
31336,1,166,170,336,"(e4a883e60104d95d9c364efa4ac49bd241894d75, 2020-03-05 16:58:41 -0800, Xiang Gao, 166, 170, 336, LINK)"
31412,1,5,4,9,"(54777b1e736becb12ded6dcf34d9f01d32b4f896, 2020-01-08 11:48:21 -0800, Peter Bell, 5, 4, 9, LINK)"
31413,1,82,46,128,"(c342c354a959728029c544b9d13aea1528367d15, 2020-01-22 08:02:25 -0800, Yanli Zhao, 82, 46, 128, LINK)"
31427,1,151,149,300,"(1487582ba7f046e496554d40301e31b4ebc22422, 2020-01-14 09:35:57 -0800, Xiang Gao, 151, 149, 300, LINK)"
31443,1,24,0,24,"(b38901aa15aa8561140098f626dd755f94f4f456, 2019-12-20 08:19:49 -0800, Gregory Chanan, 24, 0, 24, LINK)"
31459,1,11,1,12,"(ddff014b79303e5239d5cb876ba97143cad6405a, 2020-01-06 10:25:28 -0800, anjali411, 11, 1, 12, LINK)"
31468,3,306,3,309,"(87b6685c6b290323629ae04fd962985421743661, 2020-03-19 20:46:41 -0700, Zafar Takhirov, 102, 1, 103, LINK), (463f7920bd45b522b4675663656873fa9689cab0, 2020-03-19 20:46:41 -0700, Zafar Takhirov, 102, 1, 103, LINK), (d46bbbb9eef50e2d8a0db47c3ad5fdfb4b2545e7, 2020-03-16 11:20:12 -0700, Zafar Takhirov, 102, 1, 103, LINK)"
31472,1,162,73,235,"(9af5a97b1df9d3b3708a8e10ff5d9e6d83ce4b02, 2020-01-23 11:44:06 -0800, Pavel Belevich, 162, 73, 235, LINK)"
315,1,19,0,19,"(3cb2470bb33305921b92ae4417d1364a5177a44e, 2018-10-30 12:54:37 -0700, Wei Yang, 19, 0, 19, LINK)"
31515,1,24,1,25,"(0b9cd410a96d173e09e0b8661233d3c853907adf, 2020-01-03 10:14:16 -0800, leetanenbaum, 24, 1, 25, LINK)"
31549,1,4,8,12,"(f995ec207604ac7b8b22c16acd924a14a9035db9, 2020-01-10 11:02:52 -0800, Jerry Zhang, 4, 8, 12, LINK)"
31611,1,10,0,10,"(9e6cd98c3ff5f521fe8130ce0f1a71fca0d61296, 2020-03-12 12:07:34 -0700, peterjc123, 10, 0, 10, LINK)"
31620,1,56,0,56,"(3c07eb33bb5be9ffaac310031c2b4725c7ddc882, 2020-01-07 16:19:01 -0800, davidriazati, 56, 0, 56, LINK)"
31625,1,91,82,173,"(230b68168b6ab5e6496a8425bceef1dbe576d45d, 2020-04-23 10:19:55 -0700, Jerry Zhang, 91, 82, 173, LINK)"
3164,1,510,14,524,"(71626491c40c86eb1ee410e695c467486084144c, 2018-05-08 17:06:27 -0400, Richard Zou, 510, 14, 524, LINK)"
31650,1,6,4,10,"(ad4fba0ce49340397744a638f0416dd709edb3e4, 2020-01-23 14:46:14 -0800, Xiang Gao, 6, 4, 10, LINK)"
31672,1,32,6,38,"(ee87b01f4093208d527fc0bd740723c2fa4f1feb, 2019-12-29 23:02:16 -0800, Natalia Gimelshein, 32, 6, 38, LINK)"
31680,1,2,2,4,"(1ba1799a66b20f17657a132eab111d002b3356f3, 2020-01-06 01:44:35 -0800, meganset, 2, 2, 4, LINK)"
31715,1,27,4,31,"(1314f7f4f486e2457b1660e9c89da3cb0c4b5fe4, 2020-01-08 14:15:04 -0800, Alban Desmaison, 27, 4, 31, LINK)"
31734,1,12,1,13,"(e37a24b0446e80d01b52cb04a2e7fde6976a16d4, 2020-01-22 08:01:46 -0800, Peter Bell, 12, 1, 13, LINK)"
31753,1,35,9,44,"(b10761d8900af1dc48bee807ab39c80fd4334b79, 2020-02-27 06:56:28 -0800, JeongUkJae, 35, 9, 44, LINK)"
31768,3,83,1,84,"(efba6302876ef1156c84a0cb1ace24a1df8cecce, 2020-02-10 07:02:09 -0800, Peter Bell, 37, 0, 37, LINK), (46c3c18bcc12e7d2d368fdb8606b509f130554f1, 2020-02-05 20:22:56 -0800, Peter Bell, 37, 0, 37, LINK), (7fdc6cb74efb0610daaf9c724daa8e4b52cd52fa, 2020-01-21 15:07:36 -0800, Peter Bell, 9, 1, 10, LINK)"
31774,1,20,15,35,"(40e720282cab50d88c79ba1b5df69c7e46bcd77c, 2020-01-03 13:38:27 -0800, Jerry Zhang, 20, 15, 35, LINK)"
31804,1,10,9,19,"(457c57d9f7287c1d7ed97e477499119bc1777749, 2020-01-03 13:19:37 -0800, Rohan Varma, 10, 9, 19, LINK)"
31864,1,173,60,233,"(2f6ffe8c393c29cb22560c2b9c23388115794194, 2020-02-28 18:32:20 -0800, davidriazati, 173, 60, 233, LINK)"
31894,1,10,0,10,"(52e9953faffe45d48660fc666db3b520b918c37c, 2020-05-15 08:30:47 -0700, Xinyu Li, 10, 0, 10, LINK)"
31902,1,34,3,37,"(10bd21d5502ec983ec4e5b9c7810d4e5b3cf0d4b, 2020-01-31 16:53:25 -0800, Elias Ellison, 34, 3, 37, LINK)"
31906,1,1,0,1,"(67c1d930eb51626d282e93818200977acc6945a9, 2020-01-09 13:25:01 -0800, Edward Yang, 1, 0, 1, LINK)"
31915,1,13,1,14,"(d03c9aaa05dc62efa0c0efc77c7483114af5c6cf, 2020-01-31 16:38:59 -0800, Charles Hofer, 13, 1, 14, LINK)"
3192,2,2,0,2,"(db1292a5098e640d26489481703b50f5ae5259c0, 2017-10-20 10:49:07 -0400, Edward Z. Yang, 1, 0, 1, LINK), (95605400841cdd6a244d0c2a01a75f5062155ae6, 2017-10-20 10:49:07 -0400, Edward Z. Yang, 1, 0, 1, LINK)"
31926,1,10,4,14,"(b6f43afacaff516a8e1681afac367bb4cb15aa62, 2020-01-10 07:40:26 -0800, Tongzhou Wang, 10, 4, 14, LINK)"
31944,1,13,3,16,"(1b746b95fb6f3df45bd2883045de9fbd82b72100, 2020-02-05 15:32:37 -0800, Edgar Andrés Margffoy Tuay, 13, 3, 16, LINK)"
31950,1,173,60,233,"(2f6ffe8c393c29cb22560c2b9c23388115794194, 2020-02-28 18:32:20 -0800, davidriazati, 173, 60, 233, LINK)"
31985,1,196,2,198,"(1558a3657b669001befd3271e2718f7d2c71e614, 2020-10-05 16:25:33 -0700, Nikita Shulga, 196, 2, 198, LINK)"
31991,1,57,15,72,"(3bbb36e02d6a34c8dd5ac4abf7455d869c7800dc, 2020-01-25 20:21:37 -0800, Enealor, 57, 15, 72, LINK)"
32001,1,30,0,30,"(7cddc302e5742ee458010bbd0a10ff3d39b5ae9c, 2020-02-03 10:11:31 -0800, Wojciech Baranowski, 30, 0, 30, LINK)"
32002,1,4,6,10,"(638e4ad8b95793876c0f5e82db58c18618fb6e61, 2020-01-10 13:11:45 -0800, anjali411, 4, 6, 10, LINK)"
32006,1,25,8,33,"(a8e7ed48f469e561d89f724fcbf290eeb3967eb5, 2020-02-26 09:52:59 -0800, Daya Khudia, 25, 8, 33, LINK)"
32032,2,2,2,4,"(49364eb42684416b0dc94e4ce1a3ccd002e8203f, 2020-01-14 10:02:37 -0500, Vishwak Srinivasan, 1, 1, 2, LINK), (77c2c78e01d55f111e9d8e6114256e225c853269, 2020-01-13 07:17:38 -0800, vishwakftw, 1, 1, 2, LINK)"
32045,1,48,0,48,"(02aa3ba3312c273472084f782f06f79109185f33, 2020-01-23 08:51:32 -0800, albanD, 48, 0, 48, LINK)"
32058,1,15,13,28,"(19bbb4fccb15fdd120ff00697887331f5a2394ef, 2020-01-15 07:46:45 -0800, Richard Zou, 15, 13, 28, LINK)"
32082,1,2,2,4,"(8c1268aad3656b20f97b98278481fab3f93a82b8, 2020-01-17 11:02:18 -0800, Jerry Zhang, 2, 2, 4, LINK)"
32119,1,690,55,745,"(4025729e888ea33241b3f795044fd24381cf91d1, 2020-03-20 16:44:08 -0700, Omkar Salpekar, 690, 55, 745, LINK)"
32124,2,585,11,596,"(507f963aa66ca2971c94a614705b4328534dc615, 2020-02-19 15:57:23 -0800, Omkar Salpekar, 292, 4, 296, LINK), (92b67c03e45048b37961db1a00975f85c2da5e9b, 2020-02-14 11:45:02 -0800, Omkar Salpekar, 293, 7, 300, LINK)"
32136,1,2,2,4,"(9357b911800b891f09e9d8e02b74018514c9b77f, 2020-01-29 14:10:20 -0800, Pavel Belevich, 2, 2, 4, LINK)"
32139,1,27,3,30,"(f3b67bf75021d1597cd1a55620d3403b4b7e2631, 2020-01-14 14:51:33 -0800, davidriazati, 27, 3, 30, LINK)"
32234,1,89,76,165,"(b564eaf7a803ae7019ca0523d4ba8c060c30b0cb, 2020-02-01 14:58:23 -0800, Will Feng, 89, 76, 165, LINK)"
3225,1,6,44,50,"(9ea576d06839b7c888865921c2bd66db1fbc3648, 2017-12-07 16:37:17 -0500, Sam Gross, 6, 44, 50, LINK)"
32289,1,9,0,9,"(84101f353e3fdf9eaa6584e8b4e1b3fc7945638e, 2020-02-26 21:12:42 -0800, Nathan Goldbaum, 9, 0, 9, LINK)"
3234,1,59,23,82,"(cc5a948e62e843453938e77cf2724e3be9f2d0b3, 2017-10-24 13:13:38 -0400, Edward Z. Yang, 59, 23, 82, LINK)"
32345,1,563,0,563,"(945d7a7408891e25bc54a65015724f6d2de644e6, 2020-04-01 08:54:43 -0700, Dhiraj D Kalamkar, 563, 0, 563, LINK)"
32346,2,40,18,58,"(e8581869f2ddbdf0149bd8382adeebb95ea4aec5, 2020-02-05 11:51:50 -0800, Natalia Gimelshein, 20, 9, 29, LINK), (df71b3e23a9d02fd2c402bb01e93cf151bface45, 2020-02-03 18:11:29 -0800, Natalia Gimelshein, 20, 9, 29, LINK)"
32366,3,464,92,556,"(3c5677a6760ba8df633987263b387e2a5a881c23, 2020-02-28 14:40:52 -0800, Sebastian Messmer, 417, 90, 507, LINK), (f07e963ec9285d2818f78821c80b63ee33eb15e9, 2020-02-27 14:57:18 -0800, Sebastian Messmer, 1, 1, 2, LINK), (e727520fc03e3f4f71c757186891a389bda37c41, 2020-02-26 19:34:44 -0800, Sebastian Messmer, 46, 1, 47, LINK)"
32368,1,8,1,9,"(e7edc5f20e89257d0cdaafff70447b5885ad8b72, 2020-01-24 16:47:05 -0800, Jerry Zhang, 8, 1, 9, LINK)"
3241,1,97,63,160,"(3003ebe67ae03922312e796990eac6a00a9d1633, 2017-11-02 17:23:25 -0400, Sam Gross, 97, 63, 160, LINK)"
32414,1,15,2,17,"(739d4609c3bbe3f461052d4586a2fa8cf8e0f7ee, 2020-03-09 08:12:54 -0700, Will Feng, 15, 2, 17, LINK)"
32435,5,264,251,515,"(3b47922855d94c7727a22d924d2a6b447475ee06, 2020-01-29 13:16:37 -0800, Edward Yang, 95, 88, 183, LINK), (b719d8f6b0da2fea26aa229b507ffbb8b317a318, 2020-01-28 07:33:15 -0800, Edward Z. Yang, 1, 1, 2, LINK), (37835acb1ab4179a131e5e12d9ff6bf08f9eb132, 2020-01-28 07:23:58 -0800, Edward Z. Yang, 8, 8, 16, LINK), (dc5504ed4f24db1437d5f865cb6756c926849f82, 2020-01-23 07:25:35 -0800, Edward Z. Yang, 80, 77, 157, LINK), (6e1148598596c7d164e43182490f64b16cc0623e, 2020-01-23 07:25:28 -0800, Edward Z. Yang, 80, 77, 157, LINK)"
32436,1,198,161,359,"(389e16c33be6d62b08490c0ab1e0e88883db28d3, 2020-05-24 13:11:43 -0700, Brian, 198, 161, 359, LINK)"
32454,1,420,567,987,"(a0ba7fb43e85606830277d5bc6076e5e799286fe, 2020-06-26 08:59:33 -0700, Edward Yang, 420, 567, 987, LINK)"
32469,1,26,1,27,"(ef5637f85e43dff55b03276176ba2949bd83a085, 2020-01-24 11:49:56 -0800, Michael Suo, 26, 1, 27, LINK)"
32494,1,8,5,13,"(8bc889e502b45627abb4665f746f03e99cc065e0, 2020-01-29 08:47:38 -0800, Max Balandat, 8, 5, 13, LINK)"
32517,5,13,8,21,"(950b7d8634b03cad0a5a2097df762e31e17ba082, 2020-02-20 23:09:04 -0800, Rohan Varma, 2, 0, 2, LINK), (6e7b82aa4d58f2d914b2db5cac9d23cce44a7819, 2020-02-05 16:08:14 -0800, Rohan Varma, 0, 0, 0, LINK), (922db08ec7df30799e0b7cf1f2bd1053f90ce28b, 2020-02-05 15:59:45 -0800, Rohan Varma, 3, 1, 4, LINK), (15f3f8cdd23e30fca03e0267fc605fca994aaad1, 2020-02-05 15:39:26 -0800, Rohan Varma, 7, 6, 13, LINK), (6fce26f6cfdd1fde5b8ec955f5ffd1ebd035adc2, 2020-02-05 15:27:28 -0800, Rohan Varma, 1, 1, 2, LINK)"
32519,1,232,0,232,"(6fa76b8a0c5b1b3fd60fe70b68f9d47295436e74, 2020-04-28 18:44:29 -0700, Jerry Zhang, 232, 0, 232, LINK)"
32520,1,208,61,269,"(35cdb785228b8abea1d3bdb844aa5980e6642f8d, 2020-04-01 12:18:30 -0700, Nik Ved, 208, 61, 269, LINK)"
32605,2,130,66,196,"(11843049d5d580f45e9f92a77aa2926384d64ee1, 2020-03-02 13:48:06 -0800, davidriazati, 65, 33, 98, LINK), (2b9fa4a756dfef5ae442e6e7a76293c4b7a2d9fe, 2020-02-26 18:47:32 -0800, davidriazati, 65, 33, 98, LINK)"
32625,1,34,7,41,"(f5ee46f1cfea4bbdd9fbe00a1f50b4385c5e4faa, 2020-03-10 07:51:46 -0700, Richard Zou, 34, 7, 41, LINK)"
32639,1,18,1,19,"(e7f0b15473d4dea3e202c98ccafe0d054cb0a204, 2020-02-11 09:25:49 -0800, Vincent Quenneville-Belair, 18, 1, 19, LINK)"
3264,2,72,70,142,"(3d9630abc23a56a1ad60f42574040e71281ea423, 2017-11-06 17:11:44 -0500, Sam Gross, 36, 35, 71, LINK), (50a63ee6fd826669fe47c24585064718b5161e1f, 2017-11-06 17:11:44 -0500, Sam Gross, 36, 35, 71, LINK)"
32645,1,2,2,4,"(879cf0b15a54c7848ae710e3d0ec62c4a9d7d3dd, 2020-02-18 09:08:10 -0800, Jeong Ukjae, 2, 2, 4, LINK)"
3266,1,6,1,7,"(e43a63a968083aeff957c04c7d8c9ffa794a446d, 2017-10-25 13:17:54 +0200, Ozan Çağlayan, 6, 1, 7, LINK)"
32692,1,4,3,7,"(c7bf4d22fe7f0de239feeb084682827c3b9a759f, 2020-01-29 08:24:42 -0800, Seyyed Hossein Hasanpour, 4, 3, 7, LINK)"
32699,1,8,0,8,"(7773a45c0d2cba1cd53d7f50b00baa7ae95ec6e4, 2020-06-01 07:46:26 -0700, guol-fnst, 8, 0, 8, LINK)"
327,1,9,0,9,"(8e4161517e112478a1c1f0290fedb91965f95aff, 2020-01-27 21:37:49 -0800, Wojciech Baranowski, 9, 0, 9, LINK)"
32750,1,20,2,22,"(7b65acdf9e8345d2ffbbc3b85ae6667f7260407e, 2020-01-31 14:21:00 -0800, Kushashwa Ravi Shrimali, 20, 2, 22, LINK)"
32756,1,6,0,6,"(cdf381c967c7c93aa60941b0d35c33e1f8ec3121, 2020-02-20 11:07:00 -0800, Edgar Andrés Margffoy Tuay, 6, 0, 6, LINK)"
3277,2,4,1,5,"(99907f2eb0d12e626d1a82d9a76671d9e6e9c7e8, 2017-11-07 11:12:41 -0600, avmgithub, 3, 0, 3, LINK), (68116d7f8447ae1650c762c11a40aa81ef507f86, 2017-11-06 17:51:02 -0600, avmgithub, 1, 1, 2, LINK)"
32824,1,35,9,44,"(b10761d8900af1dc48bee807ab39c80fd4334b79, 2020-02-27 06:56:28 -0800, JeongUkJae, 35, 9, 44, LINK)"
32835,1,47,16,63,"(877ab3afe33eeaa797296d2794317b59e5ac90f4, 2020-02-27 16:04:36 -0800, Vitaly Fedyunin, 47, 16, 63, LINK)"
32863,2,176,57,233,"(c882425c2449a4fb67a74375abddc1456fdc84b9, 2020-02-20 15:16:33 -0800, Peter Bell, 80, 42, 122, LINK), (495bd5818bc094d4b94b309ded614f666c9ca849, 2020-02-15 17:22:52 -0800, Peter Bell, 96, 15, 111, LINK)"
32866,2,261,139,400,"(7417b4c66f5b0901f206bf48b64de07384770724, 2020-06-03 06:40:02 -0700, Peter Bell, 134, 70, 204, LINK), (5702a28b2612a104204dd31e800faaaa09bdd458, 2020-05-28 07:26:19 -0700, Peter Bell, 127, 69, 196, LINK)"
32898,1,18,1,19,"(e7f0b15473d4dea3e202c98ccafe0d054cb0a204, 2020-02-11 09:25:49 -0800, Vincent Quenneville-Belair, 18, 1, 19, LINK)"
32946,1,83,3,86,"(d141465713c3c8fcb5a4313361daa6dd3f671e29, 2020-02-04 19:04:26 -0800, Pavel Belevich, 83, 3, 86, LINK)"
32949,1,1,3,4,"(ad90c97c0ac455546b2b6353a22caa25dcf0574d, 2020-02-11 12:19:06 -0800, Mike Ruberry, 1, 3, 4, LINK)"
32973,1,175,29,204,"(ee28831341c0398b0e2a0791ffd77263217f0bff, 2020-02-21 08:40:10 -0800, davidriazati, 175, 29, 204, LINK)"
32983,1,12,1,13,"(0f358fab6b92307edba4d89a855cac395f5b1565, 2020-08-04 22:58:01 -0700, Michael Carilli, 12, 1, 13, LINK)"
33001,1,1,1,2,"(60339a38eded68eeef91f84734b4d665ddf4e080, 2020-02-19 09:53:45 -0800, matham, 1, 1, 2, LINK)"
33012,1,26,26,52,"(4299faa10bf45117c8def2971faa0c3c5d030e04, 2019-09-09 06:32:49 -0700, Ralf Gommers, 26, 26, 52, REGEX)"
33016,1,254,488,742,"(5fc5cf6571f3e33bc5061b3e139a313433ee5ca1, 2020-03-11 07:15:03 -0700, Peter Bell, 254, 488, 742, LINK)"
3307,3,36,0,36,"(345844d9d83e40a866647df1ce003d1a62aa31e7, 2021-01-26 16:17:40 -0800, mattip, 18, 0, 18, LINK), (60d601f1ec40692a819e24682184b589fdb70d18, 2020-02-27 09:57:07 -0800, Edward Z. Yang, 9, 0, 9, LINK), (619d8ea9203e7ae5167c03761db7689d39fd1455, 2020-02-27 09:57:00 -0800, Edward Z. Yang, 9, 0, 9, LINK)"
33072,1,690,55,745,"(4025729e888ea33241b3f795044fd24381cf91d1, 2020-03-20 16:44:08 -0700, Omkar Salpekar, 690, 55, 745, LINK)"
33091,1,30,2,32,"(28c5213a97eddc9d742a0ba1087981a8d6010654, 2020-02-18 06:43:25 -0800, Richard Zou, 30, 2, 32, LINK)"
33106,1,39,28,67,"(b1790794f67f094e73a28174898d4714dfa96a52, 2020-05-01 12:50:26 -0700, Pavel Belevich, 39, 28, 67, LINK)"
33128,1,0,9,9,"(2c1a302d6a7ce250fdbd8f37630a22eefffd4a3f, 2020-03-09 16:20:51 -0700, Johannes M Dieterich, 0, 9, 9, LINK)"
3313,1,843,345,1188,"(fde355f7d4ad95a1f8cba6adc3fff7b4935ecba0, 2017-11-06 18:19:56 -0500, Sam Gross, 843, 345, 1188, LINK)"
33138,1,305,106,411,"(bba30d1bd82492cd8b22c34775e27bf3b3d983c9, 2020-06-08 14:09:40 -0700, Kurt Mohler, 305, 106, 411, LINK)"
33140,1,4,0,4,"(c49de6ce0d0fb86ecc6d33b01dbd7efed5d434f8, 2020-04-13 17:40:58 -0700, Tzu-Wei Huang, 4, 0, 4, LINK)"
33143,1,19,3,22,"(2b45368e506e7cdf37ff7af413ff01a8f69229d2, 2020-03-09 12:27:51 -0700, Xiang Gao, 19, 3, 22, LINK)"
33192,1,23,11,34,"(b8fd88319a3cc31f211601b92441c15c13b1048c, 2020-03-06 05:44:19 -0800, meganset, 23, 11, 34, LINK)"
33195,1,48,1,49,"(feaa622fc658dd76bbc26fecaf614d4056bbac23, 2020-02-18 17:33:59 -0800, Xingdong Zuo, 48, 1, 49, LINK)"
33197,1,210,40,250,"(7848c229b87e28899030f076ae3521dc041b1201, 2020-03-15 16:06:49 -0700, xiaobingsuper, 210, 40, 250, LINK)"
33203,1,5,5,10,"(ab14375b08d66452807bc8c2f1c6d8a03ef75704, 2020-02-12 14:21:11 -0800, root, 5, 5, 10, LINK)"
33209,1,28,28,56,"(ff7d147732806b2e484007ce3b1fe755bfbc77f2, 2020-02-13 08:45:57 -0800, Guanheng Zhang, 28, 28, 56, LINK)"
33210,1,130,1,131,"(924717bf5197e075ec6b586c9c4117f5a4fc272b, 2020-09-16 11:52:24 -0700, Shen Li, 130, 1, 131, LINK)"
33229,1,23,1,24,"(be3bc1deb1a53315f34242c468659e2ad8751e61, 2020-03-10 15:39:24 -0700, Vincent Quenneville-Belair, 23, 1, 24, LINK)"
33240,1,8,7,15,"(e9e9331927f2200193c05df25ca6a7ea202b629e, 2020-02-14 12:29:50 -0800, meganset, 8, 7, 15, LINK)"
33270,2,7,10,17,"(ffe327f7d9c0bf3f6d2fc64fd4dfb8b2c2013be8, 2020-02-20 09:06:26 -0800, peter, 6, 10, 16, LINK), (5b922918d023126ad1f468c68577c9b599ad202d, 2020-02-13 13:08:16 -0800, Will Feng, 1, 0, 1, LINK)"
33290,1,13,0,13,"(e41fe6086745387b3e1aa1ae6e05fe6037a06a57, 2020-06-08 07:42:41 -0700, William Gan, 13, 0, 13, LINK)"
33300,1,17,7,24,"(8291e06f8fb14a09e6c3b7a740a182250069242c, 2020-02-21 22:21:06 -0800, Mike Ruberry, 17, 7, 24, LINK)"
33309,1,42,25,67,"(3f5bb2bade88344105784d3960dfa2a53d08462f, 2020-09-16 15:29:30 -0700, Jerry Zhang, 42, 25, 67, LINK)"
33345,1,24,9,33,"(a500491cbc51c093b5990a69c6066479c13e360c, 2020-03-01 21:48:40 -0800, Xiao Wang, 24, 9, 33, LINK)"
33381,1,58,14,72,"(4543cf4eb16611ab8847064e3b826f756e810c51, 2020-02-26 18:28:47 -0800, Elias Ellison, 58, 14, 72, LINK)"
33394,1,503,176,679,"(e18a2219dd34f2c532f6218a78ed081ef090909e, 2020-09-16 23:21:38 -0700, Sameer Deshmukh, 503, 176, 679, LINK)"
33401,1,13,135,148,"(4c8064c9e14d7118296b5c378d80fde63a62aeb7, 2020-02-18 11:00:54 -0800, peter, 13, 135, 148, LINK)"
33422,1,16,1,17,"(1a2574734222193c344dffb7904def10db18b874, 2020-02-20 12:12:11 -0800, vishwakftw, 16, 1, 17, LINK)"
33439,1,134,11,145,"(fcadca1bdab62ea5728e49397e023c8863466e83, 2020-06-30 22:29:22 -0700, Wojciech Baranowski, 134, 11, 145, LINK)"
33467,1,9,3,12,"(8e8a37d7464638efef2bc0c372712b57e4b4f678, 2020-03-13 09:22:28 -0700, Andrew Delong, 9, 3, 12, LINK)"
33485,1,17,0,17,"(e021c13d2d06de2e260b246c9a002a7b178b1833, 2020-03-30 15:50:27 -0700, Xiao Wang, 17, 0, 17, LINK)"
33490,1,14,0,14,"(32c93099c470dbb4c87c341def85a91b4bf85079, 2020-02-24 11:27:43 -0800, Peter Bell, 14, 0, 14, LINK)"
33494,1,12,2,14,"(fdf7a833e75d30a9d510c2d65376e5a3726411d6, 2020-04-09 08:48:55 -0700, Donna Choi, 12, 2, 14, LINK)"
33500,3,131,102,233,"(903ad90325507bb8856cfa932dd8d43e35b03fbd, 2020-03-10 16:02:30 -0700, Meghan Lele, 45, 34, 79, LINK), (9ce833879ffe5ca84dabfd8460d284bfcb0b3727, 2020-03-05 12:39:41 -0800, Meghan Lele, 45, 34, 79, LINK), (390d4d6df3c637456dbbf83de3523bb9912cba85, 2020-02-27 12:29:00 -0800, Meghan Lele, 41, 34, 75, LINK)"
33545,1,4,3,7,"(a8fc3d8c2a032a449398df814ee753b5b90853f1, 2020-03-03 13:00:01 -0800, Dmytro Dzhulgakov, 4, 3, 7, LINK)"
33546,1,59,3,62,"(5edd9aa95a8a73e940185f8448e7db05394ce6fe, 2020-08-11 18:01:08 -0700, Kurt Mohler, 59, 3, 62, LINK)"
33547,1,10,2,12,"(a341a4329a0dd625d890212d72bbd62d3840ba0a, 2020-11-03 07:34:43 -0800, Erjia Guan, 10, 2, 12, LINK)"
33552,1,9,9,18,"(cd9d9a2235567eb76743a5d863e0f2d4074d8956, 2020-03-10 10:28:40 -0700, Natalia Gimelshein, 9, 9, 18, LINK)"
33562,1,4,4,8,"(c7dd5f89a2367ba9e434a8c6e8e8e5fa0da8d9fb, 2020-03-10 08:50:28 -0700, Andrew Delong, 4, 4, 8, LINK)"
33568,1,32,2,34,"(0c9bf6498982522564434c2cdf2b5c6c693d9995, 2020-04-11 22:22:04 -0700, Mike Ruberry, 32, 2, 34, LINK)"
33580,1,21,20,41,"(90f4c5695e1785883d9ae7c86ad3fabd1963a4cb, 2020-02-21 08:30:06 -0800, Edward Yang, 21, 20, 41, LINK)"
33618,1,66,2,68,"(d37a4861b8a5eed3d9a1340484d1efb0f48aa59e, 2020-04-29 08:59:09 -0700, Michela Paganini, 66, 2, 68, LINK)"
33620,1,23,3,26,"(973371139475834c44d118ba0256d97b070980a0, 2020-02-26 22:22:52 -0800, Shihao Xu, 23, 3, 26, LINK)"
33629,1,20,21,41,"(7aa605ed92dbb726a2f285246369b0a17972ba12, 2020-02-23 14:08:44 -0800, Enealor, 20, 21, 41, LINK)"
33630,1,124,117,241,"(09046713cc02fbfb87705fb74183870320a639de, 2020-02-28 08:21:24 -0800, anjali411, 124, 117, 241, LINK)"
33694,1,1,1,2,"(533b973fd0bc7bfb34ecd0869e91463a65f160fe, 2020-02-24 13:48:34 -0800, Will Feng, 1, 1, 2, LINK)"
33698,1,5,5,10,"(fd175fa8a235569bda75718e3f9573e28d889f12, 2020-02-25 08:43:26 -0800, Jeong Ukjae, 5, 5, 10, LINK)"
33699,1,2,1,3,"(819ca2c285d058fc5786d52d02dfc5f73433ae99, 2020-02-25 08:48:01 -0800, Jeong Ukjae, 2, 1, 3, LINK)"
33701,1,17,1,18,"(0048243f70f37a3ae74725fb21c88704d3ab62bb, 2020-04-27 10:46:07 -0700, Lukas Koestler, 17, 1, 18, LINK)"
33751,1,50,112,162,"(2f84a07b58ff033cdf47afe8ff17bba80214c7b4, 2020-03-31 20:49:43 -0700, Wojciech Baranowski, 50, 112, 162, LINK)"
33757,1,1,1,2,"(b1bd950a4d3a06b4e105cb77238fb7df01fad4da, 2020-03-09 08:43:07 -0700, prajjwal1, 1, 1, 2, LINK)"
3376,1,17,0,17,"(cd3e067e4654daa0edb5f4c9db99ffce3b38c64b, 2018-07-12 19:24:10 -0700, Vishwak Srinivasan, 17, 0, 17, LINK)"
33780,2,195,54,249,"(c73e97033a3aef97a5685588ea014d54a5cc11cc, 2020-03-25 09:09:24 -0700, anjali411, 104, 27, 131, LINK), (c8f665dcb626378ca9c51d7b70fc242524105441, 2020-03-18 23:29:55 -0700, anjali411, 91, 27, 118, LINK)"
33793,1,3,57,60,"(e255a4e1fdb4cbd0e3a79c9ecfc95b7aabfb1fd8, 2020-09-18 15:52:32 -0700, Gao Xiang, 3, 57, 60, LINK)"
33812,1,15,3,18,"(2af64ba3ede8906c4b48e1d0988665520ad03c9d, 2020-03-05 15:54:00 -0800, Peter Bell, 15, 3, 18, LINK)"
33821,4,674,406,1080,"(ba1bd4176722f831a548dd69e34951189bc440e1, 2020-03-03 14:33:40 -0800, Edward Yang, 195, 114, 309, LINK), (6273ec11d9d68ba4b63675458c9cdc382676c8b4, 2020-02-28 11:59:00 -0800, Edward Z. Yang, 195, 114, 309, LINK), (86a1b588b586d3b303b3f5ad6e6471a214806e52, 2020-02-26 11:37:43 -0800, Edward Z. Yang, 142, 89, 231, LINK), (49c15a93cf299d41eb12f96a8eda3412b50bc615, 2020-02-26 11:36:12 -0800, Edward Z. Yang, 142, 89, 231, LINK)"
33828,1,999,994,1993,"(dbe850af5b941c6f0ae1ed50e7d6b779db55f5af, 2020-02-27 12:18:24 -0800, Michael Suo, 999, 994, 1993, LINK)"
33830,1,94,3,97,"(e236e1593468a68e47c5bcafd7272eca01684294, 2020-03-04 13:58:44 -0800, Supriya Rao, 94, 3, 97, LINK)"
33870,1,37,15,52,"(95465dcbaf79d55d854981ad93c4b2ff8df4a9a9, 2020-05-01 13:53:49 -0700, Wojciech Baranowski, 37, 15, 52, LINK)"
33899,1,33,19,52,"(4b3ae7e0af17cfaab832fd7954f5bfad07cee0ba, 2020-03-02 13:18:45 -0800, Peter Bell, 33, 19, 52, LINK)"
33912,2,211,19,230,"(ea273c68f99251dae0f5f08d704cd62f0e454416, 2020-07-02 10:22:45 -0700, Jerry Zhang, 126, 18, 144, LINK), (5fce7137a953ef1afcc906c05227d4f98c7be072, 2020-06-23 14:40:24 -0700, Meghan Lele, 85, 1, 86, LINK)"
33913,1,19,3,22,"(2de4fa702b8b44f3bd9fcdc5de657ac5b5ae7467, 2020-03-09 19:20:45 -0700, James Reed, 19, 3, 22, LINK)"
33928,1,34,35,69,"(e33c3e49d5549831c14b292b1383a3d192f826ab, 2020-04-27 14:17:31 -0700, Jacob Zhong, 34, 35, 69, LINK)"
33934,1,36,1,37,"(79054495d37a304b98aeef5f23e5b679bc64d419, 2020-03-26 07:34:35 -0700, mpariente, 36, 1, 37, LINK)"
33941,1,33,0,33,"(a92f1dc85e73b4017a50775235e2e0abbb35eced, 2020-04-21 16:16:29 -0700, Wojciech Baranowski, 33, 0, 33, LINK)"
33950,2,1066,817,1883,"(f9eb8824f1e1cd0d73275afaeb5c81fc4b3f0de1, 2020-05-21 15:21:23 -0700, Kurt Mohler, 284, 228, 512, LINK), (3706803b60e76e25d328c0ffec808c3b18bd6e8c, 2020-05-05 14:18:43 -0700, Kurt Mohler, 782, 589, 1371, LINK)"
33953,1,31,1,32,"(aedffdf7d8a568656253d370c2e4509596f87441, 2020-03-13 15:10:14 -0700, prajjwal1, 31, 1, 32, LINK)"
33986,1,2,1,3,"(a5b5ea9852fd90dc74e21ac5b331ee076dea8544, 2020-03-20 08:18:44 -0700, Xiao Wang, 2, 1, 3, LINK)"
33988,1,180,153,333,"(40eff454ce5638fbff638a7f4502e29ffb9a2f0d, 2020-03-13 11:17:58 -0700, X Wang, 180, 153, 333, LINK)"
34028,1,8,5,13,"(90400f48fcebb2fdbc808d2ab14d639f1e6bcf33, 2020-05-20 12:38:54 -0700, Peter Bell, 8, 5, 13, LINK)"
34054,1,103,0,103,"(9d389b1dcc8fdab66e2cbf7d5d2e29e2f8c8eff8, 2020-10-14 10:54:29 -0700, shubhambhokare1, 103, 0, 103, LINK)"
34061,2,18,2,20,"(77db93228ba85029bece43e0a130f4154d7577b8, 2020-07-23 10:09:51 -0700, Vishwak Srinivasan, 9, 1, 10, LINK), (fcd6d910450ca119091afbf62099e1fab10fe86e, 2020-07-14 21:19:12 -0700, vishwakftw, 9, 1, 10, LINK)"
34079,1,1,1,2,"(1beb309e03e4d655040d13b9a4fabdcdadbdd5dd, 2020-03-03 15:01:08 -0800, Xiang Gao, 1, 1, 2, LINK)"
34083,1,180,153,333,"(40eff454ce5638fbff638a7f4502e29ffb9a2f0d, 2020-03-13 11:17:58 -0700, X Wang, 180, 153, 333, LINK)"
34084,1,72,10,82,"(d0834c5b643b71f9cdeffa36efdf1daaff5d4c09, 2020-03-10 16:00:18 -0700, Gao Xiang, 72, 10, 82, LINK)"
3412,1,97,63,160,"(3003ebe67ae03922312e796990eac6a00a9d1633, 2017-11-02 17:23:25 -0400, Sam Gross, 97, 63, 160, LINK)"
34191,2,38,6,44,"(b12579da5398ff23b421332e21e18dc619a0b960, 2020-03-25 13:23:05 -0700, Peter Bell, 19, 3, 22, LINK), (40b244ceb4131db926a30e73c636ed7b6da29499, 2020-03-25 13:23:05 -0700, Peter Bell, 19, 3, 22, LINK)"
3420,1,1364,29,1393,"(685224aa14b59d011d0926d615846a60f138e4ba, 2018-07-31 11:02:47 -0700, Thomas Viehmann, 1364, 29, 1393, LINK)"
34202,1,5,0,5,"(ff435a0e6b3a4eb0b94b60ccc995141cd933bf7e, 2020-04-21 01:12:12 -0700, Yuxin Wu, 5, 0, 5, LINK)"
34238,1,676,22,698,"(13013848d58a606da7377affeb416affb65f4a8a, 2020-04-30 11:27:13 -0700, SsnL, 676, 22, 698, LINK)"
34260,2,20,0,20,"(2d403ed8beafef4a764b53b8a25752a47b676bce, 2020-03-25 20:05:18 -0400, mrshenli, 10, 0, 10, LINK), (36e3c005f075075c306dd0d113cb4e4d62de82f5, 2020-03-24 10:16:41 -0700, Shihao Xu, 10, 0, 10, LINK)"
34294,2,443,117,560,"(1e230a5c523a8d47d40c3b899f5a0276f0bfd0c8, 2020-07-17 08:52:27 -0700, Nathan Goldbaum, 227, 59, 286, LINK), (0a1e0fb8edce13cecedf07e3f9de4c938c86d9e9, 2020-07-15 12:55:44 -0700, Nathan Goldbaum, 216, 58, 274, LINK)"
34344,1,8,13,21,"(c258e4732a2f8a6b6992ee5d9283e90c45a60201, 2020-03-15 16:09:54 -0700, xiaobingsuper, 8, 13, 21, LINK)"
34371,1,30,9,39,"(baeb359e7af363ed2654d715abe8c97fe2360c4c, 2020-03-09 10:21:58 -0700, Will Feng, 30, 9, 39, LINK)"
34380,1,23,6,29,"(ada40777c494073d8e0de5abfcb5fd59a66a7db5, 2020-03-26 08:30:39 -0700, KostekIV, 23, 6, 29, LINK)"
34415,1,1,1,2,"(79d47c1c5ff5306bdd275196b7171c04bebbdcca, 2020-03-07 21:40:04 -0800, peter, 1, 1, 2, LINK)"
34489,1,19,8,27,"(2cf344be4c02a7101c82632407e7de50d7d68f76, 2020-03-10 12:49:18 -0700, Terence Feng, 19, 8, 27, LINK)"
34502,1,27,43,70,"(027d7f7ba55ce2617aace11330c5345b0d58b2f0, 2020-03-13 12:23:07 -0700, Hong Xu, 27, 43, 70, LINK)"
34543,1,39,35,74,"(3c76b2aeea2f4701f429e6e6d3860dd761e5269e, 2020-03-12 07:16:02 -0700, Terence Feng, 39, 35, 74, LINK)"
34551,1,23,1,24,"(6f6436ff5d54065ef8e441ff729ec897bf8a3fd0, 2020-03-24 08:22:00 -0700, Peter Bell, 23, 1, 24, LINK)"
34557,1,16,0,16,"(4167db11f76634a75754c0245d79adb18798cec1, 2020-03-10 17:42:25 -0700, Jiakai Liu, 16, 0, 16, LINK)"
34585,1,59,9,68,"(d16c8238e164c6499714de625eb73422382e5ec1, 2020-05-04 18:05:16 -0700, Povilas Kanapickas, 59, 9, 68, LINK)"
34615,1,9,5,14,"(9df9aef9b9d35fd781f2a6f968e6fda4d74b94a3, 2020-04-17 09:09:02 -0700, ashish, 9, 5, 14, LINK)"
34647,1,32,29,61,"(0216c76e1273e9deeb708cc8e6cf7bd7b7ea5fbc, 2020-03-17 15:33:16 -0700, Terence Feng, 32, 29, 61, LINK)"
34648,1,3,3,6,"(02ab6ced8e2016f5668cacd6ed6bf9ea8d9fd61a, 2020-03-23 10:38:31 -0700, Bernie Gray, 3, 3, 6, LINK)"
34658,1,1,0,1,"(c34ee4fb6e94e11c33eb6279c45b318d706bd41a, 2020-03-13 12:45:14 -0700, Elias Ellison, 1, 0, 1, LINK)"
34727,1,197,0,197,"(ae0c88d6aa43bfbbc80024c344d9f805d99305c9, 2020-03-16 17:24:53 -0700, Eli Uriegas, 197, 0, 197, LINK)"
34736,1,19,14,33,"(fa5bc9fa2e995432986aa374f70309298f3abd50, 2020-03-18 08:23:38 -0700, Xiao Wang, 19, 14, 33, LINK)"
34751,1,31,1,32,"(471ddacd8bea2f134e8d9d84e787c1612d9573a2, 2020-03-16 20:12:53 -0700, Ailing Zhang, 31, 1, 32, LINK)"
34797,1,454,69,523,"(caea1adc35404b39fe4f2e3fa75f9a0b9e554bbc, 2020-09-18 01:37:47 -0700, Peter Bell, 454, 69, 523, LINK)"
34800,1,123,13,136,"(0251ba61089795a7a27c0473e4bb022805432c1f, 2020-06-08 20:34:09 -0700, Yael Dekel, 123, 13, 136, LINK)"
34821,2,48,6,54,"(e4332713201750c103359b9bce5b0d87ba9a63c2, 2020-03-19 12:17:43 -0700, peter, 30, 4, 34, LINK), (67cb0184625ca3c30f44e02cc21ebfa7382c75c5, 2020-03-17 09:34:13 -0700, peter, 18, 2, 20, LINK)"
34826,2,27,53,80,"(fe53b52537ba7b37df8ffb937b25e173998389bb, 2020-05-11 08:42:37 -0700, Gregory Chanan, 16, 53, 69, LINK), (84dc8c410a2c7388eb6f78703130c77805fa1f60, 2020-03-24 12:44:39 -0700, Ryad ZENINE, 11, 0, 11, LINK)"
34859,2,569,124,693,"(a347c747df8302acc0007a26f23ecf3355a5bef9, 2021-01-25 16:31:30 -0800, Fritz Obermeyer, 557, 124, 681, LINK), (397cbd3bc030e0a0c3c0d8a6d6df8ef6b0a6aa1b, 2021-01-22 13:44:07 -0500, Fritz Obermeyer, 12, 0, 12, LINK)"
34895,1,18,31,49,"(901bb3c350bae8c9639900e45a517f8284e5c720, 2020-04-08 08:54:26 -0700, Artyom Astafurov, 18, 31, 49, LINK)"
34954,1,1,1,2,"(80b01ba4f3131e7fd08d2b8f741d5fb74fadab08, 2020-04-14 19:16:44 -0700, Tzu-Wei Huang, 1, 1, 2, LINK)"
34960,2,1,1,2,"(bb63710c9aa7a1013114bfdc9f150214a571fb7b, 2020-03-19 19:46:05 -0700, Shen Li, 1, 1, 2, LINK), (be5efa6286da728a1037e1fca0dc8af96d5a9423, 2020-03-19 08:32:53 -0700, Shen Li, 0, 0, 0, LINK)"
34996,1,247,156,403,"(805c417ec94ad13b3d974a6f23d85bf69e9ffdb5, 2020-04-27 10:59:32 -0700, Xiao Wang, 247, 156, 403, LINK)"
35014,3,151,55,206,"(5fc391a6465d1f7197008085bb521b6dfaccc8b3, 2020-04-22 13:27:55 -0700, Emilio Castillo, 61, 55, 116, LINK), (920e3eb7610918dfe167fe9db628ab2729e44892, 2020-03-25 11:29:07 -0700, Zafar Takhirov, 45, 0, 45, LINK), (5959bd6c29c6b9eaa1dc10f60d1825a966891732, 2020-03-25 11:29:07 -0700, Zafar Takhirov, 45, 0, 45, LINK)"
35045,2,48,16,64,"(f7f611c2ecafee2c7e14f6ad73408cdc9d22d68f, 2020-03-19 22:03:52 -0700, Wojciech Baranowski, 24, 8, 32, LINK), (eb78f7ea41ed01f6dd6481740290aef72b4b4d8a, 2020-03-19 22:03:52 -0700, Wojciech Baranowski, 24, 8, 32, LINK)"
35110,2,203,164,367,"(0ecea2d64ddb2cbc5e34e76713492ee16bee7b68, 2020-06-24 01:38:22 -0700, Shihao Xu, 152, 146, 298, LINK), (f3f30d4354698c43d7e1a61e67e330bb68776ae5, 2020-06-18 07:43:50 -0700, Shihao Xu, 51, 18, 69, LINK)"
35202,1,57,0,57,"(301be851ef23ecf00c7f2b0201da1df8da133dbd, 2020-04-01 14:34:01 -0700, Xiao Wang, 57, 0, 57, LINK)"
35210,1,7,1,8,"(a53328e89c7226e5bc5be9e365614375a73b6cd4, 2020-04-02 11:54:54 -0700, Eli Uriegas, 7, 1, 8, LINK)"
35211,1,2,0,2,"(c2804e822973980c7e572c566532b74f8c20607e, 2020-03-25 01:40:05 -0700, h6197627, 2, 0, 2, LINK)"
35213,2,2,2,4,"(ab660ae394a81750f3585fdb3b8eebca932d3c44, 2020-03-23 14:09:24 -0700, Pavel Belevich, 1, 1, 2, LINK), (3cd3f0b3f1fd93e6947d0ec1d29d3de5068f363c, 2020-03-23 14:09:24 -0700, Pavel Belevich, 1, 1, 2, LINK)"
35225,1,25,0,25,"(8d720b70340b3086f379c4108dd872db6051b12b, 2020-03-26 13:14:04 -0700, Natalia Gimelshein, 25, 0, 25, LINK)"
3525,2,4,4,8,"(f8aa5e2ed7ba8572139fe9cd61d935867204d94e, 2017-11-08 09:55:25 -0500, Sam Gross, 2, 2, 4, LINK), (9c3cb6e652e6033e355cef92229fde5b0baf271b, 2017-11-08 09:55:25 -0500, Sam Gross, 2, 2, 4, LINK)"
35257,1,114,14,128,"(254be6a2014260fadc7276676186d415f38d5e15, 2020-04-11 21:53:51 -0700, Mike Ruberry, 114, 14, 128, LINK)"
35284,2,1535,2,1537,"(6d409481b38692926930278002b50d2075396557, 2020-04-27 10:29:07 -0700, Gao Xiang, 511, 1, 512, LINK), (25252816cf81c7b4105d5c074f6a0ade9306e041, 2020-04-14 10:48:20 -0700, Xiang Gao, 1024, 1, 1025, LINK)"
35358,1,5,0,5,"(de3044b2102dc5e1ebf40a6603a55426aafd6852, 2020-03-25 13:19:55 -0700, peterjc123, 5, 0, 5, LINK)"
35367,1,23,0,23,"(0a3864f81e3f660151ce452b228dbce0338c553e, 2020-03-25 18:36:48 -0700, Shihao Xu, 23, 0, 23, LINK)"
35397,1,72,74,146,"(4f4ed5c1084669762f57cfd4759d885d6f983ce2, 2020-03-30 21:10:24 -0700, Edward Yang, 72, 74, 146, LINK)"
35470,1,10,1,11,"(e99c53dc86e450df6cd78fbca496b47db3d25057, 2020-04-08 10:59:34 -0700, Peter Bell, 10, 1, 11, LINK)"
35532,1,23,3,26,"(b3cdec88e364e56bc69bf42cd6d8583fcfd62a18, 2020-04-04 15:31:21 -0700, Aayush Naik, 23, 3, 26, LINK)"
3554,2,48,28,76,"(1108bced80570d21475ac3d56b2ce9916e26a3f5, 2017-11-09 12:30:12 -0500, Sam Gross, 24, 14, 38, LINK), (1bf717e17dbc9deb8845d8496a4a423a3594e98f, 2017-11-09 12:30:12 -0500, Sam Gross, 24, 14, 38, LINK)"
35547,1,1,2,3,"(5db5a0f2bb6b5bfa1822fd8c4e1ad67af88cab00, 2020-07-02 11:19:41 -0700, peter, 1, 2, 3, LINK)"
35634,1,16,19,35,"(bc3151dee0b73e10c64788fce2d822e96aeffb4a, 2020-09-24 22:10:52 -0700, Jerry Zhang, 16, 19, 35, LINK)"
35675,1,17,5,22,"(c070e8fb26e276da2148b7604b9a93d85740f5e2, 2020-04-02 15:09:06 -0700, anjali411, 17, 5, 22, LINK)"
35689,2,24,24,48,"(ffd010f8a0ce4ac427d9424e839d2e0316f306cf, 2020-04-01 16:59:47 -0700, Gregory Chanan, 12, 12, 24, LINK), (e0ee8000ac68ae58580ca62a59d5f40a9dd8710c, 2020-04-01 16:59:47 -0700, Gregory Chanan, 12, 12, 24, LINK)"
35699,1,23,6,29,"(84342476536253cf34e03aae5a73edac0d37fda7, 2020-05-06 10:46:57 -0700, Nik Ved, 23, 6, 29, LINK)"
3573,1,24,15,39,"(0217ad29d2f2706b7d7b7989aac789dd1c2a4f0e, 2017-11-09 06:28:37 +0800, Edward Z. Yang, 24, 15, 39, LINK)"
35778,1,15,0,15,"(6e13a7787bfe5e0027c4cc51812b3bf08e7c973a, 2020-04-03 11:30:29 -0700, davidriazati, 15, 0, 15, LINK)"
35810,1,78,3,81,"(b4ccdef09040397443d4d82feb82dec502c66e76, 2020-06-24 09:05:38 -0700, Michael Carilli, 78, 3, 81, LINK)"
3584,1,306,121,427,"(335306406032489bfdfa5bf06220da5429ca3e8f, 2018-12-20 17:34:41 -0800, Richard Zou, 306, 121, 427, LINK)"
35863,1,16,17,33,"(82dd01150c182b39d2560b61d3983d9f08242245, 2020-04-08 14:03:37 -0700, Pritam Damania, 16, 17, 33, LINK)"
3587,1,28,4,32,"(8212f576dbebfb6ceb45ea550ba1521bb46e9fd4, 2018-05-18 16:41:03 +0200, Thomas Viehmann, 28, 4, 32, LINK)"
36046,2,22,6,28,"(e8236d2ed4a1be6d64c59b1beea640efee6ea978, 2020-04-07 01:09:23 -0700, lixinyu, 11, 3, 14, LINK), (b55dee9fe15d679f9d92ec660d77059ff380c839, 2020-04-07 01:09:23 -0700, lixinyu, 11, 3, 14, LINK)"
36048,2,419,93,512,"(5c9cef9a6c2df8e82ff49624a8e69b5cfe25880d, 2020-12-03 10:30:00 -0800, kshitij12345, 163, 92, 255, LINK), (266657182a4040937f6f27011d7ddf77716db83d, 2020-07-23 09:32:24 -0700, kshitij12345, 256, 1, 257, LINK)"
36057,3,467,209,676,"(4f3946a89b639f3b87c37b4190e2bc3dc22ee608, 2020-04-24 15:03:38 -0700, anjali411, 195, 98, 293, LINK), (25eb250d77ff83ee5b133eb7b1f9c70d6a6a5e48, 2020-04-22 08:47:04 -0700, anjali411, 158, 97, 255, LINK), (254be6a2014260fadc7276676186d415f38d5e15, 2020-04-11 21:53:51 -0700, Mike Ruberry, 114, 14, 128, LINK)"
36064,1,0,2,2,"(f8c93c5d3ed69c475f9211cb21ef421ed75dba65, 2020-05-07 19:47:39 -0700, Edward Yang, 0, 2, 2, LINK)"
36129,2,1,1,2,"(b0c90fad935cde51d0d1234ba9efa6702b5e6636, 2020-04-10 10:00:31 -0700, Di Wu, 0, 1, 1, LINK), (3e5d25fdfd6dc22cfc697a83d924ff386fdf51b3, 2020-04-06 23:48:32 -0700, Mike Ruberry, 1, 0, 1, LINK)"
36176,1,29,0,29,"(3d2fce6bc39c7cfa2872a43773da74e0da79757a, 2020-05-27 11:34:43 -0700, Donna Choi, 29, 0, 29, LINK)"
36207,1,1,1,2,"(b9260bdb7b66a51d915a7493143a95d9929f9c40, 2020-04-08 08:55:08 -0700, peter, 1, 1, 2, LINK)"
3627,1,552,528,1080,"(d6050582122c09e52e51b518f5af9be04e12e021, 2017-12-18 15:46:13 -0500, Sam Gross, 552, 528, 1080, LINK)"
36279,1,19,13,32,"(2f5b523cd0aa0443b2cc34e580a87846aedd776d, 2020-04-09 19:32:50 -0700, Donna Choi, 19, 13, 32, LINK)"
36322,2,102,42,144,"(9e016f77a8fc8c628f8a80f594cd071ae48ddf21, 2020-04-16 08:21:49 -0700, anjali411, 53, 22, 75, LINK), (4bcd8ab6f77fd25a951d2e236bb710321abd7d09, 2020-04-12 13:38:42 -0700, anjali411, 49, 20, 69, LINK)"
36323,1,196,13,209,"(58b6ab69e5100adc01dd1bf272e70279ba6ae012, 2020-09-22 08:01:16 -0700, anjali411, 196, 13, 209, LINK)"
36327,2,102,42,144,"(9e016f77a8fc8c628f8a80f594cd071ae48ddf21, 2020-04-16 08:21:49 -0700, anjali411, 53, 22, 75, LINK), (4bcd8ab6f77fd25a951d2e236bb710321abd7d09, 2020-04-12 13:38:42 -0700, anjali411, 49, 20, 69, LINK)"
36328,1,236,403,639,"(b198cf4f1cad25c9bf6bb3f9a076d6428bb12e44, 2021-02-01 15:54:13 -0800, Nikita Vedeneev, 236, 403, 639, LINK)"
36340,1,20,19,39,"(c78691b4a6e89ebd9794a5ab9b02bfafd6903094, 2020-05-20 09:12:51 -0700, nuka137, 20, 19, 39, LINK)"
36341,1,14,2,16,"(379e4d9cad2b040f09022014f26f34f24ca9aaa6, 2020-04-13 07:48:05 -0700, Max Balandat, 14, 2, 16, LINK)"
36363,1,114,14,128,"(254be6a2014260fadc7276676186d415f38d5e15, 2020-04-11 21:53:51 -0700, Mike Ruberry, 114, 14, 128, LINK)"
36369,1,84,10,94,"(54a575c9bdde3d8e221fc28a7925fe49902feeb8, 2020-04-16 10:53:34 -0700, Elias Ellison, 84, 10, 94, LINK)"
36374,1,54,5,59,"(7aa6a8fd7a7cebc691e50ae7016f02207663e756, 2020-04-11 12:28:34 -0700, Mike Ruberry, 54, 5, 59, LINK)"
36408,1,21,21,42,"(8544591f5a312980c353e9ff2db8a357943a3db5, 2020-04-13 20:08:30 -0700, Vivek Panyam, 21, 21, 42, LINK)"
36428,1,531,229,760,"(fbf274f5a7c55f58ee1f7eb9b515f23f29bff443, 2020-08-18 13:36:02 -0700, Michael Carilli, 531, 229, 760, LINK)"
36434,1,33,12,45,"(76f952887835e3c14eeb3b56a993f2082cd9888d, 2020-04-16 20:47:41 -0700, Nikolay Korovaiko, 33, 12, 45, LINK)"
36455,1,27,1,28,"(b75b961934f8daa03c877a380487334e873b1950, 2020-10-28 09:31:02 -0700, Kurt Mohler, 27, 1, 28, LINK)"
36462,1,686,256,942,"(9cfc10d52e0d0a8576b0a5a347fa6fa8da86244a, 2020-05-15 16:22:03 -0700, Mike Ruberry, 686, 256, 942, LINK)"
36493,1,20,2,22,"(54aaffb7c7d05b107f15bc1a73e5c8dedbf705a3, 2020-10-05 16:17:24 -0700, Kurt Mohler, 20, 2, 22, LINK)"
36499,2,62,24,86,"(375566fb78f8f874d27ffa0cbe2c1b6e6a98bc36, 2020-04-16 11:46:01 -0700, Gregory Chanan, 31, 12, 43, LINK), (4c666d42fff6daea4f9aca2feed0e64857c725dd, 2020-04-17 08:23:09 -0700, Gregory Chanan, 31, 12, 43, LINK)"
3659,1,2671,2267,4938,"(1c0fbd27a10b7036b1db643014e65cae7f6d0266, 2017-11-30 23:06:58 -0500, Edward Z. Yang, 2671, 2267, 4938, LINK)"
36594,1,6,4,10,"(f41833957d28e91cf19685a2f13493e487c5bec9, 2020-05-11 16:17:23 -0700, Emilio Castillo, 6, 4, 10, LINK)"
36595,1,1,1,2,"(681158e211af835aab0c2f8f926746d0d8d12b7b, 2020-04-17 18:04:09 -0700, Nikita Shulga, 1, 1, 2, LINK)"
36671,2,353,195,548,"(4f3946a89b639f3b87c37b4190e2bc3dc22ee608, 2020-04-24 15:03:38 -0700, anjali411, 195, 98, 293, LINK), (25eb250d77ff83ee5b133eb7b1f9c70d6a6a5e48, 2020-04-22 08:47:04 -0700, anjali411, 158, 97, 255, LINK)"
36676,1,24,6,30,"(68250fa557cc3079bdd88aee4bee2d9222fbb34d, 2020-04-29 23:04:50 -0700, Ailing Zhang, 24, 6, 30, LINK)"
367,1,411,398,809,"(c367e0b64e9871a87105958089091c5880e96680, 2016-12-29 18:20:32 -0500, Sam Gross, 411, 398, 809, LINK)"
3671,1,11,2,13,"(7d16e87f14c4b93a0dd28363c9cb57860faa567d, 2018-08-13 21:33:10 -0700, Vishwak Srinivasan, 11, 2, 13, LINK)"
36715,1,73,2,75,"(e39991e8387ccd028627fe6031a33ea94f5aeecc, 2020-05-12 21:05:33 -0700, Hongyi Jia, 73, 2, 75, LINK)"
36730,2,353,195,548,"(4f3946a89b639f3b87c37b4190e2bc3dc22ee608, 2020-04-24 15:03:38 -0700, anjali411, 195, 98, 293, LINK), (25eb250d77ff83ee5b133eb7b1f9c70d6a6a5e48, 2020-04-22 08:47:04 -0700, anjali411, 158, 97, 255, LINK)"
36744,1,80,27,107,"(779abf753833eaa7539470257221a4d73345b005, 2020-05-12 11:25:51 -0700, Emilio Castillo, 80, 27, 107, LINK)"
3677,2,12,4,16,"(4e00120117054edfd659429fdd3b835d099945b3, 2017-11-13 20:34:20 -0800, Sam Gross, 6, 2, 8, LINK), (446f869a0d22995c816d3cc425dd639f9e5faca4, 2017-11-13 20:34:20 -0800, Sam Gross, 6, 2, 8, LINK)"
36773,2,12,0,12,"(9e6ef814ccbc9b20ed02d25a6ace2b44faab2239, 2020-04-16 18:08:19 -0700, Gregory Chanan, 6, 0, 6, LINK), (46288465fe773da6941b2f366a0ad6e59f935d83, 2020-04-17 07:25:17 -0700, Gregory Chanan, 6, 0, 6, LINK)"
36796,1,142,35,177,"(3c5e3966f4a05edbf959888fe42dbfe89d746571, 2020-08-17 17:40:11 -0700, Yael Dekel, 142, 35, 177, LINK)"
36798,1,14,18,32,"(a850d8a526d0d964159493dbd17f94c181af7339, 2020-04-21 17:28:37 -0700, Mike Ruberry, 14, 18, 32, LINK)"
36801,1,2,0,2,"(c0e38398459ef107b7afa7d23024b28c9c151e97, 2020-07-23 09:28:21 -0700, chenx, 2, 0, 2, LINK)"
36803,1,9,1,10,"(92b9089fd9900968bb2fa91f2cb132ce53ce5159, 2020-04-28 21:27:59 -0700, Michael Suo, 9, 1, 10, LINK)"
36807,1,48,23,71,"(0f0d69009eb1dbc58feacc819bc9885990e888aa, 2020-04-19 23:31:54 -0700, Mike Ruberry, 48, 23, 71, LINK)"
36831,1,17,4,21,"(a3c87c492268191a3d469089dbe992427befced0, 2020-06-01 15:28:38 -0700, Alex Hedges, 17, 4, 21, LINK)"
36834,1,7,1,8,"(a42616f71af8ee758e2461789d1e7a50e06a3e1c, 2020-05-07 17:39:12 -0700, anjali411, 7, 1, 8, LINK)"
36925,2,521,619,1140,"(47c72be3d79cc8cf313204313de8028f6d5aa4a0, 2020-06-26 16:10:25 -0700, Changji Shi, 10, 24, 34, LINK), (77abb6938e6cee510a003e7316e2a1429fcc9d64, 2020-04-24 10:01:58 -0700, Jesse Brizzi, 511, 595, 1106, LINK)"
36941,2,32,29,61,"(c5424a85dc62205ab5c12a78fe8d6f1d97be3e97, 2020-06-03 07:44:48 -0700, Nikita Shulga, 8, 8, 16, LINK), (a864dbb3607c0de010d8668175d0eede8b1a1519, 2020-06-02 13:07:55 -0700, Nikita Shulga, 24, 21, 45, LINK)"
36946,3,32,33,65,"(8e07b75cef6097f944add88ca151bc1ac85b1d4d, 2020-05-11 16:01:26 -0700, anjali411, 27, 26, 53, LINK), (331c31d3344289f4510b943a65f54a9d48bacec8, 2020-05-07 14:12:11 -0700, anjali411, 4, 6, 10, LINK), (3f2c76c24bb1023d5207a7a9fcdee36e9bf028c9, 2020-05-07 12:17:09 -0700, anjali411, 1, 1, 2, LINK)"
36956,2,16,2,18,"(ce0500eb4cbcc4c3e48f59ebb28b60ce60e16634, 2020-04-20 20:43:59 -0700, Gregory Chanan, 8, 1, 9, LINK), (4ff3872a2099993bf7e8c588f7182f3df777205b, 2020-04-20 19:59:38 -0400, gchanan, 8, 1, 9, LINK)"
36977,1,83,0,83,"(87bf04fe1277d08e047ff878615344022fec48d8, 2020-07-14 09:19:54 -0700, Peter Bell, 83, 0, 83, LINK)"
36997,1,53,4,57,"(6e4f501f1ae2814b1f6801c95b6cab2f297a3cf6, 2020-07-06 20:22:43 -0700, Yael Dekel, 53, 4, 57, LINK)"
37000,1,15,4,19,"(f188b52b59090dfc688620934b9f77946ffdc659, 2020-05-26 16:14:54 -0700, chengjinfang, 15, 4, 19, LINK)"
37047,1,2,2,4,"(305444a0bda0d2be09c97ee8cc9f376c005d256e, 2020-05-07 09:55:56 -0700, Eli Uriegas, 2, 2, 4, LINK)"
37084,1,23,1,24,"(273c4641451a1efce8d0b0889da196cea80002ee, 2020-04-28 18:06:22 -0700, Emilio Castillo, 23, 1, 24, LINK)"
37117,2,11,4,15,"(f1cd0eeb70f7bb62e7c881940441cc4bc63d1fe8, 2020-04-29 15:56:39 -0700, Nikita Shulga, 7, 4, 11, LINK), (e6231c9e24c05e435eeb9dfcd66247e4520c559a, 2020-04-25 00:09:09 -0700, Nikita Shulga, 4, 0, 4, LINK)"
37141,1,33,8,41,"(3a0d4240c32b568ebe74a0f6901fc744d5179b3b, 2020-12-04 07:31:03 -0800, Emile van Krieken, 33, 8, 41, LINK)"
37154,1,37,4,41,"(25ba802ce4cbdeaebcad4a03cec8502f0de9b7b3, 2020-05-05 14:06:18 -0700, Emilio Castillo, 37, 4, 41, LINK)"
37157,1,80,31,111,"(35693e9b4b09de02a18f0840ec491726f2e61fe2, 2020-05-06 18:16:33 -0700, Michael Carilli, 80, 31, 111, LINK)"
37182,1,21,18,39,"(f8ec51bd865bb488dc0c30f1e970c5dc49ce4727, 2020-04-25 20:55:28 -0700, Peter Bell, 21, 18, 39, LINK)"
37183,1,1,1,2,"(16e3df3ac6c7a47d758543e30161eef9ca1a896f, 2020-05-07 20:55:32 -0700, Edward Yang, 1, 1, 2, LINK)"
37234,1,408,11,419,"(3dcc329746223bc24f8213ccbaa5eba09273e162, 2020-06-24 16:56:24 -0700, Peter Bell, 408, 11, 419, LINK)"
37240,1,111,57,168,"(a318234eb0d746c1f5a59b5584687f522dd3e459, 2020-07-09 11:36:13 -0700, Thomas Viehmann, 111, 57, 168, LINK)"
37286,1,48,5,53,"(dd618216c526a78b6df85e006480250ee3ccb0f0, 2020-05-06 10:38:45 -0700, Ailing Zhang, 48, 5, 53, LINK)"
37306,2,55,46,101,"(25621d05df04979db9efdacf77f38b3f03b5a54c, 2020-04-28 20:09:09 -0700, Sebastian Messmer, 28, 7, 35, LINK), (12f5a328639104353a84ef623423d3b8abd76c87, 2020-04-28 20:09:09 -0700, Sebastian Messmer, 27, 39, 66, LINK)"
37345,2,24,14,38,"(dc30c519dd3e66564e61573488b49a3cfd3abcfb, 2020-04-28 21:30:56 -0700, lixinyu, 12, 7, 19, LINK), (21b7af1e7b986e3f0e19b15390bb89e2b9314f56, 2020-04-28 21:30:56 -0700, lixinyu, 12, 7, 19, LINK)"
37368,1,115,43,158,"(ce6077d7a8364d3dddd1702886884e818ceae8a6, 2020-04-29 08:03:04 -0700, Pavel Belevich, 115, 43, 158, LINK)"
37369,1,111,42,153,"(06168bf17d17a04a696626c90fdf72b56f287afc, 2020-04-29 08:03:04 -0700, Pavel Belevich, 111, 42, 153, LINK)"
37370,1,138,70,208,"(ec8517b6df32aebe931658828856d2c8aad9ddc0, 2020-04-29 08:03:04 -0700, Pavel Belevich, 138, 70, 208, LINK)"
37371,1,70,37,107,"(5ab36ec98ba28b61ac3be57427d67ad8e1f0bab4, 2020-04-30 20:00:54 -0700, Pavel Belevich, 70, 37, 107, LINK)"
37398,1,47,8,55,"(c835dedce905405839774c985d7469df07cd61f1, 2020-05-27 13:56:07 -0700, chengjinfang, 47, 8, 55, LINK)"
37403,2,110,82,192,"(39f0a2752a5cb835a035989d7b34afbe063d8fa4, 2020-05-12 22:30:45 -0700, Natalia Gimelshein, 55, 41, 96, LINK), (3d968088e0555a0dee20ea591a3c760efc9b4e66, 2020-05-12 22:30:45 -0700, Natalia Gimelshein, 55, 41, 96, LINK)"
37490,1,32,32,64,"(4c009c7f3e77c9413ec9494449f0d800fb1c3ca2, 2020-05-05 15:04:38 -0700, Nikita Shulga, 32, 32, 64, LINK)"
37493,1,0,5,5,"(88e94da5802f6a8f36a45dd397345b2acd0d1e1f, 2020-10-22 19:38:00 -0700, ashish, 0, 5, 5, LINK)"
37499,1,32,0,32,"(deeef504327c5c76f9c16111a905281b313c148a, 2020-05-07 21:31:04 -0700, Chris Paulse, 32, 0, 32, LINK)"
37500,1,18,1,19,"(724b2b6ebda1ba87c16368fc987709355a82c277, 2020-05-18 16:42:41 -0700, Shawn Zhong, 18, 1, 19, LINK)"
37530,1,16,1,17,"(1456515f1526560822ac5b2376af5d74e96a24fc, 2020-05-11 14:13:39 -0700, Meghan Lele, 16, 1, 17, LINK)"
37558,1,2,1,3,"(4d1df74c7ced61d8067dc4daa9d98843910a5fb1, 2020-05-26 09:02:37 -0700, Diego M. Rodriguez, 2, 1, 3, LINK)"
37571,1,28,13,41,"(9d92fa2679f15013e832971514f7ecb5836abbae, 2020-07-16 10:54:27 -0700, Omkar Salpekar, 28, 13, 41, LINK)"
37577,1,82,61,143,"(480bd0ad509db7f1e8ca0845b6dcf415afbc302a, 2020-05-05 18:44:40 -0700, Edward Yang, 82, 61, 143, LINK)"
37628,2,1073,698,1771,"(ea2a568cca71aaf690051782c225ca9dd2e5e1f9, 2020-12-06 08:01:00 -0800, Heitor Schueroff, 543, 348, 891, LINK), (a5c65b86ce249f5f2d365169e6315593fbd47b61, 2020-11-10 19:37:09 -0800, Heitor Schueroff, 530, 350, 880, LINK)"
37672,1,18,3,21,"(6133be31bde86543e9c173fb18b675bfb2db75c4, 2020-05-05 07:12:17 -0700, Alban Desmaison, 18, 3, 21, LINK)"
37680,1,17,1,18,"(5e83a13e14fd172f56f5d63b6bce9fd472ac1ba3, 2020-05-07 15:06:46 -0700, Alban Desmaison, 17, 1, 18, LINK)"
37698,1,66,19,85,"(09bea1398141e0f74afb1e22d380d3322ba28105, 2020-06-02 13:00:01 -0700, kshitij12345, 66, 19, 85, LINK)"
37701,1,28,11,39,"(09c430a2aae7a8086fa0d773fe46fee8210166aa, 2020-05-18 11:55:34 -0700, kshitij12345, 28, 11, 39, LINK)"
37703,2,28,2,30,"(eb387a0a2bf70aba3ecbd69d5a3c2f62d805bf2e, 2020-05-07 20:31:55 -0700, Edward Yang, 14, 1, 15, LINK), (c2f787ce7708ba81c1d24b4481024510379d37de, 2020-05-07 20:31:55 -0700, Edward Yang, 14, 1, 15, LINK)"
37725,1,47,30,77,"(17d3f74ea345c827da7dec73a1f4f3e7ad37bb93, 2020-06-22 10:57:17 -0700, Xiao Wang, 47, 30, 77, LINK)"
37743,2,117,14,131,"(0a159b0a3a78a80fb0f9082087a98f87f2dea986, 2020-05-14 08:52:15 -0700, Peter Bell, 91, 11, 102, LINK), (63b1ae69831cd21bc4d6059a5854bc1155a152c9, 2020-05-08 16:44:33 -0700, Xiao Wang, 26, 3, 29, LINK)"
3775,1,465,3,468,"(5a27ec09b8a2e8f834a3a5a3371561d2e02ee669, 2020-04-24 12:12:33 -0700, moto, 465, 3, 468, LINK)"
37756,4,1787,20,1807,"(bf8cd21f2a785ce9721c9be7a13be9eca61c16cd, 2020-09-25 08:20:44 -0700, Vinod Kumar S, 487, 0, 487, LINK), (13c7c6227ed2cdd1991329093d7d2ff84c5232e5, 2020-08-28 20:10:36 -0700, Vinod Kumar S, 697, 19, 716, LINK), (5d608d45cfd5c42b374c9ac6d2f8bb6ddd1c6e7f, 2020-08-18 11:07:35 -0700, Vinod Kumar S, 2, 0, 2, LINK), (830423b80b76ef063285cba79a86ce11246c2976, 2020-08-13 20:26:42 -0700, Vinod Kumar S, 601, 1, 602, LINK)"
37784,1,47,35,82,"(91f451a5e69d2969d730744e98e059d05e63a84d, 2020-05-08 10:43:14 -0700, Luca Wehrstedt, 47, 35, 82, LINK)"
37786,1,42,0,42,"(4c358b8b726f56bc78ce20bb031e10869145de94, 2020-05-07 22:08:14 -0700, Nikita Shulga, 42, 0, 42, LINK)"
37790,2,98,0,98,"(77ffb259259f229cdbb76ebeed92ed2100a095f4, 2020-07-08 21:08:17 -0700, Rohan Varma, 49, 0, 49, LINK), (9a3e16c773496b16e6c02f6e3e020be5bb485ea0, 2020-06-24 11:23:11 -0700, Rohan Varma, 49, 0, 49, LINK)"
37819,2,4,0,4,"(bae895cef0c12df5f64afa155ce5462e06f0e04a, 2020-05-15 01:38:50 -0700, Nicolas Weber, 2, 0, 2, LINK), (bae895cef0c12df5f64afa155ce5462e06f0e04a, 2020-05-15 01:38:50 -0700, Nicolas Weber, 2, 0, 2, REGEX)"
37823,1,42,11,53,"(881c1adfcd916b6cd5de91bc343eb86aff88cc80, 2020-06-22 08:15:51 -0700, F-G Fernandez, 42, 11, 53, LINK)"
37841,2,80,81,161,"(f4365cf5ba8ee4ba319385cbd2ff7b9a825a75d0, 2020-06-01 23:49:16 -0700, Meghan Lele, 76, 80, 156, LINK), (fa184c351fec6c368a24d878072c285f2ae9a533, 2020-05-27 15:39:03 -0700, Meghan Lele, 4, 1, 5, LINK)"
37844,2,68,48,116,"(7fc24334588f571f07c95f2a71a9b04a47c8713e, 2020-05-14 11:54:14 -0700, SsnL, 34, 24, 58, LINK), (5f2a27401506162a9890a99fec4f7a759b30787e, 2020-05-14 11:54:14 -0700, SsnL, 34, 24, 58, LINK)"
37855,2,690,452,1142,"(8cdc4807cdda4c773097283de0d1c93fa4a550da, 2020-05-14 17:05:51 -0700, Eli Uriegas, 352, 224, 576, LINK), (def9f15b57f6799695bbc7423a6b307548586026, 2020-05-11 15:23:16 -0700, Eli Uriegas, 338, 228, 566, LINK)"
37874,1,51,19,70,"(7b9ca54ecf31503ac4f22968307675164cf492bd, 2021-02-08 17:44:45 -0800, Jeffrey Wan, 51, 19, 70, LINK)"
37930,1,16,5,21,"(5b8a79ab4929c68db1e7d70e5febcccbd808ac29, 2020-05-20 15:40:57 -0700, jiej, 16, 5, 21, LINK)"
37944,2,98,0,98,"(77ffb259259f229cdbb76ebeed92ed2100a095f4, 2020-07-08 21:08:17 -0700, Rohan Varma, 49, 0, 49, LINK), (9a3e16c773496b16e6c02f6e3e020be5bb485ea0, 2020-06-24 11:23:11 -0700, Rohan Varma, 49, 0, 49, LINK)"
37986,2,169,63,232,"(82f549b0a8de5581c64363420680905b49dc27c5, 2020-05-12 18:29:18 -0700, Elias Ellison, 87, 34, 121, LINK), (eb3e9872c9ed038ead67a832e7e5295628cbb55a, 2020-05-12 18:29:18 -0700, Elias Ellison, 82, 29, 111, LINK)"
37996,2,16,0,16,"(e7a6ed8151226091d039091d81036803abfc0068, 2020-05-10 23:13:33 -0700, Cloud Han, 8, 0, 8, LINK), (324dc1623e2f91892038fb1b151450a7c6529dd9, 2020-05-10 23:13:33 -0700, Cloud Han, 8, 0, 8, LINK)"
38018,1,13,10,23,"(f7e7a15a5dc37f75e122d7279adacfdfe3db7088, 2020-05-12 18:25:06 -0700, Emilio Castillo, 13, 10, 23, LINK)"
38024,1,3,3,6,"(ec7beda822d96b11c9bcd652a1f9aa43f888da6b, 2020-05-11 20:29:46 -0700, peter, 3, 3, 6, LINK)"
38081,1,13,6,19,"(8292742ba020fcff90f14418c18741ebf606103b, 2020-05-18 09:17:20 -0700, Vasiliy Kuznetsov, 13, 6, 19, LINK)"
38111,1,8,7,15,"(6e1e2a60dcf086bee0932e5dc105463de868aac9, 2020-05-08 13:21:15 -0700, Cloud Han, 8, 7, 15, LINK)"
38137,1,21,0,21,"(fbf9745c85b6b50fec0156ff1f877a1209f76779, 2021-03-02 10:32:19 -0800, mattip, 21, 0, 21, LINK)"
38187,1,2,3,5,"(a37b8651075f270c6f7fe269ca1e9b5a3c86f057, 2020-05-11 15:14:29 -0700, kshitij12345, 2, 3, 5, LINK)"
38221,1,4,25,29,"(0cf71eb54783495de9332738b5cfc2be1a02ab84, 2020-08-05 08:16:47 -0700, Nikita Shulga, 4, 25, 29, LINK)"
38235,1,12,1,13,"(0031108b60ec0e2713fb3a9a1e88b43d7a650f05, 2020-06-05 11:52:20 -0700, Yanan Cao, 12, 1, 13, LINK)"
38315,1,29,4,33,"(fc19747d648ba58cfd0c79c211cb5d8ff1167c85, 2020-05-18 20:47:30 -0700, kshitij12345, 29, 4, 33, LINK)"
38336,1,14,1,15,"(f872cf5ed084c4a5d354fe1308b93449f73512b7, 2020-05-31 12:50:08 -0700, Shawn Zhong, 14, 1, 15, LINK)"
38357,1,45,3,48,"(6fd48e24f109a08612495df05ad75392f0d2e6b2, 2020-05-19 12:58:06 -0700, Will Constable, 45, 3, 48, LINK)"
38372,1,163,0,163,"(0829cadca34ba7b5276c2e2f410476f0827bab2f, 2020-06-03 22:17:17 -0700, Aayush Naik, 163, 0, 163, LINK)"
38401,1,38,46,84,"(de8c888232aaf6bae339092fd2a7e9799617ece0, 2020-05-26 21:03:50 -0700, Martin Valgur, 38, 46, 84, LINK)"
38410,1,32,13,45,"(21ba3b4f40242eb8b758d0f507d68c8a7a412a02, 2020-06-03 10:53:26 -0700, Shawn Zhong, 32, 13, 45, LINK)"
38431,1,113,83,196,"(49d687f23ccbc8f1c80fd7ffcd2b41c35c57da81, 2020-05-18 16:28:21 -0700, Jason Ansel, 113, 83, 196, LINK)"
38439,2,142,27,169,"(409e42e3b83611ab115eff198c8f4118f83b51ce, 2020-05-15 17:20:48 -0700, Shen Li, 80, 14, 94, LINK), (f39222a13dbad4deaac2dc8c376b630bc2b0da78, 2020-05-15 17:20:48 -0700, Shen Li, 62, 13, 75, LINK)"
38554,1,45,14,59,"(e4f9c74db35c621f4c29efc1eda8566bb549a646, 2020-06-08 08:38:53 -0700, Nik Ved, 45, 14, 59, LINK)"
38555,1,38,23,61,"(67c79bb045c1870c8f33b81d06f11a9647d06ce9, 2020-06-26 09:22:57 -0700, Taylor Robie, 38, 23, 61, LINK)"
38568,2,8,8,16,"(366026ab103ad0cc687825a9ab338e341574d467, 2020-05-18 18:43:50 -0700, jjsjann123, 4, 4, 8, LINK), (958313a79fbcdcc2eecceead8544ed27f898997e, 2020-05-18 18:43:50 -0700, jjsjann123, 4, 4, 8, LINK)"
3858,1,272,22,294,"(670f509984efce8aab0b0b5b166ff01472af6f1c, 2019-03-18 12:21:52 -0700, Narine Kokhlikyan, 272, 22, 294, LINK)"
38586,1,14,6,20,"(2c2fe6356ad995b31b079912d1ff85ad952338c4, 2020-05-21 07:47:41 -0700, Alban Desmaison, 14, 6, 20, LINK)"
38597,1,0,2,2,"(7e85f6f922d93c6142ceb3bc5ca6885be1756b49, 2020-05-26 16:27:09 -0700, Andy Jones, 0, 2, 2, LINK)"
3860,1,4,0,4,"(3c709f5b263e2c4c21f86bbc2eece9d11e0b637a, 2017-11-29 19:35:27 +0100, Simeon Monov, 4, 0, 4, LINK)"
38605,2,68,8,76,"(b54a731c8ebbd473b9a589dac16f2f5b91f6625e, 2020-05-19 10:30:57 -0700, Natalia Gimelshein, 34, 4, 38, LINK), (54d4b419db8962a01978a6c191148f0174080978, 2020-05-19 10:30:57 -0700, Natalia Gimelshein, 34, 4, 38, LINK)"
38607,2,83,0,83,"(351b85d7584e6157928583127bfef107d996b541, 2020-11-20 17:42:35 -0800, Nikita Shulga, 39, 0, 39, LINK), (14194e4f23ed0596849e5521d3d7031596c59a9f, 2020-11-03 12:55:14 -0800, Nikita Shulga, 44, 0, 44, LINK)"
38710,1,5,0,5,"(02e091902f694fced3691ea7c0d7ceb0b42e1ecf, 2020-06-18 20:57:14 -0700, Deepali Chourasia, 5, 0, 5, LINK)"
38716,1,408,11,419,"(3dcc329746223bc24f8213ccbaa5eba09273e162, 2020-06-24 16:56:24 -0700, Peter Bell, 408, 11, 419, LINK)"
38728,1,110,12,122,"(a1071e5d36aa59d462b5482c651666230ff6667d, 2020-06-10 13:22:33 -0700, Will Constable, 110, 12, 122, LINK)"
38731,1,49,40,89,"(adbb50ea67ab87f2dd4a09698d2e229a83877e09, 2020-10-21 19:59:47 -0700, Rahul Nambiar, 49, 40, 89, LINK)"
38764,1,31,16,47,"(e4a3c584d51662d4c14060fc8517464fe3c12142, 2020-05-26 11:55:36 -0700, Xiao Wang, 31, 16, 47, LINK)"
38771,2,30,58,88,"(17eae0e0cdc18eab77c53a86c6ae1b2fdf8ac2c9, 2020-05-26 18:08:53 -0700, Natalia Gimelshein, 15, 29, 44, LINK), (ba14a701dc3f58d0027aa385baa3b1347301c484, 2020-05-26 18:08:53 -0700, Natalia Gimelshein, 15, 29, 44, LINK)"
38775,5,455,85,540,"(b9877c6480340a526a131529d322541d1f5afb8f, 2021-03-05 09:07:55 -0800, Nikitha Malgi, 91, 17, 108, LINK), (0b9538e6484ce2ba4dc96124519a7d83108c97bf, 2021-03-05 09:07:50 -0800, Nikitha Malgi, 91, 17, 108, LINK), (9f84b3fa026d56e62dccfad21c8f44bab357d8ae, 2021-03-05 09:06:50 -0800, Nikitha Malgi, 91, 17, 108, LINK), (76363510f9a82ff6357e8f8ad663fa09544151ce, 2021-03-05 09:06:14 -0800, Nikitha Malgi, 91, 17, 108, LINK), (e9d71370721d44439774f5cfaf67bc6275d5e943, 2021-03-05 08:35:28 -0800, kshitij12345, 91, 17, 108, LINK)"
38779,5,455,85,540,"(b9877c6480340a526a131529d322541d1f5afb8f, 2021-03-05 09:07:55 -0800, Nikitha Malgi, 91, 17, 108, LINK), (0b9538e6484ce2ba4dc96124519a7d83108c97bf, 2021-03-05 09:07:50 -0800, Nikitha Malgi, 91, 17, 108, LINK), (9f84b3fa026d56e62dccfad21c8f44bab357d8ae, 2021-03-05 09:06:50 -0800, Nikitha Malgi, 91, 17, 108, LINK), (76363510f9a82ff6357e8f8ad663fa09544151ce, 2021-03-05 09:06:14 -0800, Nikitha Malgi, 91, 17, 108, LINK), (e9d71370721d44439774f5cfaf67bc6275d5e943, 2021-03-05 08:35:28 -0800, kshitij12345, 91, 17, 108, LINK)"
38784,1,3,0,3,"(51504cb8dd81f3e86b5914e308141d2577aaf087, 2020-06-05 09:45:51 -0700, xueht-fnst, 3, 0, 3, LINK)"
38807,1,2,1,3,"(563b60b8901c23a5239f2533744d2d4b03a11ca4, 2020-07-15 10:50:40 -0700, Alexander Grund, 2, 1, 3, LINK)"
38839,1,23,15,38,"(c34b333230a4d56cb7fc246a094a050b20e73aa6, 2020-05-24 22:01:30 -0700, Natalia Gimelshein, 23, 15, 38, LINK)"
38845,1,457,3,460,"(45baf0e1a0e952f56163cee40d01237ccfcfd803, 2020-06-01 12:33:39 -0700, Shihao Xu, 457, 3, 460, LINK)"
38889,2,39,1,40,"(db2b273d1fe00d63bc8932e6136fea83efef1de4, 2020-06-12 21:27:24 -0700, Kurt Mohler, 20, 1, 21, LINK), (2cd27be5b52697b8f997e789b133be16de1577c6, 2020-06-11 20:00:24 -0700, Kurt Mohler, 19, 0, 19, LINK)"
38913,1,133,182,315,"(0e09511af9f986e5afdb4a9ce854c7ed77974f2e, 2020-07-07 07:14:33 -0700, Wojciech Baranowski, 133, 182, 315, LINK)"
38922,2,72,0,72,"(2da54442211d4282d2755e5ee79f2037838f0b8f, 2020-06-06 23:45:16 -0700, Shawn Zhong, 40, 0, 40, LINK), (f7a8851e9e1a7920fb48baf86321e2190fdcfe4e, 2020-05-28 19:39:21 -0700, ShawnZhong, 32, 0, 32, LINK)"
38958,1,24,4,28,"(de5b8797e675d8bb5867d9e06dd08e0217db07db, 2020-06-02 07:45:01 -0700, Edward Yang, 24, 4, 28, LINK)"
38979,1,8,0,8,"(12c219de54cbbbaac62c3812812f409a97d65b28, 2020-05-26 13:16:05 -0700, ShawnZhong, 8, 0, 8, LINK)"
38985,1,71,26,97,"(bfcb687b9c2744ffeb845b5ed33ea3b39ece584b, 2020-05-28 08:05:01 -0700, jiej, 71, 26, 97, LINK)"
38986,1,29,12,41,"(583ff947e1f4e922ba15832c7334cdecf9cd0439, 2020-05-26 11:23:24 -0700, Xiao Wang, 29, 12, 41, LINK)"
39020,1,38,0,38,"(e088902b4a8cd7ea1dd998e6ed7d523786aca304, 2020-05-28 01:26:44 -0700, Luca Antiga, 38, 0, 38, LINK)"
39044,3,80,144,224,"(1670ea947411001160094ba9397b8e1091a5188e, 2020-06-17 16:15:31 -0700, Xiao Wang, 52, 116, 168, LINK), (5d01f87e581fd977d42cfd44ccacd832bfd8e4e0, 2020-05-28 15:41:32 -0700, Natalia Gimelshein, 14, 14, 28, LINK), (9c19a12965ba08e5541d5106821728a747934bac, 2020-05-28 15:41:32 -0700, Natalia Gimelshein, 14, 14, 28, LINK)"
39060,1,6,3,9,"(35719cdc85e55886889b11a9b0ee671af73900ea, 2020-06-02 11:17:42 -0700, Xiang Gao, 6, 3, 9, LINK)"
39133,1,14,4,18,"(e029d678b63d8970d92e7d9713af74eb0ea69ad8, 2020-05-28 13:23:13 -0700, peter, 14, 4, 18, LINK)"
3914,1,44,5,49,"(d4e5d9061da8c69d30e691e3de4ba218713e109c, 2017-11-28 14:32:35 -0500, Sam Gross, 44, 5, 49, LINK)"
39247,1,4,0,4,"(b44f02f8f58ca8bacb331cbe6d9fee5b36af6b52, 2020-05-29 09:55:05 -0700, peter, 4, 0, 4, LINK)"
39281,2,18,2,20,"(bb33e5fc85a643fd296540e978aef45133aa9cdc, 2020-06-03 09:13:54 -0700, kshitij12345, 9, 1, 10, LINK), (884e16b41af144df171b6982fa4e31c7973b3fa1, 2020-06-03 09:13:54 -0700, kshitij12345, 9, 1, 10, LINK)"
39308,1,45,19,64,"(eba35025e073187440ce7bd4b1d2d6842c07e78c, 2020-08-07 11:19:27 -0700, Meghan Lele, 45, 19, 64, LINK)"
39327,1,5,0,5,"(e6d86036e22c9772bae5191a1d62e505a1b7cbd4, 2020-06-01 16:59:42 -0700, peter, 5, 0, 5, LINK)"
39394,1,4,4,8,"(d2e16dd888a9b5fd55bd475d4fcffb70f388d4f0, 2020-06-29 10:57:08 -0700, peter, 4, 4, 8, LINK)"
39449,1,238,224,462,"(c22bbb212436c3ac44dbc68d0d25da64c6572057, 2020-06-10 11:59:01 -0700, Yanan Cao, 238, 224, 462, LINK)"
39450,1,10,2,12,"(49b69b2adeb230a15ed27ee2d25bb44835769681, 2020-06-04 12:13:33 -0700, Elias Ellison, 10, 2, 12, LINK)"
39471,3,146,76,222,"(ccea3726da3aca338eb7753e84ba370a13148855, 2020-06-18 20:17:48 -0700, Pavel Belevich, 54, 25, 79, LINK), (d4faf14cb25601511e39be6c10743021d2b4bed6, 2020-06-15 20:03:51 -0700, Pavel Belevich, 53, 26, 79, LINK), (4c4b9916ef806b69413365c7c406cb2a375680bc, 2020-06-10 21:01:58 -0700, Pavel Belevich, 39, 25, 64, LINK)"
39541,1,52,9,61,"(7bf1dd582ac0d66364a409deb2d0b939889c2ec9, 2020-06-22 20:46:14 -0700, Vitaly Fedyunin, 52, 9, 61, LINK)"
39556,1,32,43,75,"(51e341df4fda6b9b1d7ca101394eb447dcf327a3, 2020-06-15 14:09:57 -0700, Xiong Wei, 32, 43, 75, LINK)"
39557,1,26,30,56,"(d04a3fcc423a846d77c020b4bb46c4f8dae65df2, 2020-06-10 12:38:57 -0700, xueht-fnst, 26, 30, 56, LINK)"
39558,2,2,1,3,"(12cf8390e613be208a888f6b4fad981ccd6b6213, 2020-06-16 09:20:58 -0700, wangxiyuan, 1, 1, 2, LINK), (f1e6e56641dbd0db1ed5a80608844ac77803c49e, 2020-06-09 14:00:41 -0700, wangxiyuan, 1, 0, 1, LINK)"
39566,1,36,13,49,"(916235284cd78472cf799e5ce5940fe6bc6f1b3d, 2020-08-11 08:50:27 -0700, Gao Xiang, 36, 13, 49, LINK)"
39572,1,51,11,62,"(c8c53c802e3ee7c1b39d8d8ca45a2e502b08c465, 2020-06-15 06:59:33 -0700, ShawnZhong, 51, 11, 62, LINK)"
39600,1,41,1,42,"(0b9717b86a70b4a0a7a7b728d7f651ed2c149fde, 2020-07-06 07:54:18 -0700, Wojciech Baranowski, 41, 1, 42, LINK)"
39618,1,69,20,89,"(f13be5fde120d0266a6af143544f2c665a0e5e78, 2020-06-15 19:55:27 -0700, Pavel Belevich, 69, 20, 89, LINK)"
39620,1,15,6,21,"(3413f0a8caa41ff9b667e3c0c30ee0f77bf39325, 2020-06-09 11:25:10 -0700, peter, 15, 6, 21, LINK)"
39626,2,8,24,32,"(ee2bc13f446ea817b97a9022edc7c112a65cf079, 2020-06-07 17:03:49 -0700, peter, 4, 16, 20, LINK), (f2af07d7f6ca775baf3abfb058cc5bb4aac7cc3a, 2020-06-06 10:10:18 -0700, peter, 4, 8, 12, LINK)"
3966,1,46,0,46,"(b79d74aa812cf5a3370ab09e20704453b070cb0e, 2017-12-18 01:51:27 -0500, Sam Gross, 46, 0, 46, LINK)"
39708,1,35,9,44,"(6ebc0504cabf6d2f20f2a836c0d59eb000d10537, 2020-08-07 13:07:28 -0700, Darius Tan, 35, 9, 44, LINK)"
39734,1,9,0,9,"(b5848833f05cfd68770daed0fb6a71a01a206873, 2020-06-11 15:24:37 -0700, peter, 9, 0, 9, LINK)"
39810,1,5,5,10,"(4c7fb8c2b6b0078b36ee59d7c01065deb719254d, 2020-07-28 14:57:17 -0700, Will Constable, 5, 5, 10, LINK)"
39846,1,52,116,168,"(1670ea947411001160094ba9397b8e1091a5188e, 2020-06-17 16:15:31 -0700, Xiao Wang, 52, 116, 168, LINK)"
399,1,16,6,22,"(3adcb2c157ed7df5aaff9b59d4526aa24ec770db, 2016-12-14 00:25:05 +0100, Adam Paszke, 16, 6, 22, LINK)"
39968,1,4,0,4,"(ee74c2e5bec8beacbf1ec87f10fe4e726a920c26, 2020-08-18 09:46:42 -0700, Xiang Gao, 4, 0, 4, LINK)"
39971,1,304,126,430,"(27ab9bc0f9b72dcf2eacd5baa35930f87c9fd60a, 2020-09-25 13:17:24 -0700, Rohan Varma, 304, 126, 430, LINK)"
39989,1,3,0,3,"(905c6730b77704ef3ef47072a2660c81eba1c97c, 2020-06-13 12:14:41 -0700, peter, 3, 0, 3, LINK)"
40018,1,242,0,242,"(200c34318454d47da316f7b0d14248efe1a0e387, 2020-07-15 20:54:53 -0700, Aayush Naik, 242, 0, 242, LINK)"
40023,1,12,13,25,"(0b73ea0ea269071ee4dfaf1ca5269b959b914d21, 2020-07-14 20:32:24 -0700, Kurt Mohler, 12, 13, 25, LINK)"
40032,1,6,3,9,"(b7517a76ba797a5582afc4f9a8c8c58aa58e0ff2, 2020-07-02 15:11:36 -0700, Xiao Wang, 6, 3, 9, LINK)"
40067,7,1454,32,1486,"(4972cf06a275dede69427420d2a11b3c5b98ea4e, 2020-07-14 10:53:58 -0700, Meghan Lele, 366, 1, 367, LINK), (aa87e1e3028d8f369ce8824c3e8570cebf9d6da3, 2020-07-08 14:26:18 -0700, Meghan Lele, 366, 1, 367, LINK), (e2a291b396be8db6f9ac1fc7d45e97c6026df590, 2020-07-07 20:53:22 -0700, Meghan Lele, 366, 1, 367, LINK), (5a4c45f8d1fdf29bc983302910523fa7651fd725, 2020-07-07 20:53:22 -0700, Meghan Lele, 12, 15, 27, LINK), (fb47e52fb15f9093e96236dfa9ca8a5a319b4858, 2020-06-30 19:26:47 -0700, Meghan Lele, 1, 1, 2, LINK), (4760b0f82104a3d6e093d50d1874895a8fe2335d, 2020-06-30 17:29:06 -0700, Meghan Lele, 341, 3, 344, LINK), (ed7c88e643f4c7bb0f810da9ce8e3ea850c83041, 2020-06-30 17:28:33 -0700, Meghan Lele, 2, 10, 12, LINK)"
40069,4,1285,891,2176,"(ce3ba3b9bc068d3a4cd366155659f9933bd84263, 2020-07-10 16:33:15 -0700, Meghan Lele, 321, 224, 545, LINK), (1b393f6ff1994c7a961d090ad0db9e6a7baeb8a0, 2020-07-08 14:21:53 -0700, Meghan Lele, 320, 224, 544, LINK), (6777ea19fe5947b88c239b5d02c0f2441a21a4ce, 2020-07-07 20:53:22 -0700, Meghan Lele, 320, 224, 544, LINK), (346684940d557230cd48fdaec8ed6976ee50754c, 2020-06-30 17:28:49 -0700, Meghan Lele, 324, 219, 543, LINK)"
40072,2,384,498,882,"(3e01931e497bf42fb1024f0d750983cc55f1a3f2, 2020-07-07 20:53:22 -0700, Meghan Lele, 192, 249, 441, LINK), (cfc5a6dfd0e86f57e515961e10f3b3cde8d62d4f, 2020-06-30 17:26:03 -0700, Meghan Lele, 192, 249, 441, LINK)"
40119,1,21,21,42,"(db5b27396170abd40f184474f3b87de8dc6e1523, 2020-06-22 08:53:20 -0700, guol-fnst, 21, 21, 42, LINK)"
40120,1,44,41,85,"(bc9e8af21875dafafe9bbd25c8f542b20b2e660f, 2020-06-17 14:59:08 -0700, Shihao Xu, 44, 41, 85, LINK)"
40131,1,35,32,67,"(20f3051f7d6aa85a778c5f1a8b88ffb706da01ca, 2020-07-14 21:49:43 -0700, Wojciech Baranowski, 35, 32, 67, LINK)"
40223,1,7,3,10,"(ed83b9a4bedae9379c63e6588c92d6bc26d75a42, 2020-06-29 13:47:05 -0700, Ho Young Jhoo, 7, 3, 10, LINK)"
40244,1,463,163,626,"(c314e0deb56a549f217a6b407e8efdef4c599751, 2020-06-23 18:10:31 -0700, Zafar, 463, 163, 626, LINK)"
40259,1,113,37,150,"(87d7c362b1617d5a7ab72c3c27b4bb11e3371145, 2020-08-27 15:31:12 -0700, Meghan Lele, 113, 37, 150, LINK)"
40292,1,3,2,5,"(e762ce8ecff39ac2bfae6526e42118e126888548, 2020-06-30 13:59:56 -0700, Pritam Damania, 3, 2, 5, LINK)"
40304,1,77,3,80,"(3b7df2388e63a193bb8129c0acab222d4a9c8e7b, 2020-07-03 15:15:00 -0700, Rohan Varma, 77, 3, 80, LINK)"
40337,1,18,12,30,"(ac8c3c0ad11beba80fe02d2a988a15e3b4dcf361, 2020-06-20 15:06:23 -0700, peter, 18, 12, 30, LINK)"
40350,2,36,28,64,"(1c098ae339b1bea8020c0be094e89947da93f752, 2020-07-10 20:01:33 -0700, Jannik Bamberger, 7, 6, 13, LINK), (39d037253c59ce5be464b6c4ab67f07dd020987c, 2020-06-01 11:03:41 -0700, Nikita Shulga, 29, 22, 51, REGEX)"
40362,1,73,13,86,"(2bc6caa9e4d653ecd9c8258f0bf192c0f25ccff0, 2020-10-14 14:58:43 -0700, Aiden Nibali, 73, 13, 86, LINK)"
40366,1,1,1,2,"(37c88a4731952dcdb3a0501fe578ef306fb03e72, 2020-06-22 06:31:46 -0700, peter, 1, 1, 2, LINK)"
40378,1,32,9,41,"(a2b4177c5b9a4778a77fcee52857e8f152ded111, 2020-09-25 15:45:07 -0700, Pritam Damania, 32, 9, 41, LINK)"
40393,1,4,4,8,"(d2e16dd888a9b5fd55bd475d4fcffb70f388d4f0, 2020-06-29 10:57:08 -0700, peter, 4, 4, 8, LINK)"
40397,1,15,0,15,"(e180ca652f8a38c479a3eff1080efe69cbc11621, 2020-06-25 14:02:24 -0700, Diego M. Rodriguez, 15, 0, 15, LINK)"
40434,1,32,9,41,"(a2b4177c5b9a4778a77fcee52857e8f152ded111, 2020-09-25 15:45:07 -0700, Pritam Damania, 32, 9, 41, LINK)"
4048,1,423,4,427,"(97008a64a1d008ea0eb1715afeadbcc0538f4c1c, 2018-07-15 17:37:18 -0700, Karan Dwivedi, 423, 4, 427, LINK)"
4049,1,395,255,650,"(3ada2e0d64b40622e823b8135d2bbbc74e6526b9, 2020-01-23 21:28:03 -0800, Jianyu Huang, 395, 255, 650, LINK)"
40529,1,69,39,108,"(179dbd4f25288a098099e806b16098468e6f0b2f, 2020-06-30 16:48:38 -0700, Michael Suo, 69, 39, 108, LINK)"
40580,1,71,42,113,"(344defc9733a45fee8d0c4d3f5530f631e823196, 2020-07-30 12:11:03 -0700, Hong Xu, 71, 42, 113, LINK)"
40603,1,439,210,649,"(8ecd4f36aab89df38500e72458af5e05e7f12a78, 2020-07-04 15:43:52 -0700, Will Constable, 439, 210, 649, LINK)"
40658,1,13,1,14,"(0790d11a18d6ca4f8278a8cefe78fc69633b7f5a, 2020-07-04 11:57:04 -0700, Tongzhou Wang, 13, 1, 14, LINK)"
4066,1,6,44,50,"(9ea576d06839b7c888865921c2bd66db1fbc3648, 2017-12-07 16:37:17 -0500, Sam Gross, 6, 44, 50, LINK)"
40690,1,477,2,479,"(233e4ebdb60c8353dab765986d87a45e4213e640, 2021-01-26 07:50:19 -0800, Emilio Castillo, 477, 2, 479, LINK)"
40713,1,5,2,7,"(cb9029df9db397f66da234d21b5ddafd6be6e602, 2020-07-17 07:20:36 -0700, Will Constable, 5, 2, 7, LINK)"
40744,1,2,2,4,"(063d5b0d3f8e47b9930e1f387d0fbbf0be175e8d, 2020-07-06 07:46:49 -0700, X Wang, 2, 2, 4, LINK)"
40771,1,14,1,15,"(e44f4600792a3d2fba33f7cbf9d72a566bbbe799, 2020-07-15 20:11:36 -0700, Cloud Han, 14, 1, 15, LINK)"
40784,1,4,4,8,"(63ef706979c3f22f95d68e3dfc77ca6968ff41d8, 2020-07-06 19:56:44 -0700, Nikita Shulga, 4, 4, 8, LINK)"
40803,1,4,2,6,"(af34f2f63b1c5a86ce82046001a0048d7576f03a, 2020-07-01 16:02:59 -0700, Sanjeev Kumar, 4, 2, 6, LINK)"
40829,2,732,45,777,"(a2ae2d32034cff6d68a724d317898568a8bd66d3, 2020-08-20 08:32:35 -0700, Anthony Scopatz, 141, 45, 186, LINK), (21823aa6808227bd97438c7e9e3256fb301a91ab, 2020-08-13 20:04:37 -0700, Anthony Scopatz, 591, 0, 591, LINK)"
40838,2,2,2,4,"(40bf15a8ac64f45f3474cfb54a7542f6c66926dd, 2020-07-09 13:41:15 -0700, Nikita Shulga, 1, 1, 2, LINK), (3e26709a4e263667f6a8a2973c726ee5137f4996, 2020-07-09 08:03:45 -0700, anjali411, 1, 1, 2, LINK)"
40861,1,4,2,6,"(404799d43f8ba371d469ae4d1ec4ffb371cf2e1b, 2020-07-15 19:38:06 -0700, peter, 4, 2, 6, LINK)"
40869,1,63,5,68,"(f3ad7b2919180e83972cb89be3141c70049a8eeb, 2020-11-06 01:06:48 -0800, Elias Ellison, 63, 5, 68, LINK)"
40986,1,15,1,16,"(2912390662c3c50732add54c94ac9b98d17e1cba, 2020-08-01 02:02:49 -0700, Mike Ruberry, 15, 1, 16, LINK)"
40998,2,1386,1782,3168,"(05207b7371bbaa072c2d8f3469984312b21d50ca, 2020-07-14 14:46:41 -0700, Eli Uriegas, 1384, 1782, 3166, LINK), (450ba4965376792a1622f9e6a661c9034abbb6e9, 2020-07-06 07:00:35 -0700, peter, 2, 0, 2, LINK)"
41,3,436,211,647,"(b90cbb841d98aeae435b1d02b1ff211e028cdf5b, 2019-04-05 12:44:49 -0700, Joakim Rishaug, 1, 1, 2, LINK), (4a1bbc01ac71e7410ddcca9a947964a6819b4bdb, 2017-08-03 09:08:06 -0700, Edward Z. Yang, 85, 5, 90, LINK), (66de96588216b945fc475f52e353cdf915d2c52f, 2016-12-19 20:46:55 +0100, Mateusz Piotrowski, 350, 205, 555, LINK)"
4103,1,10,1,11,"(2e08885df8b1a2c958f4c742867541bd138e0455, 2017-12-16 08:09:08 -0600, avmgithub, 10, 1, 11, LINK)"
41047,2,52,26,78,"(8f4d01d9f106d6af07c88d5823a4db6477ba5914, 2020-07-08 22:06:48 -0700, Mike Ruberry, 26, 13, 39, LINK), (351407dd752344730f82b8a983bb10e96affc97f, 2020-07-08 11:46:20 -0700, Mike Ruberry, 26, 13, 39, LINK)"
41095,1,1,50,51,"(07d07e3c6c19f1cddb08af2158f5727e794fa271, 2020-09-16 11:30:11 -0700, Yanan Cao, 1, 50, 51, LINK)"
411,1,7,1,8,"(8c14630e35675d1c55d893bf5e49234061235adb, 2017-01-13 00:51:18 -0500, Sam Gross, 7, 1, 8, LINK)"
41143,1,12,2,14,"(45e6f2d60012df37393f5c5153e805209713ef19, 2020-07-24 17:42:04 -0700, Nikita Shulga, 12, 2, 14, LINK)"
4119,1,0,4,4,"(3657df383669a651a2d7717f93e59fbd9a8458c4, 2019-11-08 16:45:51 -0800, Michael Suo, 0, 4, 4, LINK)"
41192,1,70,8,78,"(de400fa5acb4ba2fd045d504391a4aaecfb8c65e, 2020-07-20 11:59:08 -0700, Elias Ellison, 70, 8, 78, LINK)"
41238,1,2,2,4,"(8397a62a64e86e16e39e0cb33ef03d0bc4075219, 2020-12-14 08:47:24 -0800, Nikita Shulga, 2, 2, 4, LINK)"
4126,1,6,0,6,"(2030ac7545b29a684a88b6f1b5fc70c2eb3bb036, 2018-03-23 14:57:29 +0100, Katrin Leinweber, 6, 0, 6, LINK)"
41261,1,10,0,10,"(f2e5ae4ba22b930b64889be3e7f763841f179e15, 2020-10-14 07:50:22 -0700, Alexander Grund, 10, 0, 10, LINK)"
41288,1,9,1,10,"(174cbff00a2580fc17a126c1fb819377d0038094, 2020-09-18 10:58:32 -0700, Yanan Cao, 9, 1, 10, LINK)"
41314,1,174,153,327,"(c8bc298d6c7850a1b33416eea56e4fc365d6af9a, 2020-08-20 10:48:26 -0700, Natalia Gimelshein, 174, 153, 327, LINK)"
41324,1,53,8,61,"(d850b5c98ca166e899933b481e622a05e082d0f8, 2020-10-29 12:20:49 -0700, Rohan Varma, 53, 8, 61, LINK)"
41332,1,28,1,29,"(825a387ea20e409b4f7945426b14cb86b48d50d0, 2020-07-22 00:16:44 -0700, Vinnam Kim, 28, 1, 29, LINK)"
41340,1,28,42,70,"(aef2890a75a8a6c59b3e7692b2321eaca9dc5d9b, 2020-08-17 20:03:29 -0700, Xiang Gao, 28, 42, 70, LINK)"
41389,1,15,1,16,"(1f6d0985d79919f343c91b2f952c0b8fe72964a6, 2020-08-14 12:33:00 -0700, albanD, 15, 1, 16, LINK)"
41393,1,37,30,67,"(86492410bca0093718314645a487d3af323f976c, 2020-07-28 08:12:41 -0700, Alexander Grund, 37, 30, 67, LINK)"
41394,1,20,14,34,"(a7cf04ec40e487286ad3f8068fa18321f3474dd2, 2021-01-25 13:32:12 -0800, Heitor Schueroff, 20, 14, 34, LINK)"
41402,1,3,3,6,"(fef30220fdfe24f9f5f82ddacf6420a824b2c143, 2020-07-16 10:37:58 -0700, Mike Ruberry, 3, 3, 6, LINK)"
41432,5,453,28,481,"(f9d32c4fa8f5990ac09ba0f9a1298d0348433179, 2020-10-30 00:36:13 -0700, Meghan Lele, 353, 8, 361, LINK), (7ac872b9347db7af0265b16d2e49110e1479bde3, 2020-09-28 17:15:06 -0700, Meghan Lele, 8, 6, 14, LINK), (0322525e7370257347372b5a7252d727d0f3984a, 2020-07-23 15:48:18 -0700, Meghan Lele, 76, 2, 78, LINK), (5e89c4faefa86a1dcf5b858e8855442d7a0f52ba, 2020-07-23 15:48:17 -0700, Meghan Lele, 8, 6, 14, LINK), (9097f17236f27da89b20df92c0e7f06b0cc7cc5e, 2020-07-15 17:07:51 -0700, Meghan Lele, 8, 6, 14, LINK)"
41449,1,20,0,20,"(cd756ee3d44858500c7de87df33cda930f195be6, 2020-08-11 21:36:05 -0700, Alex Şuhan, 20, 0, 20, LINK)"
41471,1,4,2,6,"(404799d43f8ba371d469ae4d1ec4ffb371cf2e1b, 2020-07-15 19:38:06 -0700, peter, 4, 2, 6, LINK)"
41473,1,196,122,318,"(7a5708832f10dd6b5925d434663e7f57758d1aa9, 2020-08-03 18:41:57 -0700, Natalia Gimelshein, 196, 122, 318, LINK)"
41474,1,4,0,4,"(fced54aa679afeac0159ca75b40d69d79f2e47fc, 2020-07-22 06:30:17 -0700, Luca Wehrstedt, 4, 0, 4, LINK)"
41489,1,42675,1350,44025,"(449098c2d2459cb4c1e3546a024d417ae74fb236, 2021-02-01 08:41:53 -0800, Max Balandat, 42675, 1350, 44025, LINK)"
415,3,587,8,595,"(6ee77b4edd1552d3a9a2e5389ffc351e513a8089, 2017-01-27 13:30:25 -0500, Will Frey, 563, 0, 563, LINK), (4e3db462eddfc6dbe2e1700d003e14769f93b5fa, 2016-05-27 10:32:57 -0700, Boris Fomitchev, 12, 4, 16, LINK), (429c7a03cbabb072bdb2008b779d2e4e1ba878bd, 2016-05-27 10:32:57 -0700, Boris Fomitchev, 12, 4, 16, LINK)"
41510,1,136,82,218,"(7d809f5d8e93cb6d332297ece071083845e30e26, 2020-10-02 13:08:49 -0700, anjali411, 136, 82, 218, LINK)"
4157,2,24,18,42,"(8a9f570eb182d1cb946dcc13898b8ec782407f21, 2017-12-14 11:28:59 -0500, Richard Zou, 12, 9, 21, LINK), (dac5e6568d7cc8b62be37d94fd9556c04b61c75e, 2017-12-14 11:28:59 -0500, Richard Zou, 12, 9, 21, LINK)"
41656,1,852,325,1177,"(33519e19abfe99747ee654df61b83d3c82f03c27, 2020-08-06 16:06:38 -0700, Peter Bell, 852, 325, 1177, LINK)"
41680,1,8,2,10,"(55d2a732cdeba8e89de839381ccc3833acb23767, 2020-08-03 21:40:58 -0700, Nikita Shulga, 8, 2, 10, LINK)"
4176,2,106,16,122,"(bb60c978057ac4dd07960f03d572db0480163443, 2018-07-20 08:36:11 -0700, Tongzhou Wang, 53, 8, 61, LINK), (2a0018f2a80d98853c0733107650255929eb9d40, 2018-07-20 08:36:11 -0700, Tongzhou Wang, 53, 8, 61, LINK)"
41767,1,22,6,28,"(b0424a895c878cb865947164cb0ce9ce3c2e73ef, 2020-07-28 11:04:27 -0700, X Wang, 22, 6, 28, LINK)"
41768,1,4,3,7,"(2249a293b73e1c5c9408c249d4e256f37b90f4ef, 2020-10-29 10:32:08 -0700, Sameer Deshmukh, 4, 3, 7, LINK)"
4177,1,56,10,66,"(425ea6b31e433eaf1e4aa874332c1d6176cc6a8a, 2018-09-05 17:25:07 -0700, Wei Yang, 56, 10, 66, LINK)"
41770,1,34,12,46,"(91546a4b0f4b439bab9b01f53fd84858713babc4, 2020-07-29 11:12:31 -0700, Bert Maher, 34, 12, 46, LINK)"
41776,1,25,4,29,"(2c8cbd78bd779dcfee373d4ac26df1ba9629cb14, 2020-08-11 10:16:09 -0700, Kurt Mohler, 25, 4, 29, LINK)"
41779,1,34,23,57,"(ca880d77b81f5318d3941266a870a982d04b1db5, 2020-11-20 10:19:53 -0800, Jeffrey Wan, 34, 23, 57, LINK)"
41780,1,13,0,13,"(42b4a7132e7c6f1df963b473d1583e4791fb1808, 2020-08-11 08:24:49 -0700, Kurt Mohler, 13, 0, 13, LINK)"
41857,1,32,5,37,"(129f4060622225d09c69da3b6b04e1a371778a43, 2020-09-02 17:04:28 -0700, anjali411, 32, 5, 37, LINK)"
41882,1,185,5,190,"(a9e7e787f8108ff2b08deb435fe4da91833e67f2, 2020-07-31 10:21:43 -0700, Wanchao Liang, 185, 5, 190, LINK)"
41886,1,7,2,9,"(e59db43313e4a999875986f0edf880e805c0eff8, 2020-07-27 13:44:40 -0700, acxz, 7, 2, 9, LINK)"
41922,1,11,11,22,"(a4b831a86abf3d45096ca904a5250c349ea3033a, 2020-07-23 15:47:10 -0700, Alexander Grund, 11, 11, 22, LINK)"
41951,1,44,14,58,"(5246bc4e87ecfb7a7bc424888aba6e7c191857d5, 2020-07-27 13:56:21 -0700, lixinyu, 44, 14, 58, LINK)"
41962,1,41,4,45,"(00c1501bc0eb88a2778b41ddc1b8f08e2c1062f9, 2020-08-26 18:22:47 -0700, Meghan Lele, 41, 4, 45, LINK)"
41966,1,18,0,18,"(24eea364f761bc841cb3f3890d1ce0200571856e, 2020-09-01 14:20:56 -0700, Randall Hunt, 18, 0, 18, LINK)"
41998,1,118,14,132,"(c7787f7fbf388f9fe326d581726e7ef3f2dce74b, 2020-08-28 06:40:53 -0700, kshitij12345, 118, 14, 132, LINK)"
42,2,1492,812,2304,"(b90cbb841d98aeae435b1d02b1ff211e028cdf5b, 2019-04-05 12:44:49 -0700, Joakim Rishaug, 1, 1, 2, LINK), (76520512e7e267dfeb610cfcc3d5ce2f50c3c351, 2016-12-19 20:49:43 +0100, Janusz Marcinkiewicz, 1491, 811, 2302, LINK)"
42062,1,17,7,24,"(c8a42c32a163f219e16638ff07cd58bb0bf2faac, 2020-11-09 21:02:57 -0800, Pearu Peterson, 17, 7, 24, LINK)"
42073,1,13,3,16,"(fbdaa555a2f287430da536e3e5bf42a1dd2a7d7c, 2020-07-27 10:20:07 -0700, Nikita Shulga, 13, 3, 16, LINK)"
42115,1,11,8,19,"(1eed54d17a8ae686c79ce716db35bc6ead97c4cd, 2020-12-03 11:40:09 -0800, pinzhenx, 11, 8, 19, LINK)"
42125,1,30,13,43,"(8fab33f9422011391f63664656f3afbae84cd5e7, 2021-02-09 13:20:48 -0800, Antonio Cuni, 30, 13, 43, LINK)"
42153,1,22,1,23,"(059aa34b124916dfd761f3cbdb5fa97d7a01fc93, 2020-08-14 11:59:29 -0700, mattip, 22, 1, 23, LINK)"
4219,1,323,20,343,"(444039c47bb997f698c2bd9481c8649188038c51, 2019-02-19 08:17:49 -0800, Iurii Zdebskyi, 323, 20, 343, LINK)"
42239,1,39,12,51,"(51bab0877d89c20f052a0bd68c54319f7601e1fb, 2020-08-20 14:49:00 -0700, Ailing Zhang, 39, 12, 51, LINK)"
42242,1,2,0,2,"(832b1659e78b146e75446d9afd168781dde3e9ea, 2020-07-31 08:54:28 -0700, Sharvil Nanavati, 2, 0, 2, LINK)"
42271,1,2,2,4,"(87061875239d0694779255b55e50250b272169ff, 2021-01-07 11:37:09 -0800, TomHeaven, 2, 2, 4, LINK)"
42281,2,18,7,25,"(d21e345ef0f306ffe15bcd733466b323b538b9b3, 2020-08-04 08:03:36 -0700, Nikita Shulga, 11, 5, 16, LINK), (d3acfe3ba8c74cd040fb6ea68228ae5ba00750d6, 2020-08-03 16:26:25 -0700, Nikita Shulga, 7, 2, 9, LINK)"
42292,1,15,3,18,"(9ca338a9d44b6b9603cddbb2c35f7d484d8d39fd, 2020-08-26 16:49:30 -0700, shubhambhokare1, 15, 3, 18, LINK)"
42305,1,7,6,13,"(ddb8849ffc627531b8d88cf5c22bb7bb1a2ff5a0, 2020-08-05 19:55:34 -0700, Max Berrendorf, 7, 6, 13, LINK)"
42363,1,35,2,37,"(ec898b1ab5adf4b8c9da039444e9ffb2d49a7ac1, 2020-08-04 10:07:43 -0700, Natalia Gimelshein, 35, 2, 37, LINK)"
42364,1,83,44,127,"(7f3f5020e6d930792c3db6b6604de74bb58aa291, 2020-08-12 13:04:38 -0700, Xiang Gao, 83, 44, 127, LINK)"
42375,1,18,1,19,"(317b9d3bfcd87113386bf7e3d4db588d2a548544, 2020-08-04 15:24:14 -0700, Yanan Cao, 18, 1, 19, LINK)"
42406,1,3,8,11,"(c8cb5e5bcb5bec4d783f825002aeb45289440448, 2020-08-03 19:55:42 -0700, Xiao Wang, 3, 8, 11, LINK)"
42418,1,32,8,40,"(b9e68e03c4f16c61886451c37f8051a84a0b9dce, 2020-08-04 16:08:25 -0700, Ivan Yashchuk, 32, 8, 40, LINK)"
42435,1,2,0,2,"(7221a3d1aaa40eda0511f7f103bff67782313cf7, 2020-08-05 12:31:20 -0700, Vincent Quenneville-Belair, 2, 0, 2, LINK)"
42446,1,1,1,2,"(72b5665c4fc257a9e5cdef4df65f61c93ce4e69a, 2020-09-15 09:25:05 -0700, pinzhenx, 1, 1, 2, LINK)"
42448,1,1,1,2,"(29700c009280ce63c113ad7300171af4cee26174, 2020-08-04 16:55:34 -0700, Meghan Lele, 1, 1, 2, LINK)"
42467,1,2,2,4,"(47e1b7a8f1dff6eee56fec890d64380aa6925bf1, 2020-08-22 03:21:47 -0700, Yi Zhang, 2, 2, 4, LINK)"
42517,6,218,159,377,"(281463ba0b27480e62d2aa0d54a7510ef0397792, 2020-10-09 14:57:40 -0700, Mingzhe Li, 34, 44, 78, LINK), (8cd3857bc7c57bd412941812f40fdb3a9dc6dd45, 2020-10-08 19:17:10 -0700, Mingzhe Li, 64, 15, 79, LINK), (c19b9cd18dd1da5f499ef0672e6871928618204d, 2020-10-07 23:54:48 -0700, Nikita Shulga, 51, 36, 87, LINK), (2421c30b3819f94acc133bee008afdf6062aff5f, 2020-10-07 14:07:15 -0700, mingzhe0908, 18, 28, 46, LINK), (ba8c2b4bf0699d9c32a35f21e39188349e87a716, 2020-10-07 14:07:12 -0700, mingzhe0908, 0, 0, 0, LINK), (d19ab8ce460e2871f126db6de987b825ce6cd2a4, 2020-10-07 14:07:12 -0700, mingzhe0908, 51, 36, 87, LINK)"
42562,1,156,2,158,"(e045119956aa8ed07e293714fd674bcff6251d69, 2020-09-22 18:35:55 -0700, Meghan Lele, 156, 2, 158, LINK)"
42578,1,4,1,5,"(c14a7f6808031a44f79bbf7c303e8b2951d05b2c, 2020-08-10 19:24:27 -0700, Nikita Shulga, 4, 1, 5, LINK)"
42588,1,35,26,61,"(534c82153e64d2a2960aadb93b6d1d570fa04faf, 2021-01-17 21:07:32 -0800, Natalia Gimelshein, 35, 26, 61, LINK)"
42605,1,82,13,95,"(2a87742ffa5c4511e5cc071087b0407c54d56590, 2020-09-09 09:40:45 -0700, Michael Carilli, 82, 13, 95, LINK)"
42609,1,42,2,44,"(1f689b6ef9acc4e3ee09b812ec1301a5ca3d8ece, 2020-08-06 13:13:37 -0700, Basil Hosmer, 42, 2, 44, LINK)"
42616,1,18,2,20,"(3cf2551f2fc8c4d9b53e249d91d40944e1ec8f1c, 2020-08-10 16:18:30 -0700, Nikita Shulga, 18, 2, 20, LINK)"
42657,1,4,4,8,"(dcee8933fbded09397e17e8b99610e32d0a405fe, 2020-08-07 10:19:41 -0700, Nikita Shulga, 4, 4, 8, LINK)"
42660,24,734,587,1321,"(60fea510a1c6688367961e9f29c9d97932dcc19b, 2020-11-02 11:40:39 -0800, Brian Hirsh, 145, 61, 206, LINK), (fafb4ef578caf40793cbef9abd8632b8086935a5, 2020-10-27 11:34:22 -0700, Brian Hirsh, 0, 1, 1, LINK), (9ba26733eee1adaf1f4ccad7972fd7e3f26e0b20, 2020-10-26 12:48:17 -0700, Brian Hirsh, 12, 4, 16, LINK), (4c843ef8aea72b3ea6bdb48da7aa9039b3b3ae6c, 2020-10-26 11:18:34 -0700, Brian Hirsh, 52, 59, 111, LINK), (97ededbbb61ad46c33791bef82c067fcdd0033f5, 2020-10-26 08:19:35 -0700, Brian Hirsh, 34, 13, 47, LINK), (6a99d423c46960608f41de2a936ee4ae76f87859, 2020-10-26 07:23:51 -0700, Brian Hirsh, 0, 2, 2, LINK), (e739d1547382ca624cfac25d9000855409b68cb9, 2020-10-26 07:22:05 -0700, Brian Hirsh, 3, 1, 4, LINK), (8c455121166228e6613bcd92688b705024de6128, 2020-10-26 07:11:22 -0700, Brian Hirsh, 47, 54, 101, LINK), (e008f5fbefb94af255717eadea133fa160a182c2, 2020-10-26 07:01:44 -0700, Brian Hirsh, 1, 3, 4, LINK), (224f05da9b9d6d5744f021acee39b1479e0b1515, 2020-10-26 06:59:32 -0700, Brian Hirsh, 37, 32, 69, LINK), (5d36a12df31f8652c456529cecadce8235162a9d, 2020-10-26 06:09:56 -0700, Brian Hirsh, 2, 5, 7, LINK), (534468d48e0fbc78667de82209f8e8b18cfdfed0, 2020-10-26 05:49:53 -0700, Brian Hirsh, 215, 75, 290, LINK), (779ccccd0b9051223f7ccf9691b3e5f21cb3bbf5, 2020-10-25 11:33:17 -0700, Brian Hirsh, 1, 1, 2, LINK), (c33d4e70b769deda0348d1b2da0357dc400999f3, 2020-10-25 10:28:03 -0700, Brian Hirsh, 1, 1, 2, LINK), (350b00bbedccc77b005aec5d75a5d9501aa227d8, 2020-10-25 10:25:50 -0700, Brian Hirsh, 2, 4, 6, LINK), (4e08464a6bd9dfde02342b2431128c9ba018db6a, 2020-10-25 10:18:38 -0700, Brian Hirsh, 18, 50, 68, LINK), (0844a9f565a761cf6a9fa75bb03e207af4bf9b60, 2020-10-25 05:11:18 -0700, Brian Hirsh, 60, 121, 181, LINK), (3de42248e0df3fa858fd2ba82cd4a3d59d9fe934, 2020-10-23 15:16:43 -0700, Brian Hirsh, 13, 24, 37, LINK), (8488813a440a036a57668d8e5c220684570dcbf5, 2020-10-23 12:44:34 -0700, Brian Hirsh, 61, 54, 115, LINK), (3b96993c63b49a6efc6c1b7ca449216342582f28, 2020-10-19 06:29:05 -0700, Brian Hirsh, 3, 2, 5, LINK), (a94049e2355667fe54fe15b87287b4239b5bd8a0, 2020-10-16 12:59:07 -0700, Brian Hirsh, 2, 1, 3, LINK), (0e69aae77bca0817f6342f8149498d61927d31a8, 2020-10-16 12:46:08 -0700, Brian Hirsh, 2, 1, 3, LINK), (32d473b098f737a938433bddfd94af911cd23b83, 2020-10-16 11:33:04 -0700, Brian Hirsh, 21, 16, 37, LINK), (6a3eb531da57ecf1b599cb06f7fe21e4f57bd186, 2020-10-15 09:59:22 -0700, Brian Hirsh, 2, 2, 4, LINK)"
42662,1,3,3,6,"(103887892c276fceed5d36324fb9683ed51aa34a, 2020-08-10 19:37:55 -0700, NTT123, 3, 3, 6, LINK)"
42695,1,4,1,5,"(758c2b96f53a39f484b583987300a308475500da, 2020-09-09 11:34:46 -0700, mattip, 4, 1, 5, LINK)"
42776,2,7,2,9,"(2f9fd8ad29918e8e1d514b38dde27e1cf54d16ad, 2020-08-14 09:23:26 -0700, Nikita Shulga, 1, 2, 3, LINK), (64a7939ee56fdc0a34b3de66aa9e6f3c96ef6860, 2020-08-10 16:52:55 -0700, Nikita Shulga, 6, 0, 6, LINK)"
4284,1,203,481,684,"(5b8fe5cbb5b696d49d1480942f1904f92444857b, 2017-12-21 11:38:31 -0500, Edward Z. Yang, 203, 481, 684, LINK)"
42859,1,5,3,8,"(de672e874d89be7144fc6319fcaf64472e2f6f40, 2020-09-03 11:53:01 -0700, Meghan Lele, 5, 3, 8, LINK)"
42860,1,12,6,18,"(1c616c5ab7160a781e82ea80ce6084f4e1f7f122, 2020-08-14 10:24:22 -0700, Adam Thompson, 12, 6, 18, LINK)"
4288,1,323,20,343,"(444039c47bb997f698c2bd9481c8649188038c51, 2019-02-19 08:17:49 -0800, Iurii Zdebskyi, 323, 20, 343, LINK)"
42908,2,1,1,2,"(ebc7ebc74edcc8e1caf216858f1b4645cff812a9, 2020-08-13 10:27:36 -0700, Nikita Shulga, 0, 1, 1, LINK), (5d2e9b6ed9020668df47b0fbbe4eaea3305d0b3c, 2020-08-12 17:10:58 -0700, Keigo Kawamura, 1, 0, 1, LINK)"
42939,1,74,71,145,"(33aba57e4c872a056251d9d9dc59e930f4097ef1, 2020-09-29 18:04:18 -0700, peter, 74, 71, 145, LINK)"
42952,2,575,90,665,"(4305609d66720f82c855e6003b264584226c7571, 2021-02-17 11:30:16 -0800, Nikita Shulga, 48, 14, 62, LINK), (c64594f5cc7f17f9f0638fe2c2d3d1a583412cec, 2020-08-20 21:59:49 -0700, Mike Ruberry, 527, 76, 603, LINK)"
42955,1,1,1,2,"(75dfa5a45925a2cea27064d3b8461e83c5d096a9, 2020-08-14 11:33:59 -0700, Keigo Kawamura, 1, 1, 2, LINK)"
42967,1,45,33,78,"(49f0e5dfeb64a928c6a2368dd5f86573b07d20fb, 2020-11-16 23:16:02 -0800, Xu Zhao, 45, 33, 78, LINK)"
42973,1,6,3,9,"(89108ba6ea2c085f6bae18efd0654710f229f139, 2020-10-16 15:31:50 -0700, Rong Rong, 6, 3, 9, LINK)"
42977,1,7,8,15,"(d1745c36dc4fd85367297e9eeaaa61fa7ba0f918, 2020-10-15 20:41:22 -0700, Rong Rong, 7, 8, 15, LINK)"
42978,1,2,5,7,"(5855aa8dac7e8804647666782fcf65767309b227, 2020-09-28 16:47:55 -0700, Rong Rong, 2, 5, 7, LINK)"
42979,1,42,27,69,"(146721f1dfe29786f5d25a9e2a2c2227dfa85f76, 2020-10-12 10:23:42 -0700, Xu Zhao, 42, 27, 69, LINK)"
42980,1,3,3,6,"(ecac8294a606acbb6d8c794d4cc74a0e04f88673, 2020-09-14 13:21:39 -0700, Rong Rong, 3, 3, 6, LINK)"
42983,1,63,35,98,"(bea7901e387011248cf00e083af71dd92168c211, 2020-09-24 08:20:06 -0700, Rong Rong, 63, 35, 98, LINK)"
42984,1,66,71,137,"(6753157c5ae7e0616ba4a23f325c46fab5215168, 2020-08-13 15:22:44 -0700, Nikita Shulga, 66, 71, 137, LINK)"
43,3,41,48,89,"(b90cbb841d98aeae435b1d02b1ff211e028cdf5b, 2019-04-05 12:44:49 -0700, Joakim Rishaug, 1, 1, 2, LINK), (e50d59924026abbc2c01d49055bba697ea273898, 2017-06-06 15:10:02 -0700, Pieter Noordhuis, 20, 13, 33, LINK), (10d32fb0b7e1e4686ee4686001b49f1e24fa5349, 2016-12-11 20:18:28 +0100, Janusz Marcinkiewicz, 20, 34, 54, LINK)"
43006,1,18,1,19,"(da4033d32adafd6fe0fa3a3727fcb2b55c19e2e9, 2020-09-23 11:03:53 -0700, Edward Yang, 18, 1, 19, LINK)"
43013,1,9,15,24,"(e107ef5ca2f9c2b7c3c666c06088e7ae35092cec, 2020-09-14 17:50:05 -0700, Guilherme Leobas, 9, 15, 24, LINK)"
43023,1,4,2,6,"(85752b989d9bff4135e0fd6bfc4d5638d041f18b, 2020-08-13 20:21:46 -0700, Jerry Zhang, 4, 2, 6, LINK)"
43029,1,33,47,80,"(c1e6592964261d2856c84e166a0989684f946697, 2020-09-29 18:05:57 -0700, Guilherme Leobas, 33, 47, 80, LINK)"
43057,2,20,20,40,"(e39b43fd765ba08625f57cc09af878fdfb86af7e, 2020-08-18 12:48:07 -0700, Oliver Thomas, 10, 10, 20, LINK), (e39b43fd765ba08625f57cc09af878fdfb86af7e, 2020-08-18 12:48:07 -0700, Oliver Thomas, 10, 10, 20, REGEX)"
43141,1,22,4,26,"(07d9cc80a4eb9b3ca3445bf5f6048d1385e82b38, 2020-09-16 13:48:03 -0700, Ivan Yashchuk, 22, 4, 26, LINK)"
43185,1,48,46,94,"(63a0bb0ab9b5980a028491b3f2e5ed08307560e5, 2020-09-01 10:23:05 -0700, Guilherme Leobas, 48, 46, 94, LINK)"
4320,1,2,2,4,"(ab5cf16b6c6c2c65cfe0823cd3b1f608b05995b2, 2020-09-29 13:45:47 -0700, Randall Hunt, 2, 2, 4, LINK)"
43212,1,8,1,9,"(103b100ddc2d20fa51d9d80f4d339b5e7ffbb55e, 2020-10-14 20:03:37 -0700, guol-fnst, 8, 1, 9, LINK)"
43216,1,3,1,4,"(76894062dca367a7e88f7b6081ece3b5e2b2e3d4, 2020-08-25 10:34:13 -0700, Yi Zhang, 3, 1, 4, LINK)"
43219,1,294,52,346,"(2558e5769de64827487c1647333e01b6266c3231, 2020-09-17 11:18:24 -0700, Yanan Cao, 294, 52, 346, LINK)"
43228,5,36,91,127,"(5579b53a7fe33cb09fd5e8bb19bd7a2c734ed660, 2020-09-11 12:07:54 -0700, Gregory Chanan, 9, 23, 32, LINK), (3de2c0b42f429a40898b84e37babb04ba844f607, 2020-09-11 09:48:41 -0700, Gregory Chanan, 8, 11, 19, LINK), (d07d25a8c5df404259b53e4291c8dcee4a80417b, 2020-09-11 08:47:46 -0700, Gregory Chanan, 19, 35, 54, LINK), (1dcc4fb6b733967d5b70d866029f91ad25894129, 2020-08-31 07:56:39 -0700, Gregory Chanan, 0, 11, 11, LINK), (859dd628ea4edc6aff4e3fb977ca0bd6573bd72e, 2020-08-24 15:17:56 -0700, Gregory Chanan, 0, 11, 11, LINK)"
43265,1,470,0,470,"(c2591464777951d4d0cd20b5f62c8d66d33bb3d8, 2020-09-01 21:18:19 -0700, Sebastian Pop, 470, 0, 470, LINK)"
43273,1,11,1,12,"(7a0f0d24d07e4baaea64bc685b00b5918db90be5, 2020-11-03 16:28:20 -0800, Brian Hirsh, 11, 1, 12, LINK)"
43300,1,111,86,197,"(cf26050e29386b727e8de3132082d12b9bb801fc, 2020-08-26 15:16:44 -0700, Tom Colen, 111, 86, 197, LINK)"
43338,2,15,17,32,"(9a1f2b3617725e1fb10fb89ff1c4d6e14c2ca8a5, 2020-08-20 17:40:53 -0700, Eli Uriegas, 13, 15, 28, LINK), (2b7108a96f3de4f20a18b44f2f64ab0e7ded3ca5, 2020-08-20 15:34:57 -0700, Edward Yang, 2, 2, 4, LINK)"
43344,1,12,5,17,"(98307a282162750aaf66f52f4b6a15fc020c6679, 2020-08-21 19:57:54 -0700, XiaobingSuper, 12, 5, 17, LINK)"
4336,1,21,6,27,"(57f9db9c3c89dcb98e3f65bdc2ac99117e4b932e, 2018-01-02 12:42:40 -0500, Edward Z. Yang, 21, 6, 27, LINK)"
43360,1,57,5,62,"(0b6b7358633dfaa84881ae00608b621e1e35c6fc, 2020-09-23 22:21:23 -0700, kshitij12345, 57, 5, 62, LINK)"
43389,1,4,1,5,"(cfba33bde3d600f1003949dde24edf5430f7418d, 2020-09-14 13:45:58 -0700, mariosasko, 4, 1, 5, LINK)"
434,4,35,1,36,"(e169465672fd59e7675be25e87b0f2b89a5aa276, 2018-04-19 19:54:07 +0200, Marek Šuppa, 4, 0, 4, LINK), (1a5a28dc340b8d88236624c3765437687c184e62, 2017-11-30 17:46:04 +0100, mr.Shu, 4, 0, 4, LINK), (8cb32ba630238f8de15695c9b0492ca02d1a9518, 2017-11-30 17:46:04 +0100, mr.Shu, 4, 0, 4, LINK), (956d946c25ece0051931a023f45d4ee7d39997f1, 2017-01-29 05:38:56 -0600, Hardik Goel, 23, 1, 24, LINK)"
43414,2,179,6,185,"(576880febf2fa3aee714620c5bb105cb0150fec4, 2020-08-31 08:19:38 -0700, mfkasim91, 175, 5, 180, LINK), (8e507ad00ebdfd0ae84bc03718e9c2cb74b8573b, 2020-08-28 07:48:03 -0700, albanD, 4, 1, 5, LINK)"
43431,1,39,25,64,"(cdf5e2ae86b61a02b4cadaec542de3c8e85d472d, 2020-09-11 10:13:43 -0700, Guilherme Leobas, 39, 25, 64, LINK)"
43436,1,5,4,9,"(db78c07cedd1fef8a26000293e688fda7f6a0e54, 2020-08-24 08:17:36 -0700, Nikita Shulga, 5, 4, 9, LINK)"
43442,1,21,6,27,"(0fa99d50bcc2fbe9ebc0babbf8c591fa2c071b01, 2020-08-24 11:44:10 -0700, Nikita Shulga, 21, 6, 27, LINK)"
43455,1,10,6,16,"(1112773cf533a2ab6246fbb4d9a0ee0d0d53d9ea, 2020-12-02 21:40:37 -0800, Tongzhou Wang, 10, 6, 16, LINK)"
43476,1,6,7,13,"(c010ef7f0c6d837809a7e973048afac76373e3de, 2020-09-09 16:14:42 -0700, Rong Rong, 6, 7, 13, LINK)"
435,2,182,12,194,"(920ed4a8cb51e4f026797931360d0afbe245d6fc, 2020-12-03 15:22:38 -0800, jiej, 91, 6, 97, LINK), (23157d0733b4b23e76606b54418a272fb79f534f, 2020-11-10 04:02:59 -0800, jiej, 91, 6, 97, LINK)"
43511,1,307,24,331,"(99093277c0972535d6ecea2ec4eed98c14895f48, 2020-09-17 00:40:00 -0700, Yanan Cao, 307, 24, 331, LINK)"
43513,1,1,1,2,"(455de34cdb5addaa2e11443c7f4ad964040eb8a3, 2020-08-28 17:12:44 -0700, James Reed, 1, 1, 2, LINK)"
43514,1,84,53,137,"(b72da0cf28f4ee6fc9dd701e9914564262294952, 2020-08-28 10:55:27 -0700, XiaobingSuper, 84, 53, 137, LINK)"
43522,1,31,8,39,"(3830998ac387c4ca60d3e5f17077b0116bbbf0c6, 2020-08-27 10:41:26 -0700, Michael Suo, 31, 8, 39, LINK)"
43530,1,36,1,37,"(cb3b8a33f15cb41ca85a3240001033a3e4448575, 2020-09-16 14:35:29 -0700, Meghan Lele, 36, 1, 37, LINK)"
43577,1,10,7,17,"(6befc09465bf3d4d602ff3870ff339fcdf5847b0, 2020-09-16 16:16:05 -0700, Yanan Cao, 10, 7, 17, LINK)"
43580,1,24,1,25,"(caf23d110fa52b2664ed79a4da11cde7b3dddd09, 2020-09-08 12:14:43 -0700, Meghan Lele, 24, 1, 25, LINK)"
43605,1,74,18,92,"(89ac30afb88451efc66ed8077b7bbb222afd3428, 2020-09-09 20:05:01 -0700, Meghan Lele, 74, 18, 92, LINK)"
43607,1,2,2,4,"(c10f30647fadab0239e69c1be7aeb8d07a494903, 2020-09-03 09:11:04 -0700, peter, 2, 2, 4, LINK)"
43699,1,133,39,172,"(24df3b7373a80fbccebfde72f70fdd045ec44430, 2020-09-17 10:17:22 -0700, vfdev, 133, 39, 172, LINK)"
43709,1,1,1,2,"(a5cc151b8cb973a1fcadc44571c1c096d7f3453a, 2020-09-16 10:19:18 -0700, Nikita Shulga, 1, 1, 2, LINK)"
43723,1,29,2,31,"(6dd53fb58da424d83f22d2274af166dda6e8bac3, 2020-09-08 16:05:30 -0700, kshitij12345, 29, 2, 31, LINK)"
43729,1,57,21,78,"(3f89b779c4152cec48a9ed2baa704cbc183e8afc, 2020-09-23 14:01:43 -0700, Wanchao Liang, 57, 21, 78, LINK)"
43732,1,10,2,12,"(f4695203c2c38864753873802a0835cfb7bc3dde, 2020-08-28 12:39:53 -0700, Mike Ruberry, 10, 2, 12, LINK)"
43761,1,4,1,5,"(7de512ced88eedde41f32a472b15762131b4ac60, 2020-09-21 12:29:57 -0700, Anthony Scopatz, 4, 1, 5, LINK)"
43768,1,15,6,21,"(0394c5a2835b8c5fe6713df50f302e22c5bcc70d, 2020-08-31 11:53:23 -0700, kshitij12345, 15, 6, 21, LINK)"
43787,1,27,23,50,"(57c18127dc5156e6d8e259e9a816e91b573377a8, 2020-09-28 13:43:50 -0700, BowenBao, 27, 23, 50, LINK)"
438,1,55,9,64,"(4f4bd81228257cfbb6e9894dd8bb2b0fa61f7039, 2017-01-13 13:51:47 -0500, Sam Gross, 55, 9, 64, LINK)"
43829,1,12,1,13,"(0c8a6008acf14a2d083f7cea78a595127597d36b, 2020-09-28 18:17:40 -0700, Xiong Wei, 12, 1, 13, LINK)"
43833,1,23,3,26,"(4ef12be900e9ec8b81fd45b2f7fe14d648826f64, 2020-08-31 11:35:55 -0700, Xiang Gao, 23, 3, 26, LINK)"
4386,1,13,2,15,"(b8fd57a0cc271a46c0dfa9b117573d41251868af, 2018-01-05 12:58:27 -0500, Sam Gross, 13, 2, 15, LINK)"
43944,2,156,17,173,"(8b39498a23e1840658cfb3885afd1f39bb7937f9, 2020-10-06 21:51:12 -0700, Peter Bell, 136, 8, 144, LINK), (0cdfadb954bffeb9b2f837f0539f61eb89617438, 2020-10-05 18:35:05 +0100, Peter Bell, 20, 9, 29, LINK)"
43945,5,126,35,161,"(8eee8460f821b7acb7a060df7b3b557218128fd9, 2021-01-04 11:51:28 -0800, Edward Yang, 100, 13, 113, LINK), (ff4a892dd27c06874338cee1922a6fd53a3d6b9a, 2020-10-05 21:38:19 +0100, Peter Bell, 4, 2, 6, LINK), (d38d8e000b406a89c84e37a9715a0b498f08ac79, 2020-10-01 23:22:27 +0100, Peter Bell, 3, 3, 6, LINK), (6ab11414580229ec859c89ac344beda5d3d04981, 2020-10-01 23:18:27 +0100, Peter Bell, 4, 13, 17, LINK), (8e95647275bac61a6288033e925d83f59c6188f8, 2020-10-01 19:28:22 +0100, Peter Bell, 15, 4, 19, LINK)"
43995,13,1720,275,1995,"(59083d61762b608a8298b68dcabe156e50759243, 2020-10-05 18:23:14 -0700, Mingzhe Li, 527, 46, 573, LINK), (83db4bdec58ee78cbb35e4382c462bc274a7d01b, 2020-09-25 12:37:55 -0700, mingzhe0908, 4, 0, 4, LINK), (bb02a5ec317ba0a707a04ac46b5c111fe0041fa7, 2020-09-25 12:37:55 -0700, mingzhe0908, 527, 46, 573, LINK), (8dbdc157c11de15d8ce011d57bff54ac0e201451, 2020-09-24 12:18:47 -0700, mingzhe0908, 6, 0, 6, LINK), (721a802dc9ec3e3b8e24b8b1dfac5c5edeaa8026, 2020-09-23 17:57:33 -0700, mingzhe0908, 13, 11, 24, LINK), (8ee2c13c1f0240fb89af729dc529cce7baa188c5, 2020-09-23 17:19:00 -0700, mingzhe0908, 8, 8, 16, LINK), (67bf6ce812ab0912887ea7b582803f370b9aa51d, 2020-09-23 13:57:36 -0700, mingzhe0908, 25, 1, 26, LINK), (6f891a2628bdc8a0208429a946071776a5750519, 2020-09-23 12:16:01 -0700, mingzhe0908, 103, 83, 186, LINK), (1c1f3c7dbcb1967b4e2059862d70c23733e2f4a5, 2020-09-21 16:09:11 -0700, mingzhe0908, 1, 1, 2, LINK), (b7600b90bf39d9f5ac2daa092bc4692b3eadaf13, 2020-09-21 16:04:00 -0700, mingzhe0908, 4, 3, 7, LINK), (e6d1111610dd520aab332970df8c1e5a0df2d0b7, 2020-09-21 15:53:29 -0700, mingzhe0908, 135, 44, 179, LINK), (acc7248616839498e99ba13741efa6cf9dd5741d, 2020-09-18 11:04:03 -0700, mingzhe0908, 31, 14, 45, LINK), (7d522daacda89a7ce225223011f68d556a6ff560, 2020-09-17 17:08:43 -0700, mingzhe0908, 336, 18, 354, LINK)"
44009,1,97,0,97,"(f8c1ca5dd8eeac7a67f61f6c4ef0a330399e9061, 2020-10-02 12:41:23 -0700, Rohan Varma, 97, 0, 97, LINK)"
4403,2,4,2,6,"(26751c56755eb76a623cc42b467c7706997092af, 2018-01-02 06:44:03 +0800, Tzu-Wei Huang, 2, 1, 3, LINK), (98c02c20b161ff8e4181e24336de4936039e9f5f, 2018-01-02 06:44:03 +0800, Tzu-Wei Huang, 2, 1, 3, LINK)"
44038,4,383,60,443,"(13b7855f33e61e3c466197518250e57ffe5886db, 2020-10-23 21:22:01 -0700, Yanan Cao, 176, 13, 189, LINK), (6d173e81a55d9613d3ff04512610b539a02451d9, 2020-09-03 14:06:30 -0700, Michael Suo, 88, 32, 120, LINK), (3d0ee430b4486c0e8d37eae7ff39d8e4b1e2583f, 2020-09-03 14:06:30 -0700, Michael Suo, 94, 14, 108, LINK), (d142f607ff036dcb24802403b2cbb33646a90b33, 2020-09-02 12:03:52 -0700, Michael Suo, 25, 1, 26, LINK)"
44061,1,7,0,7,"(b6b1c01adfdadf93a4a1d30c3661ff177412a876, 2020-09-11 08:32:19 -0700, guol-fnst, 7, 0, 7, LINK)"
4408,1,4,0,4,"(f05ca657dd25fe064da5f771f4592da092604ce2, 2018-01-03 10:23:50 -0500, Jon Crall, 4, 0, 4, LINK)"
44096,1,16,0,16,"(cfd3620b76b0facdf6dd5a705887c16a7aee6c57, 2020-09-09 08:06:54 -0700, peter, 16, 0, 16, LINK)"
44107,1,3,3,6,"(92ebb04f9206882e6d312a8b91318545f43a53c2, 2020-09-24 16:24:36 -0700, Himangshu, 3, 3, 6, LINK)"
44170,1,224,63,287,"(40eea6d9d1c46fcdf0eeb560cae808359a37229a, 2021-01-27 12:58:30 -0800, Pritam Damania, 224, 63, 287, LINK)"
4419,2,2,2,4,"(f31ac990f7ca4671420a527f1a34fa628040bc56, 2018-01-04 11:45:26 +0800, HE Tao, 1, 1, 2, REGEX), (c43b120d4329dbcbed114eae8b4cfb23f11b3779, 2018-01-04 11:45:26 +0800, HE Tao, 1, 1, 2, REGEX)"
44198,2,28,0,28,"(e261e0953e7a39f381926271b24a41a975bfa11a, 2020-09-14 12:17:00 -0700, Marcin Juszkiewicz, 1, 0, 1, LINK), (566b8d0650b9603a40b020972df40220ccf40f94, 2020-09-11 16:00:24 -0700, Marcin Juszkiewicz, 27, 0, 27, LINK)"
44203,1,127,55,182,"(98aad933b63dd4c74dcf8ba652954c23ab743686, 2020-10-22 01:47:29 -0700, Yi Wang, 127, 55, 182, LINK)"
44215,1,39,13,52,"(375a83e6c148a3a6344e94ffdf051d96a66c0ffa, 2020-09-29 18:05:51 -0700, Guilherme Leobas, 39, 13, 52, LINK)"
4422,2,155,31,186,"(c3b7baecea07314d28259d410aad970f41680c0b, 2018-01-09 14:33:32 -0800, Edward Z. Yang, 83, 27, 110, LINK), (0f8ece56576ab0820e951e783c8e422cc6365817, 2018-01-03 09:27:24 -0800, Edward Z. Yang, 72, 4, 76, LINK)"
44273,1,24,11,35,"(42f9f2f38f734466a18c54b8eb82c8cf5c01a132, 2020-09-11 15:30:59 -0700, kshitij12345, 24, 11, 35, LINK)"
44283,1,10,3,13,"(89f368bef8c803fa85389e3b3d14ce64ef2dbfd3, 2020-10-23 14:12:00 -0700, peter, 10, 3, 13, LINK)"
44378,2,2996,1,2997,"(afa1ff8e04dad60dee9f979451a36713903f521d, 2021-03-12 13:23:13 -0800, Nikita Vedeneev, 1498, 1, 1499, LINK), (3ac90132351b3dab51d6ecede52db62e101257e1, 2021-03-02 18:46:02 -0800, Nikita Vedeneev, 1498, 0, 1498, LINK)"
44384,1,2,0,2,"(5e0bfd74551455220c95783200bb88ea71fed269, 2020-10-20 08:31:56 -0700, acxz, 2, 0, 2, LINK)"
44425,1,79,13,92,"(41f62b17e721d2f8854b7e684d96e70d58f2eaf0, 2020-09-10 18:30:06 -0700, Rohan Varma, 79, 13, 92, LINK)"
44438,1,46,13,59,"(a82ea6a91f9b7ac3885ea1144a215db17d816a62, 2020-09-11 15:20:22 -0700, Jerry Zhang, 46, 13, 59, LINK)"
44450,1,81,36,117,"(4bead6438a4271f154980dc242199c2f1b897bc1, 2020-09-10 13:34:49 -0700, Nikita Shulga, 81, 36, 117, LINK)"
44470,1,5,1,6,"(de3a48013a35bf6ebfba7fb4c5408339e57010cb, 2020-10-01 16:39:01 -0700, Abaho Katabarwa, 5, 1, 6, LINK)"
44472,2,16,9,25,"(c1fa42497bd6c8eb2085d4647909d2d8008d1b4f, 2020-09-17 10:47:20 -0700, Rong Rong, 8, 2, 10, LINK), (993b4651fd4eb6a858b35e660c6d623a6ab39bb5, 2020-09-15 13:59:50 -0700, Jeffrey Wan, 8, 7, 15, LINK)"
44530,1,30,2,32,"(1e2d1d7242ac28d2cf71c8a5d4a91be43b0acd90, 2020-12-14 14:14:28 -0800, vikigenius, 30, 2, 32, LINK)"
44531,1,49,2,51,"(9fc7a942f0043a79ccd0ef0c3d55a844249b52d3, 2020-09-22 09:05:41 -0700, Himangshu, 49, 2, 51, LINK)"
4457,1,25,0,25,"(4e3a4bd6887b65df680fd6c2f739255db3a35a98, 2018-01-03 08:14:51 -0800, Edward Z. Yang, 25, 0, 25, LINK)"
44599,1,3,3,6,"(ed862d36824679c056123e1d2495c4f2b60657a5, 2020-09-14 20:24:07 -0700, peter, 3, 3, 6, LINK)"
44601,1,665,47,712,"(f41f3e3cd16a51e19441d1d51ddbee53771d4c6c, 2020-11-03 15:27:20 -0800, pomelyu, 665, 47, 712, LINK)"
44612,1,3,3,6,"(8c66cd120bd52055dab215033c2b487a8aff7fbb, 2020-09-28 19:05:11 -0700, kiyosora, 3, 3, 6, LINK)"
44638,2,286,230,516,"(992d57b9fa17255097062a34c61671ab9784f78b, 2020-10-12 14:59:55 -0700, Nikita Shulga, 143, 115, 258, LINK), (9679e1affcded109201a4b33900943cf452c2ae0, 2020-10-07 10:50:50 -0700, Guilherme Leobas, 143, 115, 258, LINK)"
4464,1,7,1,8,"(ac613371a30553f08024b3e83fd2033e4791d4b0, 2020-05-14 22:11:09 -0700, omromano, 7, 1, 8, LINK)"
4466,1,19,7,26,"(f4a75deccf2b722f4f4d1d1fd08f0002a8a56565, 2018-01-09 23:39:09 +0800, HE Tao, 19, 7, 26, LINK)"
44714,1,19,5,24,"(e4bc785dd57b15ae091eb8e8ca71a604da9b3fb2, 2020-11-04 08:27:55 -0800, Jane Xu, 19, 5, 24, LINK)"
4475,1,19,8,27,"(9c2561e60c6ac9003c669c4d95fdbe3e1adbb9ce, 2018-01-06 19:49:36 +0800, peterjc123, 19, 8, 27, LINK)"
44792,1,18,4,22,"(66505b64a5f26094b9b037c9777fec2706b2e5ad, 2020-10-12 18:26:07 -0700, Kurt Mohler, 18, 4, 22, LINK)"
44793,1,8,15,23,"(c44e4878ae7e2ce98af71615122019719e4f66bd, 2020-09-16 12:17:23 -0700, Nikita Shulga, 8, 15, 23, LINK)"
4480,1,63,34,97,"(27505e642963bb8b8c18abdcc6dbed4d41ffa0db, 2018-01-23 18:06:55 -0500, Edward Z. Yang, 63, 34, 97, LINK)"
44810,1,10,2,12,"(0df99ad4706d1dceddcf0424bb3c17453fcf4722, 2020-09-29 11:50:58 -0700, Hong Xu, 10, 2, 12, LINK)"
44864,1,14,1,15,"(9a007ba4cb12f7d3fa7db59c52b9b58879ca9cd9, 2020-09-17 18:07:07 -0700, Yuxin Wu, 14, 1, 15, LINK)"
44892,1,30,0,30,"(c253b101545cc1a2ba5a4ab467cd972a63ac072d, 2020-09-22 11:51:58 -0700, Yanan Cao, 30, 0, 30, LINK)"
4492,1,62,41,103,"(7d25a4125180732e8e6882c898bcadd9c9c637a3, 2018-01-08 12:21:09 -0500, Edward Z. Yang, 62, 41, 103, LINK)"
4500,2,117,13,130,"(bc7a41af7d541e64f8b8f7318a7a2248c0119632, 2018-01-10 17:33:31 -0500, Edward Z. Yang, 45, 9, 54, LINK), (0f8ece56576ab0820e951e783c8e422cc6365817, 2018-01-03 09:27:24 -0800, Edward Z. Yang, 72, 4, 76, LINK)"
45061,1,128,33,161,"(77cd8e006b92a8faf90a1ffcfe601860df587726, 2020-10-01 08:55:22 -0700, Ivan Yashchuk, 128, 33, 161, LINK)"
45082,1,49,13,62,"(09e7f62ce20e3623d2949581cd627ab29e34cdc1, 2020-09-21 21:44:56 -0700, Shen Li, 49, 13, 62, LINK)"
45108,1,275,15,290,"(d150d3e276cea1ae955df4afc2b30496c0802dce, 2020-10-02 14:39:14 -0700, Yanan Cao, 275, 15, 290, LINK)"
45165,1,58,5,63,"(cf3d7a266053cb2cf4c115ff0638bbac0d162dae, 2020-10-21 08:33:02 -0700, Brian Hirsh, 58, 5, 63, LINK)"
45172,1,58,4,62,"(b8eab8cdbdc467bc6ef19381af9387f41e45fb44, 2020-09-24 10:04:47 -0700, Rong Rong, 58, 4, 62, LINK)"
45184,1,29,1,30,"(7cde662f08b226fb8d7f8e99dbd6f40dbe2dca16, 2020-09-29 07:35:00 -0700, Himangshu, 29, 1, 30, LINK)"
45201,1,10,3,13,"(00e704e75705b8441641a314f4c5cd9b7ffeb113, 2020-09-25 07:51:11 -0700, kshitij12345, 10, 3, 13, LINK)"
45215,3,320,153,473,"(34cc77a8116718ad22936e571d18b54b793bf7c0, 2020-12-08 19:40:01 -0800, Guilherme Leobas, 110, 52, 162, LINK), (8bc6023d7a822ea6936b7460027f29558149008d, 2020-12-07 08:21:42 -0800, Guilherme Leobas, 105, 51, 156, LINK), (40a2dd7e1eccdcf756fec92084a54eeb397f75cd, 2020-12-01 20:36:25 -0800, Guilherme Leobas, 105, 50, 155, LINK)"
4526,1,4,4,8,"(e3bafb884ad7333a489960d0ddec2f1f676cbc40, 2018-01-08 17:25:33 -0500, Edward Z. Yang, 4, 4, 8, LINK)"
45269,2,22,13,35,"(772ce9ac2cac933e049181db078d428680e9da10, 2020-09-29 20:22:56 -0700, Nikita Shulga, 14, 12, 26, LINK), (c87ff2cb9054c6757419e3b6d883014b2c773fef, 2020-09-29 19:19:49 -0700, Nikita Shulga, 8, 1, 9, LINK)"
45271,1,9,4,13,"(95df8657c94492ff026112f8e51a24216f1a9a0c, 2020-09-24 23:07:38 -0700, Mike Ruberry, 9, 4, 13, LINK)"
45274,1,40,8,48,"(9201c37d020007979e144693d86c8e8599e2fd8f, 2020-10-02 00:24:14 -0700, Natalia Gimelshein, 40, 8, 48, LINK)"
45310,2,514,154,668,"(c83314e9829822fcdc765e0b1eb9585a6b114c83, 2020-10-09 09:44:49 -0700, Pritam Damania, 259, 79, 338, LINK), (c8d76ff7dc21d426c7f2851803071820865a828f, 2020-10-07 12:16:52 -0700, Pritam Damania, 255, 75, 330, LINK)"
45324,1,27,1,28,"(a69910868a5962e2d699c6069154836e262a29e2, 2020-10-14 17:17:50 -0700, HyunJun, 27, 1, 28, LINK)"
45333,2,46,2,48,"(16fd1c32c5cbf63d87a104396acacbb72b15f419, 2020-12-03 17:28:46 -0800, shubhambhokare1, 22, 1, 23, LINK), (1a55f5b3ea478ccae9f5950f7ec99bb857bfc7fd, 2020-11-10 11:29:16 -0800, shubhambhokare1, 24, 1, 25, LINK)"
45336,1,56,19,75,"(8ab2ad306d247679fc1ab2b5941f9e978f8e178b, 2020-09-25 16:58:39 -0700, Nikita Shulga, 56, 19, 75, LINK)"
45357,1,50,4,54,"(2643800881a04f31d8f548a9abbdf1772d899a6a, 2020-10-30 09:32:09 -0700, Heitor Schueroff, 50, 4, 54, LINK)"
4539,1,2,1,3,"(f44fca882eddc865901c07266b7f3b3976fc48dd, 2020-05-29 10:27:43 -0700, Ophir Romano, 2, 1, 3, LINK)"
45403,1,2,2,4,"(df0de780c32f91cfcdb153595ac456cc629c01ba, 2020-09-29 09:23:27 -0700, Xiao Wang, 2, 2, 4, LINK)"
45418,1,8,0,8,"(4ce2b0b0ac5ec9a11fb03100e2f96f2cdcc02b45, 2020-12-16 19:51:20 -0800, Daniel Balchev, 8, 0, 8, LINK)"
45419,3,406,326,732,"(cb3c1d17e452ed735ffcd86e0ceed7895ad4d8da, 2020-10-20 18:07:04 -0700, Pritam Damania, 5, 1, 6, LINK), (2b221a95997b00dcc166918f752b2ad8e921eb15, 2020-10-20 14:59:49 -0700, Pritam Damania, 359, 283, 642, LINK), (6e43f0db8b09e3516ca7238df384e9db99d89cfe, 2020-10-02 10:41:55 -0700, Pritam Damania, 42, 42, 84, LINK)"
45431,1,27,24,51,"(c1af91a13aa82661d0d15ed467b9c68dc36b914b, 2020-10-06 13:14:58 -0700, n-v-k, 27, 24, 51, LINK)"
45436,1,56,43,99,"(b3135c2056f33e918c5b0aeeb4098580c2818ddf, 2020-09-29 09:27:55 -0700, Nikita Shulga, 56, 43, 99, LINK)"
45460,1,1,1,2,"(381f6d32a77d76795df49945f1e960453d0b2cc9, 2020-10-01 12:17:02 -0700, Richard Zou, 1, 1, 2, LINK)"
45494,2,40,26,66,"(45b4b5dcddaec68ab7ac36efe2479ac0fd83a27c, 2020-11-20 20:32:02 +0100, Hameer Abbasi, 20, 13, 33, LINK), (e366591dc8da83279cdc9e9e948549142ed539db, 2020-10-15 07:45:48 -0700, Hameer Abbasi, 20, 13, 33, LINK)"
45502,1,2,0,2,"(e02868e12d2205fdf98721b220755ff03ae315eb, 2020-09-30 07:03:30 -0700, VinodSKumar, 2, 0, 2, LINK)"
45505,1,166,0,166,"(a651b876a72cb052490a779059ef3bd07a9c8aeb, 2020-10-20 19:45:34 -0700, lixinyu, 166, 0, 166, LINK)"
45552,1,230,4,234,"(a3caa719afc3a6fe17c086cde6d5b4d6837ab96c, 2020-10-13 07:45:35 -0700, Brian Hirsh, 230, 4, 234, LINK)"
45558,2,0,2,2,"(ff9e56575be620fa121b03173bc1340afabbafdf, 2020-10-11 21:27:21 -0700, SplitInfinity, 0, 1, 1, LINK), (e3112e3ed6397489d19235094b2736e38fb2824a, 2020-10-08 14:36:12 -0700, huaidong.xiong, 0, 1, 1, LINK)"
45581,1,84,26,110,"(815d38395a5081adef6ecec3372474f6f41b2a7c, 2020-12-17 09:30:02 -0800, peterjc123, 84, 26, 110, LINK)"
45593,1,56,14,70,"(d1fc1555d493a396358840d2bc19d55a19636371, 2020-10-06 10:54:31 -0700, Jerry Zhang, 56, 14, 70, LINK)"
45627,1,10,1,11,"(72e4f51bc07b464b32a3868abe5953013bf87ba9, 2020-10-07 17:33:55 -0700, Elias Ellison, 10, 1, 11, LINK)"
45703,1,542,1123,1665,"(07657b600118c30e578bff682f8b179080948095, 2020-11-18 12:17:04 -0800, Bert Maher, 542, 1123, 1665, LINK)"
45721,1,14,1,15,"(a814231616f5db7fcdb8793f64c12d652d1e8572, 2020-10-11 20:11:25 -0700, kshitij12345, 14, 1, 15, LINK)"
45724,2,124,4,128,"(653d766f4a80085b44536ea8e4170b09ef0ba976, 2020-10-08 14:24:39 -0700, Gao Xiang, 62, 2, 64, LINK), (b2bff9e4310d184c92e66617c0e396c119d594d1, 2020-10-07 22:36:27 -0700, Xiang Gao, 62, 2, 64, LINK)"
45746,1,11,8,19,"(1eed54d17a8ae686c79ce716db35bc6ead97c4cd, 2020-12-03 11:40:09 -0800, pinzhenx, 11, 8, 19, LINK)"
45771,1,25,26,51,"(9b526546202cf53c90ed3a438c16260386475680, 2020-11-02 13:03:02 -0800, Guilherme Leobas, 25, 26, 51, LINK)"
45816,1,77,0,77,"(7a599870b05c315184dd81ac4723fa974039e840, 2020-11-05 09:40:01 -0800, Ksenija Stanojevic, 77, 0, 77, LINK)"
45824,1,21,3,24,"(9dc9a55bc47c98d4683afb969d871615ca45874b, 2020-10-08 01:27:42 -0700, Jonathan Conder, 21, 3, 24, LINK)"
45835,1,12,0,12,"(c734961e265d87d3d8ef9ec640bd3d3d27a3bce2, 2020-10-09 07:30:39 -0700, Alexandre Saint, 12, 0, 12, LINK)"
45838,1,3,3,6,"(e1f74b181375da76a380c4979d8c1fde27278dc2, 2020-10-12 08:41:21 -0700, pinzhenx, 3, 3, 6, LINK)"
45845,2,32,8,40,"(a06d19b32144ac13073206c8b10f764a30df3945, 2020-10-12 17:44:31 -0700, Wanchao, 16, 4, 20, LINK), (505be08c75d5c5451586a3069124d324a483d6ef, 2020-10-07 15:08:05 -0700, Wanchao Liang, 16, 4, 20, LINK)"
45854,2,1073,698,1771,"(ea2a568cca71aaf690051782c225ca9dd2e5e1f9, 2020-12-06 08:01:00 -0800, Heitor Schueroff, 543, 348, 891, LINK), (a5c65b86ce249f5f2d365169e6315593fbd47b61, 2020-11-10 19:37:09 -0800, Heitor Schueroff, 530, 350, 880, LINK)"
45860,2,84,10,94,"(cf77b0845c60ad1f99f8a6d9da0fa8049dcc5e4e, 2020-10-15 16:26:50 -0700, SplitInfinity, 42, 5, 47, LINK), (75bf5f2b59148ea8b6a3844248bcc645dd80e0c8, 2020-10-14 23:25:48 -0700, Meghan Lele, 42, 5, 47, LINK)"
45864,1,14,11,25,"(782f92b5690ebeaca7ee46d4942b190cf7c82147, 2020-11-03 10:25:54 -0800, Yi Zhang, 14, 11, 25, LINK)"
45896,1,558,0,558,"(c542614e53f82ca2a70483d895de99ab1ba1c514, 2020-11-19 07:58:50 -0800, Erjia Guan, 558, 0, 558, LINK)"
45902,1,48,26,74,"(908c23579dd27bafbe4545c319b2284f717e231d, 2020-10-15 10:54:52 -0700, Elias Ellison, 48, 26, 74, LINK)"
45917,1,26,24,50,"(b98e35948f337b40c366cc2568e4921f2cf02c0d, 2020-10-12 15:15:25 -0700, Rong Rong, 26, 24, 50, LINK)"
45921,1,25,13,38,"(6a2f40dc66d2fa32c3fa0f980e77788a1202d4ee, 2020-10-17 17:30:09 -0700, Yanan Cao, 25, 13, 38, LINK)"
45922,1,5,1,6,"(81d40aaf96e84adde9f4fa2fe26761f1a54bc0b6, 2020-10-07 20:43:54 -0700, Nikita Shulga, 5, 1, 6, LINK)"
45928,1,99,12,111,"(87a4baf616565aecd21884754772a0f03babfe2d, 2020-10-12 15:59:03 -0700, Daya Khudia, 99, 12, 111, LINK)"
45953,1,69,0,69,"(f3db68776cebbc240a7a0f42027eb52caeb3ac36, 2020-10-12 13:27:04 -0700, Nick Gibson, 69, 0, 69, LINK)"
45964,1,170,17,187,"(5765bbd78cd4db5deda4b6b3f4ecf06303aeca69, 2020-12-09 15:09:23 -0800, Peter Bell, 170, 17, 187, LINK)"
45982,1,1,1,2,"(5f7545adf6b7d6c978bfd8aba92f9cdf124e1484, 2020-10-08 12:01:52 -0700, peter, 1, 1, 2, LINK)"
45999,1,15,2,17,"(64b068698628f9a77a53a6b98fc8f3579e3248d7, 2020-10-08 15:55:38 -0700, n-v-k, 15, 2, 17, LINK)"
46,3,689,307,996,"(b90cbb841d98aeae435b1d02b1ff211e028cdf5b, 2019-04-05 12:44:49 -0700, Joakim Rishaug, 1, 1, 2, LINK), (976f9253a5425918eda7cf865b097cf42b5da8d7, 2018-07-16 15:17:57 -0700, Edward Yang, 139, 193, 332, LINK), (5aaa220d84ca7611e38ad447831d02c9776efd17, 2017-01-15 12:42:50 +0100, Filip Binkiewicz, 549, 113, 662, LINK)"
46012,1,40,25,65,"(ca8b9437ab5e89822e5fb5d95872fb8959870505, 2020-11-18 07:41:28 -0800, Guilherme Leobas, 40, 25, 65, LINK)"
46020,3,26,24,50,"(7b7f2519d96ab840041c4bb16686727630c5b07b, 2020-10-13 12:48:22 -0700, Thomas Viehmann, 8, 10, 18, LINK), (440b7bd45109c11c549515297cf835f4d2d7f9f5, 2020-10-12 14:59:27 -0700, Nikita Shulga, 9, 7, 16, LINK), (2070834b9e52031beb1128375ae6841b69c6e0a3, 2020-10-12 11:08:02 -0700, Gregory Chanan, 9, 7, 16, LINK)"
46037,2,28,7,35,"(c99378af1b2f6a31aa2657e9cb74b31b0d85ea69, 2020-10-15 13:41:18 -0700, Jane Xu, 17, 7, 24, LINK), (ad376f1a62d0d9c04ac1e91d3baf6af4f9408019, 2020-10-13 10:12:11 -0700, Jane Xu, 11, 0, 11, LINK)"
46047,1,96,22,118,"(f9b94301529f1089f29a25958d2e754a986bfe75, 2020-10-24 12:49:17 -0700, Yanan Cao, 96, 22, 118, LINK)"
46122,1,14,2,16,"(4380934b9b75640ff29d1959dd442e559e2709d0, 2020-11-13 18:31:08 -0800, Elias Ellison, 14, 2, 16, LINK)"
46175,2,20,2,22,"(03ed8cbf586bd99181d5a3fe9b61760c83dbdf62, 2020-10-15 18:37:51 +0200, Alexander Grund, 10, 1, 11, LINK), (282f4ab9479c8c6bcc16d56c5a2612f2c005cff3, 2020-10-13 07:29:57 -0700, Alexander Grund, 10, 1, 11, LINK)"
46212,1,63,4,67,"(8f5ad00e134190deeac9d9487d3cabef9a460f92, 2021-01-19 22:54:03 -0800, Meghan Lele, 63, 4, 67, LINK)"
46242,2,117,43,160,"(cd4aa9c95c3481d82637fe36138883bbad9e15c7, 2020-11-16 08:04:15 -0800, albanD, 62, 42, 104, LINK), (849bc77ee40f6035166fa3b6facf0bab7759becd, 2020-10-15 15:08:15 -0700, albanD, 55, 1, 56, LINK)"
46246,1,2,0,2,"(8e3af9faa891b2b6b206035db4ddb7ccabc348df, 2020-11-10 14:51:50 -0800, Jiakai Liu, 2, 0, 2, LINK)"
46277,1,116,10,126,"(cf1882adeb94182cd24e15929f67007d43fcc4c8, 2021-01-20 11:23:04 -0800, Hameer Abbasi, 116, 10, 126, LINK)"
46314,2,12,18,30,"(2a23023428b5a1d28cb53dc22141d02cb6067751, 2020-10-15 18:06:54 +0200, Alexander Grund, 6, 9, 15, LINK), (45de2ee3ac83c8eb85138d7440413ff625bfaeaa, 2020-10-14 07:34:47 -0700, Nikita Shulga, 6, 9, 15, LINK)"
46326,1,19,2,21,"(fee585b5a3d7a61a5a62df81cae596b486f409f2, 2020-10-29 11:58:10 -0700, tmanlaibaatar, 19, 2, 21, LINK)"
46341,1,38,2,40,"(4d3c12d37c61848b35e1b0fb2d2e06b091e19d8d, 2021-01-11 14:03:00 -0800, Meghan Lele, 38, 2, 40, LINK)"
46348,6,544,284,828,"(f91fcefc8159c388133daa3b8643bfd37e76b236, 2020-11-03 18:29:38 -0800, Yi Wang, 192, 21, 213, LINK), (b1b77148ac544aa964e88a23ab8d3fba090fd472, 2020-11-02 20:47:47 -0800, Yi Wang, 21, 192, 213, LINK), (ee0033af9b7531ba0a453844dc621f8cfa140c20, 2020-10-30 23:17:56 -0700, Yi Wang, 192, 21, 213, LINK), (e299393fd51993bd25f61e31847d0b7b2121c548, 2020-10-27 21:39:17 -0700, Yi Wang, 66, 0, 66, LINK), (e077a2a238b1fe62f2d4c1da34df16ec9f8b563b, 2020-10-27 21:39:17 -0700, Yi Wang, 30, 8, 38, LINK), (a6cd294c9bb2c3ab6f82af0265102ae557d25390, 2020-10-26 18:05:39 -0700, Yi Wang, 43, 42, 85, LINK)"
46405,1,4,4,8,"(42e6951e62a15b063a96f2d012d2f268b8c1d23e, 2020-12-04 13:16:09 -0800, jsrozner, 4, 4, 8, LINK)"
46437,1,2,2,4,"(b5702e2350a6cc6eef1663907175547767522424, 2020-10-16 08:22:21 -0700, Nikita Shulga, 2, 2, 4, LINK)"
46440,3,363,28,391,"(eed8d7e3cbe8fc6f6f15135dfed670adcfb185a9, 2020-10-19 17:53:21 -0700, Mikhail Zolotukhin, 286, 26, 312, LINK), (107b1e4632ba9f826bee1da3ff3ea766faa21475, 2020-10-15 22:20:06 -0700, Mikhail Zolotukhin, 40, 1, 41, LINK), (4359c5e036d043a971a48223233332333d3a53ab, 2020-10-16 01:08:23 -0700, Mikhail Zolotukhin, 37, 1, 38, LINK)"
46458,1,20,7,27,"(c4892c8efe90cfd362db83bb6601d9c8040edc80, 2020-10-23 17:27:50 -0700, Bert Maher, 20, 7, 27, LINK)"
46489,1,11,10,21,"(789e9353044eb2227462ef470e4b362ac025be4d, 2020-10-23 17:38:26 -0700, Guilherme Leobas, 11, 10, 21, LINK)"
46536,1,6,6,12,"(4ab2055857a23f0652d37e4630148ea1c06de920, 2020-11-25 13:19:26 -0800, Xiao Wang, 6, 6, 12, LINK)"
46554,1,147,65,212,"(cab32d9cdf3df1d838d41739fc519f589f834f9d, 2020-10-29 00:12:55 -0700, Yi Wang, 147, 65, 212, LINK)"
46557,1,39,24,63,"(fe4f90c40bfcb442eddcd26657158bd8fd43a464, 2020-10-21 21:41:43 -0700, Xiao Wang, 39, 24, 63, LINK)"
46561,1,5,2,7,"(caed29a069c7e0e691080db825e377eecf86dcd0, 2020-10-21 12:57:55 -0700, Joel Lamy-Poirier, 5, 2, 7, LINK)"
46588,1,1,1,2,"(e09ec8eefa3c0b736b0625692919e4542d98e76d, 2020-11-06 15:44:14 -0800, Ilqar Ramazanli, 1, 1, 2, LINK)"
46651,1,1,0,1,"(50c9581de1238c8dec9c397faa19a1addf6e657a, 2020-10-28 09:04:08 -0700, Nikita Shulga, 1, 0, 1, LINK)"
4666,1,30,6,36,"(cb83474a57d3a42dfea27d654596cd6bd351d049, 2018-01-16 16:19:20 -0500, Sam Gross, 30, 6, 36, LINK)"
46681,1,20,1,21,"(53839ac9d740da3cd4ab162cfe2b4628cce4bd6c, 2020-10-27 16:44:56 -0700, kiyosora, 20, 1, 21, LINK)"
46703,1,65,35,100,"(d1b8da75e691fd43da4939dff1fd39c9a2cf092e, 2020-11-20 11:14:59 -0800, Elias Ellison, 65, 35, 100, LINK)"
46735,1,16,4,20,"(717e6d808114d73003e670169a296ba4eefb5d49, 2020-10-27 14:23:14 -0700, Guilherme Leobas, 16, 4, 20, LINK)"
46743,1,188,56,244,"(2cb92041594661ceb32c7da5bd1967b53d3bb8c0, 2020-12-03 10:55:52 -0800, Kurt Mohler, 188, 56, 244, LINK)"
46764,1,94,109,203,"(e17b8dea1dd30bef55b314b0217f79ce22a13cf9, 2020-10-29 15:22:29 -0700, Natalia Gimelshein, 94, 109, 203, LINK)"
46782,1,5,0,5,"(78de12f58854237dc5987e10bb4ab4fb33b2d01b, 2020-10-29 15:18:05 -0700, Pritam Damania, 5, 0, 5, LINK)"
46800,1,31,0,31,"(7c9ba621305f939891bbb6219cf9151092d0e301, 2020-12-04 13:16:18 -0800, Zrss, 31, 0, 31, LINK)"
46814,1,19,1,20,"(ddeacf1565ca08015c20cb6d17ef0357937fff5c, 2020-10-29 17:10:31 -0700, Heitor Schueroff, 19, 1, 20, LINK)"
46816,1,3,3,6,"(a63f391c6ff454bf18463e99a33733359fa27145, 2020-11-05 20:37:57 -0800, Elias Ellison, 3, 3, 6, LINK)"
4682,2,2,2,4,"(281b6ce41d384124c453c722a5e84a737cf43344, 2018-01-16 13:18:30 -0500, Shagun Sodhani, 1, 1, 2, LINK), (d452291a72751e94c0871c5c741316bad50b98a5, 2018-01-16 13:18:30 -0500, Shagun Sodhani, 1, 1, 2, LINK)"
46824,1,32,25,57,"(d478605dec65a746d41506b23693d6013bfa11b2, 2020-11-11 09:23:02 -0800, Hameer Abbasi, 32, 25, 57, LINK)"
46848,1,17,1,18,"(29184f86b0d01a9dafd5bc0597aa7bb63d2b84c4, 2020-11-07 00:36:44 -0800, Tugsbayasgalan Manlaibaatar, 17, 1, 18, LINK)"
46872,1,38,0,38,"(cb4b6336baac14173ec5659896fe3e7f06c2f5b2, 2020-10-30 17:06:55 -0700, Horace He, 38, 0, 38, LINK)"
46875,1,26,9,35,"(90a90ab1d6c48c30e65dc516c75a3a338c832249, 2020-11-06 11:15:16 -0800, Guilherme Leobas, 26, 9, 35, LINK)"
46930,1,1,1,2,"(dc53eefd256ad0110fae098be96d403ae7b85a97, 2020-10-27 14:56:16 -0700, Charles Coulombe, 1, 1, 2, LINK)"
46973,2,6,4,10,"(716adbe598621327409ddd8feb471886795f0e59, 2020-11-20 13:18:58 -0800, Nikita Shulga, 3, 2, 5, LINK), (058f43fc514f0505ffd78decbd3191edaf676449, 2020-10-28 12:46:45 -0700, Nikita Shulga, 3, 2, 5, LINK)"
46983,3,83,12,95,"(dc7ab46dccae3146e936eef3124cefde99f8063a, 2020-12-01 07:02:40 -0800, CedricPicron, 63, 4, 67, LINK), (b6d4dc1ee6d2d05109df2006d01dec75b7c2b3f8, 2020-11-19 12:24:08 -0500, gchanan, 10, 4, 14, LINK), (233192be7334ab1dda217472f67d1de5bcb6685b, 2020-11-16 13:10:17 -0800, albanD, 10, 4, 14, LINK)"
46985,1,2,3,5,"(1e275bc1a64919536a7a269fc4de0ea100710da7, 2020-10-29 11:57:14 -0700, Sam Estep, 2, 3, 5, LINK)"
47003,2,6,4,10,"(716adbe598621327409ddd8feb471886795f0e59, 2020-11-20 13:18:58 -0800, Nikita Shulga, 3, 2, 5, LINK), (058f43fc514f0505ffd78decbd3191edaf676449, 2020-10-28 12:46:45 -0700, Nikita Shulga, 3, 2, 5, LINK)"
47007,1,13,2,15,"(edac4060d7e7a0a074deb0612c4c13f262c8614e, 2020-10-30 10:36:53 -0700, Nikita Shulga, 13, 2, 15, LINK)"
47038,2,18,8,26,"(c307a3f336da65ac974cf8a030dbf4c61105747b, 2021-02-12 12:20:46 -0800, Nikita Shulga, 9, 4, 13, LINK), (a1bfa5eed76897b1bf7b9fdcacc5c421c452d26e, 2021-02-09 06:43:14 -0800, Nikita Shulga, 9, 4, 13, LINK)"
47054,2,22,16,38,"(22dfccbbadc0345188722f4bcc78ee90707060e6, 2020-11-19 12:26:04 -0500, gchanan, 11, 8, 19, LINK), (18470f68bc359a370f17399ae0aac24c4761a7bb, 2020-11-02 14:19:40 -0800, Heitor Schueroff, 11, 8, 19, LINK)"
47069,1,32,25,57,"(d478605dec65a746d41506b23693d6013bfa11b2, 2020-11-11 09:23:02 -0800, Hameer Abbasi, 32, 25, 57, LINK)"
47089,1,34,0,34,"(fc559bd6dc21d8bcdb77d63ecf11ec514266f27e, 2020-12-28 10:41:28 -0800, Elias Ellison, 34, 0, 34, LINK)"
47090,2,24,4,28,"(78ff7e83c89ec97e21b308d6e40838beed358e06, 2020-11-20 20:32:30 +0100, Hameer Abbasi, 12, 2, 14, LINK), (7908bf27d5256200c4711ab1f482e2517da3bdcb, 2020-11-10 19:43:48 -0800, Hameer Abbasi, 12, 2, 14, LINK)"
47098,2,61,61,122,"(8c5b0247a571aa672f9070fcc9769f2c4bb19571, 2021-01-11 21:49:35 -0800, Nikita Shulga, 57, 60, 117, LINK), (c86af4aa55ab3e63aba7568692b678ce662f27e2, 2020-10-30 13:31:10 -0700, Nikita Shulga, 4, 1, 5, LINK)"
47103,1,14,11,25,"(782f92b5690ebeaca7ee46d4942b190cf7c82147, 2020-11-03 10:25:54 -0800, Yi Zhang, 14, 11, 25, LINK)"
47123,1,69,39,108,"(093aca082e2878f3a28defe9075e7334dfceac70, 2021-01-05 13:55:10 -0800, Fritz Obermeyer, 69, 39, 108, LINK)"
47127,1,41,42,83,"(65a72cae2ccbc6dda1de3198d2afc7bd838d7202, 2020-11-10 07:43:55 -0800, Gregory Chanan, 41, 42, 83, LINK)"
47133,1,28,21,49,"(4f9d0757f39988fb0fc2a0ff60c219199f22e341, 2020-11-13 21:18:00 -0800, Guilherme Leobas, 28, 21, 49, LINK)"
47138,2,161,58,219,"(e985503d80bbc6ff62587fa64c07cfb25488490d, 2020-11-05 18:26:06 -0800, Nick Gibson, 61, 29, 90, LINK), (33cf7fddd2ec198465e680c983244adda69b4f93, 2020-11-04 15:44:13 -0800, Nick Gibson, 100, 29, 129, LINK)"
47153,3,234,405,639,"(f91fcefc8159c388133daa3b8643bfd37e76b236, 2020-11-03 18:29:38 -0800, Yi Wang, 192, 21, 213, LINK), (b1b77148ac544aa964e88a23ab8d3fba090fd472, 2020-11-02 20:47:47 -0800, Yi Wang, 21, 192, 213, LINK), (1e9277be8a2088d8c428d409e0553a272c75ccda, 2020-11-02 14:14:24 -0800, wayi, 21, 192, 213, LINK)"
47157,1,9,1,10,"(a11bc049971a1381249807ec3d6750d0eb2287ae, 2020-11-04 13:28:42 -0800, Jonas Teuwen, 9, 1, 10, LINK)"
47160,1,16,5,21,"(2907447c97c0e7a8673951907a4b94a682c39526, 2020-11-12 00:13:01 -0800, ArtistBanda, 16, 5, 21, LINK)"
47176,1,176,80,256,"(4b25d83e9bdaee701967d7aff625cedf4c12913c, 2020-11-11 22:52:57 -0800, kshitij12345, 176, 80, 256, LINK)"
47183,1,14,1,15,"(ee271047b5bcef5993db3582c759aeec966b98e8, 2020-12-22 22:22:11 -0800, Michael Carilli, 14, 1, 15, LINK)"
47186,1,32,25,57,"(d478605dec65a746d41506b23693d6013bfa11b2, 2020-11-11 09:23:02 -0800, Hameer Abbasi, 32, 25, 57, LINK)"
47193,1,68,0,68,"(008f840e7af424138bc264373467ee4b3e9669f2, 2020-11-19 11:17:25 -0800, kiyosora, 68, 0, 68, LINK)"
47202,35,2151,694,2845,"(43df03de131c0335e82a5840abf0e7c28344ac10, 2021-02-03 13:34:15 -0800, Yi Wang, 2, 2, 4, LINK), (79e7544cb4ece28032fdeccf01778222cbbe99cd, 2021-02-02 04:28:19 -0800, Yi Wang, 64, 11, 75, LINK), (c08078031f73e34d046784ff14e63c7b2061bd43, 2021-02-01 15:22:00 -0800, Yi Wang, 17, 15, 32, LINK), (0831984ed5d7d5fff4dda8d77139360b1b58bbc0, 2021-02-01 11:32:17 -0800, Yi Wang, 22, 20, 42, LINK), (e7b34962326713aa65383c509c7939f2a007211b, 2021-01-28 18:57:12 -0800, Yi Wang, 18, 19, 37, LINK), (9d731e87de09936b1915a35e10f9ab9916255b9d, 2021-01-28 18:57:12 -0800, Yi Wang, 5, 5, 10, LINK), (b619d37bb47c0caa00bad3bb8b8e654172c887e4, 2021-01-28 18:57:12 -0800, Yi Wang, 9, 16, 25, LINK), (9f19843d192a7be48fbef4aa08f7533644157b78, 2021-01-25 22:35:13 -0800, Yi Wang, 10, 10, 20, LINK), (ffaae32d602c56b538c2e9b586e89a037afedca9, 2021-01-25 22:35:13 -0800, Yi Wang, 67, 3, 70, LINK), (439afda090a343e90aa87678a0019c0dc26880cc, 2021-01-20 22:29:10 -0800, Yi Wang, 32, 32, 64, LINK), (88c33ff8abf7038112d5985a8900d91c4c441a15, 2020-12-22 23:20:04 -0800, Yi Wang, 2, 2, 4, LINK), (af1b636b89a99a7b4520fa9c3edd4c8e30969c6f, 2020-12-22 21:35:24 -0800, Yi Wang, 2, 2, 4, LINK), (c348faedc4c3e48182a9b2d74f1da861624d0f87, 2020-12-22 01:17:22 -0800, Yi Wang, 142, 54, 196, LINK), (f4fd894b1b58d7a10d49cdde8e8b9412b19d583e, 2020-12-20 19:08:23 -0800, wayi, 4, 2, 6, LINK), (26dee03807e955beecb90bbdd77a33d02db34b6f, 2020-12-20 19:08:20 -0800, wayi, 31, 0, 31, LINK), (96aed203bf8259c221948595a02d85dfafcec8cb, 2020-12-20 17:21:03 -0800, Yi Wang, 4, 2, 6, LINK), (342bfd892fc2702904414a6836cfa1247fe0d0ec, 2020-12-20 17:21:03 -0800, Yi Wang, 31, 0, 31, LINK), (71f3399e19dd0e48b3360e0b973803ea408c315a, 2020-12-18 17:59:59 -0800, Yi Wang, 243, 2, 245, LINK), (f9638ab878f826c84f5b9bbbff830e209dc1b145, 2020-12-15 15:26:02 -0800, wayi, 4, 2, 6, LINK), (8ea4faf022b7aad0d8b095648ad1e3a356cbc8bc, 2020-12-15 12:28:53 -0800, wayi, 1, 1, 2, LINK), (bcdaf5bf14170c603d17714efa5ebe21dc2b6f86, 2020-12-15 11:25:31 -0800, wayi, 31, 0, 31, LINK), (38ac6652c71cde8478f5fd6e4d1398545584c7a6, 2020-12-15 11:25:22 -0800, wayi, 243, 2, 245, LINK), (a419a3e25d0120a9bffbb5d8fe50fd525e00404c, 2020-12-14 20:13:57 -0800, Yi Wang, 3, 3, 6, LINK), (29f0fa36b1f78117a60378a8e5df5c284e1e346d, 2020-12-11 17:43:59 -0800, Yi Wang, 2, 2, 4, LINK), (c876d4f477fdebfa8acbc3ebd8042ea8f5ed36dc, 2020-12-07 17:37:59 -0800, Yi Wang, 8, 2, 10, LINK), (17f53bffefa7bd46e134a99bcd4c4e471b81c86b, 2020-12-05 23:51:34 -0800, Yi Wang, 22, 9, 31, LINK), (7439bc4dd61b0d7b252bc441113fa9de53446cca, 2020-12-05 01:38:35 -0800, Yi Wang, 22, 5, 27, LINK), (9c6979a266b0f581db6c5cf9236b7ac52ddf16ee, 2020-12-02 06:37:51 -0800, Yi Wang, 51, 4, 55, LINK), (ddb6594971d741f75b3b5c4c8c7b72e5e13c7294, 2020-11-30 18:39:06 -0800, Yi Wang, 33, 20, 53, LINK), (cac553cf34805d5fd26e0e412ce6ce0f887d1ea6, 2020-11-21 09:18:10 -0800, Yi Wang, 622, 341, 963, LINK), (6400d27bbbbd7fb4d6d66c8d493fa6fa91d62998, 2020-11-21 09:18:10 -0800, Yi Wang, 71, 23, 94, LINK), (1a6666c967bb7f2d2120ee64d5e431d4e6cbfc8f, 2020-11-19 19:20:10 -0800, Yi Wang, 5, 1, 6, LINK), (daff3a81a172b0982979918ddfb06be94f4f6672, 2020-11-19 02:57:00 -0800, Yi Wang, 152, 11, 163, LINK), (fccfe7bd1a03f0b522f20605a972fe22c7e4aedc, 2020-11-05 23:40:54 -0800, Yi Wang, 96, 60, 156, LINK), (6b3802a7113b646e04c5d23394af89f0ec4bcda9, 2020-11-04 12:32:42 -0800, Yi Wang, 80, 11, 91, LINK)"
47257,1,3,0,3,"(c8872051e63e6b50cd963603698a0e790bb1bbd3, 2020-11-04 17:51:53 -0800, Pritam Damania, 3, 0, 3, LINK)"
47272,1,11,5,16,"(a1f494cb8b1ea94ac07e4b463a0b8e7ff1c40d92, 2020-11-17 21:40:15 -0800, Xiao Wang, 11, 5, 16, LINK)"
47292,1,7,0,7,"(e8a73fbf34b796f270f8d07ea0b5d8643beeb302, 2020-11-11 16:32:09 -0800, Nikita Shulga, 7, 0, 7, LINK)"
47295,1,24,10,34,"(370350c749c2c6b09f783d74a8b3e4c233c8b135, 2020-12-23 10:56:20 -0800, Akshit Khurana, 24, 10, 34, LINK)"
47304,2,50,47,97,"(b1a4170ab3add6347f69ae11ffb43b0345ba9d78, 2020-11-12 12:31:19 -0800, Nick Gibson, 37, 46, 83, LINK), (f42cdc2e43351f8fc77c7d399bcbd398215f5404, 2020-11-12 11:00:16 -0800, Nick Gibson, 13, 1, 14, LINK)"
47330,1,36,2,38,"(71cfb73755f6e978828683a54468ce48fb44d44f, 2020-12-09 05:09:42 -0800, Sidney Fletcher, 36, 2, 38, LINK)"
47352,2,12,3,15,"(5cba3cec5a1ff01b4c952ec286cf61d945ff4a64, 2020-11-10 11:32:34 -0800, Yuxin Wu, 9, 1, 10, LINK), (611080a118fff166c85f3200d860f3b059abac6f, 2020-11-06 10:02:05 -0800, Rong Rong, 3, 2, 5, LINK)"
47358,2,26,130,156,"(99778852350de243937c5f3af107f96ef6271e99, 2020-11-19 12:24:59 -0500, gchanan, 13, 65, 78, LINK), (baa2f777c87ed77583d1d89973b095581c34d606, 2020-11-10 14:47:33 -0800, kshitij12345, 13, 65, 78, LINK)"
47377,1,13,4,17,"(abae12ba41c02f2f40bdbcf9aa3438b08425d4c5, 2020-11-10 07:53:54 -0800, Simon Geisler, 13, 4, 17, LINK)"
47379,1,13,2,15,"(a62b0deae07980147e0eb165208ea21862b6b702, 2021-02-20 02:51:18 -0800, Yuxin Wu, 13, 2, 15, LINK)"
47395,1,18,1,19,"(eed4a57d544efa8276357d033e2487e3f76b1519, 2020-11-05 10:27:02 -0800, Nikita Shulga, 18, 1, 19, LINK)"
47397,1,19,30,49,"(848901f2768bce1d843f9a5685aa452532386198, 2020-11-04 16:52:32 -0800, Nikita Shulga, 19, 30, 49, LINK)"
47405,1,147,4,151,"(d6b374956f97b2b0cd6e13114a989c0a00fa3044, 2020-11-19 20:38:13 -0800, Meghan Lele, 147, 4, 151, LINK)"
47443,1,2,2,4,"(ef50c94e7ccb67129935b5c64747f2a5645790f8, 2020-12-03 06:48:51 -0800, Rong Rong, 2, 2, 4, LINK)"
47445,1,17,12,29,"(54ce171f16c8859f829dde09f87c364c8a6b4130, 2021-01-08 06:56:10 -0800, Tongzhou Wang, 17, 12, 29, LINK)"
47449,1,2,1,3,"(febc76a5c69302c7d4b481632bcbd25e5d9b76ca, 2020-11-10 14:55:41 -0800, Rong Rong, 2, 1, 3, LINK)"
47460,1,5,5,10,"(a08e8dd70c55e9b62c917227a314384b16403c9e, 2020-11-09 11:36:56 -0800, peter, 5, 5, 10, LINK)"
47493,2,61,1,62,"(b12d645c2f64f7e5ad272c0eea02cb2b6026e9e0, 2020-11-16 13:01:14 -0800, Gao Xiang, 58, 0, 58, LINK), (e8fecd5caf550fd89b03e8c0b66868c4d6c7a393, 2020-11-13 16:38:05 -0800, Xiang Gao, 3, 1, 4, LINK)"
47496,1,163,38,201,"(60ed8fb244610beaf92ca37bdee61748a6968b69, 2021-03-09 16:07:39 -0800, Meghan Lele, 163, 38, 201, LINK)"
47500,1,75,4,79,"(497b7725477435dbe9f8eb230043bd6bed8aa449, 2021-02-11 11:51:15 -0800, Nikita Shulga, 75, 4, 79, LINK)"
4752,1,7,0,7,"(5403f3bc1711fcb71de39cdf323884ee48b3a054, 2018-01-23 10:34:09 -0800, Christian Sarofeen, 7, 0, 7, REGEX)"
47528,1,33,1,34,"(8b248af35d43c97d0e437f6f4ff0fbd4da5700c8, 2020-11-26 08:08:04 -0800, Nikita Shulga, 33, 1, 34, LINK)"
47529,1,1,1,2,"(6214d0ad88faa1cce83883e41bca9ed0ba2c5ff7, 2020-11-09 11:33:39 -0800, Nikita Shulga, 1, 1, 2, LINK)"
47553,1,1,1,2,"(5f33f22324ef18c4ba1c9e0c51bdc918a6703c12, 2021-01-19 12:05:16 -0800, KumaTea, 1, 1, 2, LINK)"
47570,2,32,6,38,"(b3ac628081bed09542d4e3bbe5f428027a36e5ae, 2020-12-03 14:39:18 -0800, Meghan Lele, 23, 3, 26, LINK), (03d1978a1a18a0f2a43acc0cd08b38736bf2d8ff, 2020-11-13 11:44:27 -0800, Meghan Lele, 9, 3, 12, LINK)"
47596,1,5,8,13,"(d7c8d3cccb540bbcbfc537d0094ee3b73998ea04, 2020-11-12 09:57:12 -0800, Nikita Shulga, 5, 8, 13, LINK)"
47629,1,5,1,6,"(1606899dbe937b67d0d8b936382e5eb115372b24, 2020-11-13 23:57:53 -0800, Jagadish Krishnamoorthy, 5, 1, 6, LINK)"
47631,1,42,4,46,"(692726812b46704b6d2506e068f9b2917a3bafec, 2020-11-13 00:41:51 -0800, Meghan Lele, 42, 4, 46, LINK)"
4764,1,323,20,343,"(444039c47bb997f698c2bd9481c8649188038c51, 2019-02-19 08:17:49 -0800, Iurii Zdebskyi, 323, 20, 343, LINK)"
47671,1,78,39,117,"(ec51b6728288ee11592fc180497fd593fb3e0a36, 2021-01-11 12:51:08 -0800, Howard Huang, 78, 39, 117, LINK)"
47679,1,10,19,29,"(5375a479aa467028f5f287f4864845b2e7deddd9, 2020-12-09 17:10:23 -0800, Guilherme Leobas, 10, 19, 29, LINK)"
47722,1,22,0,22,"(7d9eb6c6802e85193cdd6139833ff66dc0be228f, 2021-01-06 10:49:00 -0800, Joel Schlosser, 22, 0, 22, LINK)"
47748,1,8,1,9,"(ed20e327d759d469b05f17a5703e58c5fca8decd, 2020-11-12 23:29:43 -0800, Supriya Rao, 8, 1, 9, LINK)"
47754,1,34,0,34,"(8f8738ce5cfee961cc689cb38f16acdd8f4ad04c, 2020-11-30 14:20:58 -0800, Xiong Wei, 34, 0, 34, LINK)"
47755,1,62,0,62,"(909a9060e9f780c5ed7ba769d0fb11902a7b2ddf, 2020-12-10 10:56:50 -0800, Xiong Wei, 62, 0, 62, LINK)"
47757,1,14,23,37,"(cf92b0f3a068e7d941a140f573557d4fd764388f, 2020-11-16 13:00:24 -0800, Guilherme Leobas, 14, 23, 37, LINK)"
47776,1,2,2,4,"(aa8aa30a0bb93bc0b166c314ec0032629cdc93b7, 2020-11-19 19:21:49 -0800, Eli Uriegas, 2, 2, 4, LINK)"
47851,1,66,2,68,"(95ea778ac6fdc6854a391cb533233ffdd7ca5cc1, 2020-11-16 12:23:37 -0800, albanD, 66, 2, 68, LINK)"
47934,1,17,0,17,"(c0deb231db76dbea8a9d326401417f7d1ce96ed5, 2020-12-19 11:28:39 -0800, guol-fnst, 17, 0, 17, LINK)"
47948,1,32,0,32,"(b6654906c7e68eaa97b90a3bcc9eca7b9046ffc6, 2020-11-22 00:11:59 -0800, Kurt Mohler, 32, 0, 32, LINK)"
47979,1,2,2,4,"(e2b4c63dd987899cea6b6db3b02cdfee66c4010b, 2020-11-18 08:17:01 -0800, Guanheng Zhang, 2, 2, 4, LINK)"
48,2,119,61,180,"(b90cbb841d98aeae435b1d02b1ff211e028cdf5b, 2019-04-05 12:44:49 -0700, Joakim Rishaug, 1, 1, 2, LINK), (accd52feef29d40da9f1c4d9503806a1f34c07fc, 2017-08-04 08:24:16 -0700, Edward Z. Yang, 118, 60, 178, LINK)"
48032,1,5,3,8,"(8c00221fe2ad198364df64468af550e86d4c57e9, 2020-11-18 07:35:56 -0800, Samuel Aldana, 5, 3, 8, LINK)"
48043,1,41,23,64,"(0a42003f8f16e043c636dd2e2078a5c82bf21d7b, 2020-12-04 12:46:03 -0800, Elias Ellison, 41, 23, 64, LINK)"
48055,1,1,1,2,"(0387f2a6fa5db99e16bd8180565d1c7c55e72669, 2020-11-18 11:11:34 -0800, mx-iao, 1, 1, 2, LINK)"
4809,1,1,1,2,"(4c29d19f531691a8f8b709c9ad071ebbc540c1bc, 2018-01-25 10:44:16 -0500, Edward Z. Yang, 1, 1, 2, LINK)"
48110,2,185,6,191,"(c115957df086fd795abaae18c6b9bc1e80928a18, 2021-01-05 11:25:00 -0800, Jagadish Krishnamoorthy, 67, 4, 71, LINK), (43f6da787e02b49a9d219c5049165be71471ee9a, 2020-12-18 00:01:14 -0800, Pritam Damania, 118, 2, 120, LINK)"
48127,1,15,8,23,"(140e946fec7114f9b7058cf3b8afcd12792ce65c, 2020-11-18 11:09:56 -0800, Rohan Varma, 15, 8, 23, LINK)"
4814,1,44,23,67,"(7368c09280b08a00f3c640dbbc2a48b913c55647, 2018-03-09 20:52:54 -0800, Peter Goldsborough, 44, 23, 67, LINK)"
48174,1,36,0,36,"(9c0caf0384690cb67dcccb7066ece5184f72ca78, 2021-02-10 02:09:15 -0800, nikithamalgi, 36, 0, 36, LINK)"
48189,1,61,34,95,"(a4e13fcf3fe6b7a94d72dc33493a60ae8c750c19, 2020-12-02 14:43:03 -0800, Guilherme Leobas, 61, 34, 95, LINK)"
48200,1,26,25,51,"(15fc66d6c801bac4d838726c645ed7f718a6bd4e, 2020-12-02 11:48:16 -0800, jjsjann123, 26, 25, 51, LINK)"
48225,1,12,0,12,"(f96ce3305ccea78017c1504a7ba690f80ccdb2aa, 2021-01-04 14:37:02 -0800, mattip, 12, 0, 12, LINK)"
48230,1,236,403,639,"(b198cf4f1cad25c9bf6bb3f9a076d6428bb12e44, 2021-02-01 15:54:13 -0800, Nikita Vedeneev, 236, 403, 639, LINK)"
48299,1,11,11,22,"(3b25af02a4033f762275286d6d5d684209477997, 2020-12-02 08:33:49 -0800, Nikita Vedeneev, 11, 11, 22, LINK)"
48304,1,5,5,10,"(42e7cdc50a76c8f95299b3e2790cdafc4c4cf9fd, 2020-11-30 11:14:04 -0800, Joe Zhu, 5, 5, 10, LINK)"
48370,1,17,12,29,"(54ce171f16c8859f829dde09f87c364c8a6b4130, 2021-01-08 06:56:10 -0800, Tongzhou Wang, 17, 12, 29, LINK)"
48393,1,37,6,43,"(30324d1e71842b39eb06269854bbdc2d39e11bed, 2020-12-01 15:27:55 -0800, FNSTER, 37, 6, 43, LINK)"
48398,1,4,9,13,"(4d9d03fe47faf2edd1c6cd7e0f3e1c2b4078ec60, 2020-12-22 07:56:55 -0800, anjali411, 4, 9, 13, LINK)"
48462,1,6,8,14,"(2fe382e931ec5a31715c247fea2b292f7d72cb66, 2020-11-29 10:07:16 -0800, Guilherme Leobas, 6, 8, 14, LINK)"
48464,1,166,138,304,"(f2ba3c1621f798f7c91ae7604ca24704fff2a815, 2020-12-13 17:52:07 -0800, Pritam Damania, 166, 138, 304, LINK)"
48492,2,111,24,135,"(9dfbfe9fca39a21560ae856348856837eaaf849a, 2021-01-25 13:11:46 -0800, Guilherme Leobas, 57, 13, 70, LINK), (2ace4fc01e9d5ed1c2410a0630c378d26565b008, 2021-01-20 06:29:48 -0800, Guilherme Leobas, 54, 11, 65, LINK)"
48514,2,36,25,61,"(52f0af03f8882b72939476033a28067b0d219b3a, 2020-12-02 10:15:51 -0800, Jerry Zhang, 22, 13, 35, LINK), (d2e429864cb27318476537fea5e55e2beaaffc68, 2020-11-30 19:23:17 -0800, Jerry Zhang, 14, 12, 26, LINK)"
48527,1,6,5,11,"(3c5db30eaa49fe64163192c90aa7eee421c1b62d, 2020-12-02 09:43:56 -0800, peter, 6, 5, 11, LINK)"
48532,1,1,1,2,"(5bb2a87a9418c4d09b4a04fa99cdae3788900e52, 2020-11-30 06:46:31 -0800, Peter Bell, 1, 1, 2, LINK)"
48533,1,73,9,82,"(2b70bcd01416e2e1992d6aacf321f5d7cb1b9c28, 2020-12-08 13:19:10 -0800, Mikhail Zolotukhin, 73, 9, 82, LINK)"
48568,1,7,0,7,"(4816bf62d676325bf00ca7ad8716299d74a61cf2, 2021-01-19 15:09:24 -0800, zfenice, 7, 0, 7, LINK)"
4858,2,41,10,51,"(484395edfbb65a3e62a7ee90bf9c95a74f508b64, 2018-08-15 13:14:36 -0700, Thomas Viehmann, 15, 8, 23, LINK), (7cbe63da8621b6063c864527592db6b1c894804f, 2018-03-17 15:26:22 +0100, Thomas Viehmann, 26, 2, 28, LINK)"
48585,1,15,1,16,"(90a3049a9a0c8b18f94b658c0e04845281c3d7cf, 2020-12-02 15:42:39 -0800, kshitij12345, 15, 1, 16, LINK)"
48617,2,26,4,30,"(1d9b64d12680789d191b64397da24479a30b9b96, 2020-12-02 20:41:55 -0800, Eli Uriegas, 13, 2, 15, LINK), (780f2b9a9bea86f92909d2fe02662ed6cb451861, 2020-12-02 16:51:18 -0800, Eli Uriegas, 13, 2, 15, LINK)"
48634,1,2,2,4,"(069e68a2a4c3c4e6db04e54acf7048998e300fd7, 2021-01-22 22:30:09 -0800, mariosasko, 2, 2, 4, LINK)"
48635,1,73,63,136,"(3f9ff48ebb069e3fbab8af99088c584475ef6aa3, 2020-12-08 15:34:19 -0800, Meghan Lele, 73, 63, 136, LINK)"
48642,1,7,7,14,"(f61de25dfafbec24a6f6c4859efd4a7717fc471b, 2020-12-02 09:59:09 -0800, Ailing Zhang, 7, 7, 14, LINK)"
48643,1,21,4,25,"(b9acfcddeb3b320f142f07d8051e5e344480f939, 2021-02-08 11:16:52 -0800, Yanan Cao, 21, 4, 25, LINK)"
48666,1,132,51,183,"(4abca9067b0970da1cce2fd679be27e296eb4a6e, 2020-12-02 09:05:45 -0800, SsnL, 132, 51, 183, LINK)"
48674,2,24,6,30,"(62d6dfce58d276d3df82efd10ac8fb99ace35e36, 2020-12-02 13:20:47 -0800, Nikita Shulga, 12, 3, 15, LINK), (071344debe51a3fb0bdc50ea4e0959ef14faa00f, 2020-12-02 09:54:37 -0800, Nikita Shulga, 12, 3, 15, LINK)"
4869,1,1,1,2,"(c65bd6660e1f9da92c331382ab73c1ca87820f3e, 2018-02-04 07:36:22 -0800, Simeon Monov, 1, 1, 2, LINK)"
48709,2,57,28,85,"(f92713b541d38f7d5922a2d667942dd1cde240d1, 2021-02-10 10:59:49 -0500, ErjiaGuan, 30, 14, 44, LINK), (f0d8524d23ef8934f6275f031f2c9c55fdab8c57, 2021-02-09 17:44:05 -0500, ErjiaGuan, 27, 14, 41, LINK)"
48716,2,8,8,16,"(e429d05015bfa878f2ae660a1e0dd96b51d743d5, 2020-12-06 10:21:08 -0800, Vasilis Vryniotis, 5, 5, 10, LINK), (0484b048d050ea5b10cb0efd147148aa893f2a4b, 2020-12-03 05:34:53 -0800, Vasilis Vryniotis, 3, 3, 6, LINK)"
48724,1,11,1,12,"(e1bb476980e5a3448d185ba69107f7cea862f4d0, 2021-01-20 09:20:57 -0800, Mark Final, 11, 1, 12, LINK)"
48733,1,8,0,8,"(924b001b71555cfd58b31249a2eb7963627f2fc8, 2020-12-07 11:12:08 -0800, Hui Guo, 8, 0, 8, LINK)"
48746,2,2,2,4,"(5431d87c3e4a2d88a62605b64d110b45692a34e9, 2021-02-10 17:43:59 -0800, Meghan Lele, 1, 1, 2, LINK), (a480ca53028658ec32ee18183a40cda60304663a, 2020-12-10 13:09:16 -0800, Meghan Lele, 1, 1, 2, LINK)"
48764,1,1,1,2,"(e7038a77256c9b479d9e82a3552c78b26130978d, 2020-12-03 12:36:55 -0800, Richard Barnes, 1, 1, 2, LINK)"
48771,2,44,44,88,"(aebb7d1836ad513c6eaec16b8ad6a6426a1be9ee, 2020-12-21 12:56:25 -0800, Hui Guo, 22, 22, 44, LINK), (7fd493128f3ee779c1b9c3e5e44e48faaa7a061c, 2020-12-09 11:38:30 -0800, Hui Guo, 22, 22, 44, LINK)"
48835,1,5,5,10,"(e429d05015bfa878f2ae660a1e0dd96b51d743d5, 2020-12-06 10:21:08 -0800, Vasilis Vryniotis, 5, 5, 10, LINK)"
48841,1,19,7,26,"(6aa5148df21d5583cf2ae3f95c992d207ed2e281, 2021-03-10 00:33:06 -0800, Natalia Gimelshein, 19, 7, 26, LINK)"
48870,1,8,8,16,"(1febd2225b03516340a4c799c4920e0d3dc82417, 2020-12-07 08:05:25 -0800, Nikita Shulga, 8, 8, 16, LINK)"
48873,1,3,3,6,"(88b3d3371b668e2e3f89218629d764a8e5868f0c, 2020-12-11 08:08:40 -0800, Rong Rong, 3, 3, 6, LINK)"
48874,1,1,3,4,"(c29f51642ecc41da3a6a40e7685ef4decce8bbf3, 2020-12-08 07:52:52 -0800, Nikita Shulga, 1, 3, 4, LINK)"
48879,1,78,54,132,"(69522410fa1032d5af18105e03d9769021a69a6c, 2020-12-10 15:19:57 -0800, Rong Rong, 78, 54, 132, LINK)"
48895,1,2,2,4,"(5450614cf6d9b588d9ab59e9ce39c520f5415677, 2020-12-08 19:36:47 -0800, peterjc123, 2, 2, 4, LINK)"
48901,1,1,2,3,"(a0432a7020c229bce76aa22d76e57859df0d43e4, 2020-12-14 10:07:56 -0800, Sebastian Pop, 1, 2, 3, LINK)"
48903,1,6,6,12,"(a6257b2fe2b646ef7fe0aa900022400920bb3e3e, 2021-01-25 07:42:17 -0800, Edward Yang, 6, 6, 12, LINK)"
48968,1,52,17,69,"(a9e46f1413d14dab77ac3da1703e17459d491c40, 2021-01-19 15:04:32 -0800, Guilherme Leobas, 52, 17, 69, LINK)"
48996,2,21,14,35,"(a7cf04ec40e487286ad3f8068fa18321f3474dd2, 2021-01-25 13:32:12 -0800, Heitor Schueroff, 20, 14, 34, LINK), (a849f3822232770bc46433623271b52b8d397166, 2020-12-09 00:42:12 -0800, X Wang, 1, 0, 1, LINK)"
49,2,1956,28,1984,"(b90cbb841d98aeae435b1d02b1ff211e028cdf5b, 2019-04-05 12:44:49 -0700, Joakim Rishaug, 1, 1, 2, LINK), (8215d7a4baed0811361c5be31fd0e42493fd21e6, 2017-01-15 13:31:01 +0100, Janusz Marcinkiewicz, 1955, 27, 1982, LINK)"
49010,1,4,1,5,"(f431e47a2eaffe33ec69f2a6330fa7228c084962, 2020-12-09 15:20:50 -0800, peterjc123, 4, 1, 5, LINK)"
49019,1,64,2,66,"(be091600eddada5c47377b93db922263910840c7, 2020-12-22 14:31:55 -0800, Rong Rong AI Infra, 64, 2, 66, LINK)"
49034,1,9,11,20,"(4411b5ac57831bc921500f0067bc3ed2e6ac8604, 2021-01-12 07:38:28 -0800, Guilherme Leobas, 9, 11, 20, LINK)"
49044,1,44,26,70,"(5f8e1a1da9c27ce1077661aeac97c05fea5858f8, 2021-01-11 16:59:55 -0800, Guilherme Leobas, 44, 26, 70, LINK)"
49052,1,24,11,35,"(7eb392d73f897f51b0be97749ca6231ee38e58a4, 2020-12-21 19:02:30 -0800, Howard Huang, 24, 11, 35, LINK)"
4908,1,13,30,43,"(4563e190c4e5b18322a36064854409c0fb51f32e, 2018-03-30 16:39:22 -0400, Tongzhou Wang, 13, 30, 43, LINK)"
49091,1,38,80,118,"(5ab95930987f8be75d56801d2a0cf9e2593c0fdb, 2020-12-18 16:13:38 -0800, Jeffrey Wan, 38, 80, 118, LINK)"
49159,2,4,4,8,"(bcb64a80841c55dc75e5d9a1bfcff768d5e9504e, 2021-02-18 15:46:39 -0500, gchanan, 2, 2, 4, LINK), (f72b4b83febd81e6969e0c02cc87f6be71f9dcf3, 2021-02-18 09:12:19 -0800, Gregory Chanan, 2, 2, 4, LINK)"
49214,1,3,0,3,"(2df249f0ab9c3f79d084980f8e8df2f258e1fde3, 2020-12-22 07:28:17 -0800, kshitij12345, 3, 0, 3, LINK)"
49219,1,46,80,126,"(4188c374ceaf644f4fdb0d8774853465da31ca4d, 2020-12-14 12:19:11 -0800, Yi Zhang, 46, 80, 126, LINK)"
49299,1,293,113,406,"(ea087e2d92461c461f4c5b0a31fde997813cb7c3, 2021-01-08 19:59:58 -0800, Thomas Viehmann, 293, 113, 406, LINK)"
49362,1,24,0,24,"(26e076d19e6936c9fd548412e15c0c815c588762, 2020-12-17 00:25:50 -0800, Nikitha Malgi, 24, 0, 24, LINK)"
49432,1,2,2,4,"(befe337072703c7466affc1fec097cf6132ac62d, 2020-12-21 14:27:54 -0800, Nikita Shulga, 2, 2, 4, LINK)"
49462,1,6,4,10,"(d0fb55454b775fde7dca4624bcff81ed00549633, 2020-12-16 15:32:57 -0800, Nikita Shulga, 6, 4, 10, LINK)"
49478,1,5,8,13,"(aa18d174553e1c2ab4d9e09ae45c6ac323f04af5, 2021-01-08 13:47:41 -0800, Guilherme Leobas, 5, 8, 13, LINK)"
495,1,4,4,8,"(5e02136dcf59428e71b3d2443e348457cc44a4c3, 2016-02-02 16:02:43 -0500, Soumith Chintala, 4, 4, 8, LINK)"
49596,1,13,5,18,"(6f381de006f1314e6508f1f31a0e172932d0952d, 2020-12-18 17:07:05 -0800, Nikita Shulga, 13, 5, 18, LINK)"
496,1,48,9,57,"(3e467b1b21d84800848b287b4237810a5415186b, 2016-01-23 18:02:54 +0100, Cédric Deltheil, 48, 9, 57, LINK)"
49601,1,228,132,360,"(db86dd8ad78952e7250dd2d2c3c616d7ecb27b44, 2021-01-20 11:47:40 -0800, Xiao Wang, 228, 132, 360, LINK)"
49617,2,78,76,154,"(00adc7b07f5f89af1c9d3db36c656233566b92e7, 2021-01-27 10:49:10 -0800, Nikita Shulga, 62, 69, 131, LINK), (a949d7b1c85aa79981287ba297aaf0aade94d6e4, 2021-01-26 12:41:09 -0800, Nikita Shulga, 16, 7, 23, LINK)"
4965,1,8,1,9,"(dc94182db0f320f09894a99eb169fe83631e8440, 2018-04-17 20:34:33 -0700, Simeon Monov, 8, 1, 9, LINK)"
49652,2,13,3,16,"(e16036283726dd12bb29a0e70b115c903ef03587, 2021-01-11 15:15:07 -0800, Alban Desmaison, 2, 0, 2, LINK), (fc2ead094471dad946f9f44e903b02aea5324021, 2021-01-08 05:28:32 -0800, Alban Desmaison, 11, 3, 14, LINK)"
49656,1,3,0,3,"(45c0d64b33f5a0e068944ba34a80adddc49b047e, 2021-01-07 11:15:07 -0800, Nikita Shulga, 3, 0, 3, LINK)"
49660,1,6,6,12,"(4aea00735144b6a3422f83f0eb8365253e971237, 2021-01-20 02:02:10 -0800, Meghan Lele, 6, 6, 12, LINK)"
49683,1,201,171,372,"(0c313564af6173d54b393ae0b70cf2cb0db5a5c8, 2021-02-06 23:13:44 -0800, Alexander, 201, 171, 372, LINK)"
49728,2,82,0,82,"(9e5bcc10200f7a63d9114076e7db5f739222c15a, 2021-02-09 21:34:26 -0800, Yuxin Wu, 41, 0, 41, LINK), (fa701688040e84b4289184ab429ba693429740d4, 2021-02-06 10:11:30 -0800, nikithamalgi, 41, 0, 41, LINK)"
49730,1,23,12,35,"(bf4fcab68104b333c81e39d142dccc7ae7a6f1d7, 2021-01-07 18:29:00 -0800, Nikita Shulga, 23, 12, 35, LINK)"
49738,1,14,1,15,"(ee271047b5bcef5993db3582c759aeec966b98e8, 2020-12-22 22:22:11 -0800, Michael Carilli, 14, 1, 15, LINK)"
49739,1,4,1,5,"(04e86be1a202b755e296fbe759366f62e2b1ea43, 2021-01-05 10:52:49 -0800, Vasiliy Kuznetsov, 4, 1, 5, LINK)"
49756,1,16,5,21,"(8f0968f89905b3bb2e7cc5b05831ad8684ade2c8, 2021-02-02 09:26:00 -0800, Joel Schlosser, 16, 5, 21, LINK)"
49819,3,60,3,63,"(25562d3d418774598bd22d0fae875897a96a917b, 2021-02-17 09:49:30 -0800, Rohan Varma, 20, 1, 21, LINK), (906c56ac20b36b57e4c0cdbf4e7fc58dd7ecbf4a, 2021-02-13 00:55:20 -0800, Rohan Varma, 20, 1, 21, LINK), (a86027ded33a882d841d16c53b1f8f90a40baf5f, 2021-02-13 00:55:20 -0800, Rohan Varma, 20, 1, 21, LINK)"
4985,1,18,2,20,"(ea3c36b822a7940bad6f0f7bad67f04afa8f5aa2, 2018-07-30 14:32:16 -0700, vishwakftw, 18, 2, 20, LINK)"
49878,1,38,2,40,"(36ddb00240604c328358d4c35cbb042674a8ecf8, 2021-01-08 18:08:55 -0800, kshitij12345, 38, 2, 40, LINK)"
4990,1,3,1,4,"(2f1493f1fb44d0a0610585dbb8295c950399d8ec, 2018-02-13 02:11:15 +0800, peterjc123, 3, 1, 4, LINK)"
49901,1,4,0,4,"(0abe7f5ef6f80e1a92072a555b78308c3e29b5dd, 2021-01-14 08:00:07 -0800, Rong Rong AI Infra, 4, 0, 4, LINK)"
49918,1,25,13,38,"(74c055b24065d0202aecdf4bc837d3698d1639e1, 2021-01-06 09:45:15 -0800, Loi Ly, 25, 13, 38, LINK)"
49928,1,31,4,35,"(444203c52fe116a988bca8c71ab101aeabb88335, 2021-02-02 20:35:21 -0800, wanyu2018umac, 31, 4, 35, LINK)"
49932,1,18,3,21,"(c51455a7bbeb71956023c49116f428097dc223af, 2021-01-04 19:54:01 -0800, Brandon Lin, 18, 3, 21, LINK)"
49969,1,191,4,195,"(86861095fa0644a98e916ef770861cd312b93935, 2021-02-04 01:32:42 -0800, Thomas Viehmann, 191, 4, 195, LINK)"
49982,1,6,14,20,"(314351d0ef9aedb4f39936141c62b604eef40533, 2021-01-12 05:39:39 -0800, dheerajgattupalli, 6, 14, 20, LINK)"
5,7,26,18,44,"(0b93974075844601913c6df50f6566418a35eee8, 2021-02-25 14:32:13 -0800, Akao Kazutoshi, 2, 2, 4, LINK), (7e6d932208a866551ca1b9ea7f149d48eb3ad413, 2019-06-05 18:03:51 -0700, Junjie Bai, 7, 1, 8, LINK), (b90cbb841d98aeae435b1d02b1ff211e028cdf5b, 2019-04-05 12:44:49 -0700, Joakim Rishaug, 1, 1, 2, LINK), (cb2ea1770791ac5a942f51d1cb1268e288abe86b, 2019-03-15 16:43:18 -0700, Jack Montgomery, 5, 3, 8, LINK), (be6ad7ddde64cebeec4cd9537ddc3bca9cbe18e5, 2019-02-22 07:54:47 -0800, Will Feng, 8, 8, 16, LINK), (4664808938b22c22abd216008926ecd81cb0c5e5, 2017-09-24 17:07:30 -0700, Igor Sugak, 1, 1, 2, LINK), (efda016108f16d4ac6087a3bcb0909729c1a7e11, 2017-09-13 23:17:05 -0700, Philip Pronin, 2, 2, 4, LINK)"
50002,1,1569,772,2341,"(f9185973d19d30e8522d29bead9b0789897f8652, 2021-03-10 16:38:36 -0800, hyperfraise, 1569, 772, 2341, LINK)"
50014,1,19,2,21,"(6f3aa58d8023757ce7eabeee48fa86f8ed6308b8, 2021-01-26 13:21:08 -0800, Nikita Shulga, 19, 2, 21, LINK)"
5006,1,527,6,533,"(e22095b09d19f2b9aa964ea10139eb11340624fd, 2018-02-02 11:14:56 -0500, Edward Z. Yang, 527, 6, 533, LINK)"
50064,2,51,55,106,"(3f052ba07b2da4801d8f52f4116357760d5b632d, 2021-01-17 21:57:54 -0800, 76181208+imaginary-person@users.noreply.github.com, 48, 52, 100, LINK), (6420071b43dc9f2679c22952b5051b0c28f42da2, 2021-01-12 07:53:23 -0800, Sanchit Jain, 3, 3, 6, LINK)"
5011,1,36,22,58,"(483ae8cb5d28791ed668240965c01ca015a46733, 2018-07-12 07:54:59 -0700, Mary McBreen, 36, 22, 58, LINK)"
50211,1,1,1,2,"(8f31621f78789e3179007dfde5087bda85c3bb29, 2021-01-08 13:14:33 -0800, Antonio Cuni, 1, 1, 2, LINK)"
50234,1,169,89,258,"(db079a9877ec051ff14cb3f435b4bab6ddb6e777, 2021-01-22 11:55:15 -0800, Peter Bell, 169, 89, 258, LINK)"
5024,1,362,0,362,"(f3e16cc7371576ffa1cd04a4553fa326f16c48e0, 2018-03-23 14:49:32 -0700, Vedanuj Goswami, 362, 0, 362, LINK)"
5025,1,1,1,2,"(0cb52cb4580ef021a3e58345644aa8e5448d80fc, 2020-08-21 05:48:15 -0700, rakshithvasudev, 1, 1, 2, LINK)"
50287,4,23,11,34,"(c6f37e50f27d74389443352d4d3ca1898f087862, 2021-02-02 07:51:53 -0800, Heitor Schueroff, 3, 2, 5, LINK), (1caed167fb689ba9d768cc9b00c552550b97c513, 2021-02-02 07:51:53 -0800, Heitor Schueroff, 10, 4, 14, LINK), (8fa328f88e12d55a216e3274a013767a6a7626f6, 2021-02-01 15:34:39 -0800, Heitor Schueroff, 4, 0, 4, LINK), (8583f7cbe25206fcc22d56a7e05693a06f411e5f, 2021-02-01 15:34:39 -0800, Heitor Schueroff, 6, 5, 11, LINK)"
50378,1,31,16,47,"(e2041ce3540a08dcdc70eaef86b13ca84b31ebd5, 2021-01-26 16:59:24 -0800, neerajprad, 31, 16, 47, LINK)"
50381,1,2,9,11,"(38eb83638724fa87d4bbaca5787a5813c97dc413, 2021-02-02 15:22:25 -0800, kshitij12345, 2, 9, 11, LINK)"
5039,1,1,3,4,"(10fd272b7ab4b9e5ebd63120ca17cc16086e1152, 2018-02-26 13:55:08 +0800, Kaiyu Shi, 1, 3, 4, LINK)"
50404,2,11,4,15,"(3dcf126c31142d656e4c17ee5e6aade36fe2b260, 2021-01-14 10:11:59 -0800, Fritz Obermeyer, 8, 2, 10, LINK), (fc9f013cea7ef098ed4d12ccda3b039133818856, 2021-01-13 22:05:52 -0800, Feynman Liang, 3, 2, 5, LINK)"
50429,1,2,1,3,"(b2f7ff7d2928e33af090b5bbfdeffd803a5d051e, 2021-01-12 12:42:58 -0800, Jan, 2, 1, 3, LINK)"
50439,2,66,9,75,"(42929e573a6c974cab6206cf74b9ffa68965e566, 2021-01-26 20:13:57 -0800, David Clissold, 1, 0, 1, LINK), (57fb2c0fcce9f5d77816012a60f71f8c2d18d670, 2021-01-21 19:55:16 -0800, Nikita Shulga, 65, 9, 74, LINK)"
50454,1,23,5,28,"(bd6248106b3246f5b4879ec817771d0775c6b87e, 2021-02-10 11:03:55 -0800, Thomas Viehmann, 23, 5, 28, LINK)"
50496,2,719,154,873,"(a347c747df8302acc0007a26f23ecf3355a5bef9, 2021-01-25 16:31:30 -0800, Fritz Obermeyer, 557, 124, 681, LINK), (21c2542b6a9faafce0b6a3e1583a07b3fba9269d, 2021-01-21 18:40:17 -0800, Fritz Obermeyer, 162, 30, 192, LINK)"
5055,1,10,8,18,"(5816721e3514789a6bd549b91fbfbd333779b229, 2018-02-07 21:49:16 -0800, Simeon Monov, 10, 8, 18, LINK)"
5062,1,144,26,170,"(43a9d6fb6e7e68d6fd08cc5d2b69d4299a4b9851, 2020-11-16 19:16:55 -0800, Bram Wasti, 144, 26, 170, LINK)"
50661,1,7,5,12,"(fd582af06c1daf191fda1fd458d1f94aac107b68, 2021-03-02 18:38:33 -0800, Yi Zhang, 7, 5, 12, LINK)"
50662,1,1,1,2,"(edaa23c8ab08a95c6f29b038014d110690afc49a, 2021-01-29 10:42:14 -0800, Yi Zhang, 1, 1, 2, LINK)"
50679,1,3,18,21,"(5021582fe691dcd5b9cb1c7087677fd21f789d78, 2021-01-29 11:04:07 -0800, Rohan Varma, 3, 18, 21, LINK)"
50695,4,578,2,580,"(5bb69b080cb31cd0773c97ffa1ad6b06d9abb38f, 2021-02-09 10:16:12 -0800, Rong Rong, 65, 1, 66, LINK), (9cbefad83f79e0e277f3cdfd39b42787e20f5ebd, 2021-02-08 08:23:56 -0800, mattip, 65, 1, 66, LINK), (9f6e0de5485900eed3d5e2438b4797e8744ce088, 2021-01-28 14:31:07 -0800, Matti Picus, 1, 0, 1, LINK), (24eab1d80dc45d545fb2622574782affadb3b61e, 2021-01-26 14:52:46 -0800, mattip, 447, 0, 447, LINK)"
50730,1,2,2,4,"(66adfcd25859ed92075969b7b8fd67b5341931c6, 2021-01-20 09:32:16 -0800, Eli Uriegas, 2, 2, 4, LINK)"
50792,1,6,2,8,"(7cb4712b381fa112d495e88c3f573059d4b0df6d, 2021-01-22 11:11:09 -0800, narain pattabhiraman, 6, 2, 8, LINK)"
50839,1,12,19,31,"(f0e72e54cc3049e986adc5bff314dd0b649c780b, 2021-01-22 13:57:44 -0800, Shen Li, 12, 19, 31, LINK)"
50881,1,12,19,31,"(f0e72e54cc3049e986adc5bff314dd0b649c780b, 2021-01-22 13:57:44 -0800, Shen Li, 12, 19, 31, LINK)"
50893,1,19,2,21,"(6f3aa58d8023757ce7eabeee48fa86f8ed6308b8, 2021-01-26 13:21:08 -0800, Nikita Shulga, 19, 2, 21, LINK)"
50960,1,21,12,33,"(59ac0ff03709f6fb690918e0cd5717a0716c2eb6, 2021-02-24 09:47:56 -0800, Nikita Shulga, 21, 12, 33, LINK)"
50967,1,93,20,113,"(ad3319cbc21ce9cd2139ecebe99379c20cfda3af, 2021-02-22 12:01:58 -0800, kshitij12345, 93, 20, 113, LINK)"
50980,1,16,5,21,"(773c71cb3ae9b8375e5aef2d628b926d7f151509, 2021-01-27 21:48:43 -0800, Hao Lu, 16, 5, 21, LINK)"
5101,1,4,0,4,"(ef0ef70cf51f056d9a38ce81abdf1f1b78ac7568, 2018-03-01 12:08:48 -0500, Edward Z. Yang, 4, 0, 4, LINK)"
51026,1,23,14,37,"(33973d45a963fec6a2f02b8183007019082b5574, 2021-02-05 11:50:15 -0800, Nikita Shulga, 23, 14, 37, LINK)"
51036,1,42,7,49,"(0e1c5cb35475935073569a2087f5fb5b7a8e673c, 2021-01-31 15:20:32 -0800, jiej, 42, 7, 49, LINK)"
51040,1,14,0,14,"(b955da3310d97c6058f5c555fa370c55330f1a44, 2021-01-28 08:14:35 -0800, Nikitha Malgi, 14, 0, 14, LINK)"
51042,1,34,2,36,"(52ab858f0710a74d06d6282e5cdb9a97d0789113, 2021-01-27 22:23:51 -0800, Peter Bell, 34, 2, 36, LINK)"
51098,1,15,2,17,"(751c30038feee49308abd71252beb69387d961d2, 2021-02-02 10:53:17 -0800, Meghan Lele, 15, 2, 17, LINK)"
51105,1,2,0,2,"(7b85adf20fee80a9b6a7329e70d0c35870f1a611, 2021-01-27 07:06:21 -0800, pbialecki, 2, 0, 2, LINK)"
51132,1,3,0,3,"(8b27c2ccca9cbe1f0a375091a0431b3d904f0cc2, 2021-01-28 12:08:41 -0800, Abdelrauf, 3, 0, 3, LINK)"
51144,2,202,34,236,"(1379842f4a9ca5843d9d75ac8d6879f6dffe2705, 2021-01-28 13:02:32 -0800, Richard Zou, 101, 17, 118, LINK), (0a61f13cf495db2dc02dafd9141a12445214cc61, 2021-01-27 09:53:57 -0800, Richard Zou, 101, 17, 118, LINK)"
51173,10,2394,942,3336,"(8737c2a1a2c55eb6c9b33f304b104cd32974e57e, 2021-03-11 23:50:14 -0800, Hui Guo, 527, 43, 570, LINK), (219bad03bce83ec4ac7ad6fbd2e819cc9e89d249, 2021-03-11 12:09:18 -0800, Hui Guo, 13, 20, 33, LINK), (56bbae317609bf781f7d343bbfe50098f6e0d9a1, 2021-03-11 12:09:18 -0800, Hui Guo, 527, 43, 570, LINK), (07d315fce876dc4379bbf99bc756aa4b544a1e47, 2021-03-11 07:15:16 -0800, Edward Yang, 43, 534, 577, LINK), (1f01899e4a2c04063fd8305ee304f063c04edc78, 2021-03-10 18:29:49 -0800, Hui Guo, 534, 43, 577, LINK), (71c00ec4eeda2352507a3f6721b652754cc07fef, 2021-03-10 13:28:21 -0800, Hui Guo, 20, 1, 21, LINK), (a21626161cb93f6ab962637c024f9a6001e76bb4, 2021-03-07 19:04:53 -0800, Hui Guo, 40, 27, 67, LINK), (845fc667b27e5295ea68311778948a0ba78b1a26, 2021-03-05 18:01:29 -0800, Hui Guo, 112, 70, 182, LINK), (056c9f36e68d209cae7e8295ee68d4464578c1e1, 2021-03-04 16:22:11 -0800, Hui Guo, 455, 161, 616, LINK), (12e8cd4773feaa05e24fa07d8e9b5ce88455aa1f, 2021-02-25 14:30:42 -0800, Hui Guo, 123, 0, 123, LINK)"
51234,1,22,35,57,"(43084d7aab26957602e3c495e7d27bb6c989084d, 2021-02-02 08:47:02 -0800, Guilherme Leobas, 22, 35, 57, LINK)"
51352,1,128,119,247,"(d90911adf97c0e3dc7829e232eff291932210a6f, 2021-02-08 11:41:13 -0800, XiaobingSuper, 128, 119, 247, LINK)"
51366,1,11,2,13,"(c41678fd53fd145af57a32b38fcdda5d6e6754c2, 2021-02-03 21:31:11 -0800, Kurt Mohler, 11, 2, 13, LINK)"
5138,1,35,21,56,"(0877558e607f14f63bc4761a31a1c9943da688b8, 2018-03-02 10:00:00 -0500, Edward Z. Yang, 35, 21, 56, LINK)"
51428,1,22,4,26,"(075bbe0d6aa9d5129870f91cc40a9890a5aed3ce, 2021-02-23 22:28:19 -0800, Szymon Migacz, 22, 4, 26, LINK)"
51438,1,14,2,16,"(3fec1e5025d12faa3f7eec91c82f92cfc77c9bee, 2021-02-04 14:31:36 -0800, XiaobingSuper, 14, 2, 16, LINK)"
5151,1,155,24,179,"(031412a14b7c20e9030b00c26f30c5524a0eb028, 2018-02-20 16:55:57 -0500, Edward Z. Yang, 155, 24, 179, LINK)"
51541,1,1,1,2,"(a5b65ae40a7d180f945d413739d7894cf51ef549, 2021-02-02 10:11:42 -0800, Jan, 1, 1, 2, LINK)"
51544,1,4,1,5,"(1e2df9e46de4f40a141d4465e2e90e806c9dd73e, 2021-02-04 10:40:57 -0800, kshitij12345, 4, 1, 5, LINK)"
51582,1,50,0,50,"(ecf81665228cf3554f164c0651579b5d682dfa64, 2021-02-04 06:22:42 -0800, nikithamalgi, 50, 0, 50, LINK)"
51592,1,4,4,8,"(1c64f862f6e03ce09152d45289dd37577c277aaf, 2021-02-19 20:02:05 -0800, David Clissold, 4, 4, 8, LINK)"
51621,1,176,80,256,"(8f15a2f052a8befcfbcf71e0d6b017e83a234714, 2021-03-10 11:26:15 -0800, Nikita Vedeneev, 176, 80, 256, LINK)"
51627,1,42,5,47,"(bd3ae117fc50bdd206d7ef84d43fca4b85c39733, 2021-02-03 21:16:58 -0800, anjali411, 42, 5, 47, LINK)"
51691,13,3461,2556,6017,"(1d6bd157902d4b1347a5d03122d02b407658e263, 2021-02-26 16:02:36 -0800, Meghan Lele, 197, 0, 197, LINK), (76bba93ef1ec66e19cf367e5d93ec260563d5dd5, 2021-02-24 11:01:12 -0800, Meghan Lele, 2405, 1690, 4095, LINK), (6b24daaf62653963760712ca3d927829f7449d50, 2021-02-17 22:25:22 -0800, Meghan Lele, 1, 1, 2, LINK), (c422dc6fdab28e5bae069838e50cf8fe026ff41a, 2021-02-17 21:12:11 -0800, Meghan Lele, 1, 1, 2, LINK), (974a35affee9a99f42fa5762c2967c26481e606e, 2021-02-17 20:24:12 -0800, Meghan Lele, 2, 2, 4, LINK), (b9d6cc95a4009d53f372f79dc29308b002c2f9d0, 2021-02-17 18:43:59 -0800, Meghan Lele, 4, 3, 7, LINK), (8d5464ffcfd84d6962c125643e3b0d822653f8ff, 2021-02-17 12:52:04 -0800, Meghan Lele, 17, 23, 40, LINK), (12bd63b2a03157c2f0045625a27b066d57788129, 2021-02-16 22:29:54 -0800, Meghan Lele, 2, 2, 4, LINK), (5a107ea33d18a099b7ea2c84ea7ba82dd0e1b2f5, 2021-02-16 21:38:43 -0800, Meghan Lele, 13, 0, 13, LINK), (2c933ab44985e495695e76ab3b6adfe225b9db49, 2021-02-16 20:13:05 -0800, Meghan Lele, 0, 8, 8, LINK), (1f3ea092eddec90901a7a6f05b53726ef74f3dff, 2021-02-16 17:44:58 -0800, Meghan Lele, 0, 1, 1, LINK), (f63f51c34dc8042ffaf60190ab432e97bbca7771, 2021-02-16 17:40:54 -0800, Meghan Lele, 8, 8, 16, LINK), (593ff66cce6e1deb01e3263f3530ae00a780bcea, 2021-02-11 12:09:18 -0800, Meghan Lele, 811, 817, 1628, LINK)"
517,1,3,3,6,"(da0634c124503f901acda66f64b966077fac2e82, 2016-02-04 13:23:54 +0000, ivpopov, 3, 3, 6, LINK)"
51730,1,9,0,9,"(39fa0b5d0a3b966a50dcd90b26e6c36942705d6d, 2021-02-25 09:33:52 -0800, pbialecki, 9, 0, 9, LINK)"
51735,1,48,2,50,"(5563248b5882231cb99105b042cc32bddd18b912, 2021-03-10 14:21:35 -0800, Elias Ellison, 48, 2, 50, LINK)"
518,1,2,3,5,"(94b35312d00a0c8a369ca28ee931a9bccc53909e, 2016-10-02 05:41:47 +0100, Ricardo Barreira, 2, 3, 5, LINK)"
51840,1,1,1,2,"(42635c3e597ed1c8d436d97220efb61047641baa, 2021-02-09 07:22:34 -0800, Chester Liu, 1, 1, 2, LINK)"
51889,2,44,36,80,"(f071020756be512be1e58392a48cef6603fbceae, 2021-02-12 08:00:46 -0800, Nikita Shulga, 22, 18, 40, LINK), (56034636b9f37b54dacfab8794e93ba6b10bdfc7, 2021-02-09 04:50:23 -0800, Nikita Shulga, 22, 18, 40, LINK)"
51930,3,48,0,48,"(8158c39b50cb936f1f6567d2777477cc50fc47e4, 2021-03-05 09:08:03 -0800, Nikitha Malgi, 16, 0, 16, LINK), (e4bf54d645b2202f87da7c306c632f8030032dd0, 2021-03-05 09:07:59 -0800, Nikitha Malgi, 16, 0, 16, LINK), (5ebfabb310d6b3c8b32d28314b3e4612d21f5d85, 2021-03-05 08:57:19 -0800, Peter Bell, 16, 0, 16, LINK)"
51949,1,31,12,43,"(5fda3b094c9247e7f0d9e0a76a78fa7b8a476774, 2021-02-19 08:16:58 -0800, kshitij12345, 31, 12, 43, LINK)"
51992,2,64,60,124,"(e36576d153a7d3197f743de257934b2fa1a7b1a9, 2021-03-01 12:39:11 -0800, Michael Carilli, 26, 26, 52, LINK), (a1b8f3d4b6ada3721a3d9d8266f86dcb04f17fcb, 2021-02-10 11:41:47 -0800, Jane Xu, 38, 34, 72, LINK)"
52002,2,26,22,48,"(68e2a8c420212e72576bf28e14400b904a5d5e1f, 2021-02-16 07:56:07 -0800, Jane Xu, 2, 4, 6, LINK), (bff81945225f5acc4f347abe7f9c96570a2bf1c4, 2021-02-10 17:54:34 -0800, Jane Xu, 24, 18, 42, LINK)"
52044,1,59,12,71,"(fe38027fc3d445cef0d7643f3a66e24005c5f49f, 2021-03-12 12:49:16 -0800, kshitij12345, 59, 12, 71, LINK)"
52075,1,28,3,31,"(de4c9ecc3584231a6000c3b56b062271e8b38e17, 2021-02-13 19:32:22 -0800, Nikita Shulga, 28, 3, 31, LINK)"
521,1,7,7,14,"(29c91c80a287f3dae71ac5584fabee4fc9150e7c, 2016-03-26 21:19:28 +0100, Francisco Massa, 7, 7, 14, LINK)"
52146,2,4,4,8,"(30baaef738324f95efabdeab130429d4977e89b9, 2021-03-16 11:45:50 -0700, Nikita Shulga, 2, 2, 4, LINK), (67794b14bb5d89a27026a87421b5b68cc60bb97e, 2021-02-22 21:09:24 -0800, Nikita Shulga, 2, 2, 4, LINK)"
52163,1,2,2,4,"(df837d0384398f1fac1000189d62b05e7ff0240d, 2021-02-15 08:57:41 -0800, Sergei Vorobev, 2, 2, 4, LINK)"
52213,1,33,5,38,"(e5e54ada6196b58ced1c16062808575837a3f08b, 2021-03-02 10:36:37 -0800, Natalia Gimelshein, 33, 5, 38, LINK)"
52217,1,55,3,58,"(e658d7c37b7a4bc1f9737b7f989f3ecfb963fc43, 2021-02-23 10:38:21 -0800, Tugsbayasgalan Manlaibaatar, 55, 3, 58, LINK)"
52254,1,12,20,32,"(983347fa25f84b352240b9e4c6532d42d4ea4741, 2021-02-18 09:51:19 -0800, Gregory Chanan, 12, 20, 32, LINK)"
52257,1,16,6,22,"(a39b1c42c184916ab0798fde7b23967702d003e9, 2021-02-22 14:44:58 -0800, Joel Schlosser, 16, 6, 22, LINK)"
5229,1,28,0,28,"(2078e4ed37533f7de04bc28c66739a6bd1042776, 2018-02-14 12:19:18 -0800, Simeon Monov, 28, 0, 28, LINK)"
5240,1,3,3,6,"(170b22a8f010bf064c6a83cba9c310933323df1a, 2018-02-15 12:44:25 -0800, Edward Z. Yang, 3, 3, 6, LINK)"
52436,2,42,4,46,"(38414d29a1b66e3b9a0b406160e042b3a898b964, 2021-03-12 02:42:06 -0800, BowenBao, 21, 2, 23, LINK), (e9b1434582248a95ddf7fc7c2c70cdcec9477d5f, 2021-02-25 16:13:03 -0800, David Fan, 21, 2, 23, LINK)"
52455,1,4,4,8,"(116d40220041560a8f535bff1564d98e33e44fa4, 2021-02-22 11:57:43 -0800, 76181208+imaginary-person@users.noreply.github.com, 4, 4, 8, LINK)"
52456,1,43,1,44,"(6557ea0509bace85689a72b401e0855a0993ec37, 2021-03-04 09:08:46 -0800, Joel Schlosser, 43, 1, 44, LINK)"
52463,1,21,2,23,"(3721962c33a64946bd3be8ce8c032c4e7d895d22, 2021-02-23 06:56:43 -0800, Nikita Shulga, 21, 2, 23, LINK)"
52467,1,2,2,4,"(a59c4039e0c9b451d62b3991d7c902be02a79996, 2021-02-22 19:00:11 -0800, peter, 2, 2, 4, LINK)"
52526,1,2,2,4,"(43f810fa96a0d2c40387c8c84f710926d9ede3c1, 2021-03-02 10:53:39 -0800, Nikita Shulga, 2, 2, 4, LINK)"
52554,1,1,0,1,"(fd5792f8570a703eb423a198695be19f7c503e33, 2021-02-22 16:17:09 -0800, Jeff Yang, 1, 0, 1, LINK)"
52568,1,1,1,2,"(b22b082cc8d0e59c651f6a886f59baee5590abd0, 2021-03-01 10:03:54 -0800, MY_, 1, 1, 2, LINK)"
52581,1,60,51,111,"(d4602b7e459c4ad19cf1f59cd157cc4937f8ba72, 2021-03-11 20:51:52 -0800, Horace He, 60, 51, 111, LINK)"
52715,1,68,9,77,"(a6b7da7dfe59aee53d052bc427b551f459ef424f, 2021-02-24 21:35:21 -0800, Xiang Gao, 68, 9, 77, LINK)"
52716,1,68,9,77,"(a6b7da7dfe59aee53d052bc427b551f459ef424f, 2021-02-24 21:35:21 -0800, Xiang Gao, 68, 9, 77, LINK)"
52724,1,30,2,32,"(0f3a3f22af833f9f2045dc7f3957e92d83168f13, 2021-02-25 16:09:55 -0800, neerajprad, 30, 2, 32, LINK)"
52773,1,84,32,116,"(aba33b0042026ac8e1272d33e12b2db8e2ef32b3, 2021-03-02 19:54:14 -0800, Mikhail Zolotukhin, 84, 32, 116, LINK)"
52774,1,377,450,827,"(d3b427a0e321e63743e387c183c8db44c22b4431, 2021-02-24 22:41:34 -0800, Mikhail Zolotukhin, 377, 450, 827, LINK)"
52776,1,3,0,3,"(57947c5d85cb2fc755773ebce2df06b1c7d177b0, 2021-02-24 22:41:34 -0800, Mikhail Zolotukhin, 3, 0, 3, LINK)"
52778,1,427,80,507,"(e22da0a5c48ade4b48a9442bef04461776a8ce30, 2021-03-01 20:35:17 -0800, Mikhail Zolotukhin, 427, 80, 507, LINK)"
52806,1,2,2,4,"(7f1693d95eacb385580b5f5b4f7d4a20820b0b37, 2021-02-27 07:43:35 -0800, danielgordon10, 2, 2, 4, LINK)"
52822,1,15,1,16,"(ef3765b992f2d88109f6aab0a641859f145b0a73, 2021-03-09 10:49:02 -0800, Xiao Wang, 15, 1, 16, LINK)"
52843,1,59,8,67,"(272dfc7bb998145e8c60e63ad4b06ac71eda5bf4, 2021-03-01 18:26:24 -0800, Nikita Shulga, 59, 8, 67, LINK)"
52857,1,1,1,2,"(44b9fcfb55e181d647b77270b1a77aa103eed97b, 2021-02-26 10:55:01 -0800, Nikita Shulga, 1, 1, 2, LINK)"
52907,1,12,6,18,"(8870c391e9fbb023ef2319f4a27b8020d353a79a, 2021-03-01 11:12:02 -0800, peter, 12, 6, 18, LINK)"
53000,1,93,5,98,"(aae188c529c9d964b9d6dd1d6e8a6e281b4cf798, 2021-03-02 00:32:05 -0800, Raghavan Raman, 93, 5, 98, LINK)"
53013,1,1,1,2,"(a0d1e701db66682411f3c2e56be9ab823359c0b5, 2021-03-05 22:10:08 -0800, Yukio Siraichi, 1, 1, 2, LINK)"
53030,1,12,0,12,"(e2ecfb60a6beb004f9c7d2c949973b977f8394f4, 2021-03-02 16:47:07 -0800, Thomas J. Fan, 12, 0, 12, LINK)"
53092,1,139,3,142,"(ef07a04072fe02ce62a8b28d52a0548a5229d5eb, 2021-03-12 18:47:24 -0800, Raghavan Raman, 139, 3, 142, LINK)"
5310,1,12,0,12,"(7a521177926ce0534673d13ea908709d902cb0d6, 2018-10-15 16:59:28 -0700, Konstantin Semianov, 12, 0, 12, LINK)"
53108,1,1,1,2,"(43906f9b8bf7749fca65be3a57de1e8cfb8ee6af, 2021-03-03 10:06:45 -0800, Benjamin Lefaudeux, 1, 1, 2, LINK)"
5311,1,0,4,4,"(e5678794ed43feb756417a5c56a3b2d0f38f792c, 2018-07-17 10:56:29 -0700, Edward Yang, 0, 4, 4, LINK)"
53182,1,48,4,52,"(8b9e3e6fd4477443d1aa7f738611776462146e07, 2021-03-11 11:25:46 -0800, kshitij12345, 48, 4, 52, LINK)"
53217,2,116,11,127,"(51592a9e0a3c30a7e927081f153bf8db5c66f15e, 2021-03-04 20:32:22 -0800, Meghan Lele, 59, 2, 61, LINK), (f1eedfa2c865e2c5f7c4fa67fd22d952af271306, 2021-03-04 20:32:22 -0800, Meghan Lele, 57, 9, 66, LINK)"
53237,1,2,10,12,"(89fce74d558c1f0832b99e3de5787d14a7f1d7f3, 2021-03-12 11:47:24 -0800, Alexander, 2, 10, 12, LINK)"
53272,1,6,6,12,"(8c54cd7f37a3c3ac61908a451ec648c54796b114, 2021-03-04 10:39:16 -0800, Edward Yang, 6, 6, 12, LINK)"
5331,1,2,2,4,"(7a36c132cef1c3256a26048251ef022f60e22f3e, 2018-02-23 15:35:51 -0600, avmgithub, 2, 2, 4, LINK)"
5332,1,61,2,63,"(8e22ef0cb257f52d069641bd281d28d12780d22a, 2018-03-23 11:53:31 -0400, Richard Zou, 61, 2, 63, LINK)"
53393,1,1,1,2,"(c3405e5ba1271d7c456ce151c10b899d06ccda85, 2021-03-05 11:46:31 -0800, Eli Uriegas, 1, 1, 2, LINK)"
53409,1,9,9,18,"(cdac61ecd4dec7523c942256d70223e90be333dd, 2021-03-11 13:47:24 -0800, skyline75489, 9, 9, 18, LINK)"
53413,1,2,81,83,"(5344c3ea9eb75941837ecd35e3a406be032af818, 2021-03-11 17:02:40 -0800, Pritam Damania, 2, 81, 83, LINK)"
53454,1,6,6,12,"(790326d49bcbc6e66295d66137d4fc08853e3ab6, 2021-03-14 01:11:09 -0800, Ivan Yashchuk, 6, 6, 12, LINK)"
53456,1,11,0,11,"(f62e9156dcb92a40ec3180d08371b44cde007ddd, 2021-03-12 11:49:58 -0800, Peter Bell, 11, 0, 11, LINK)"
53501,2,8,8,16,"(c439f85b16cd3fa263fc3d4471fab6c351012d09, 2021-03-12 20:31:29 -0500, mrshenli, 4, 4, 8, LINK), (115df4fa28efe7ff0b97b4cbaa12e3bf6ad35941, 2021-03-08 10:52:52 -0800, Shen Li, 4, 4, 8, LINK)"
53505,1,17,1,18,"(e13ef777a7f91bf9fb8cc0b92be7ac9c5057439b, 2021-03-10 10:11:44 -0800, Thomas Viehmann, 17, 1, 18, LINK)"
53517,1,34,0,34,"(bf88a4dad5b3c06f43a9ce07a51ec0ab0dbfe2d3, 2021-03-09 00:00:14 -0800, Yanan Cao, 34, 0, 34, LINK)"
53526,2,16,7,23,"(53c77e7d5db38942abe3c2829be1ef748b16b788, 2021-03-08 17:05:12 -0800, Howard Huang, 15, 7, 22, LINK), (1e306b9a719666d657aa8eabb04a23a9031cfdfc, 2021-03-08 11:21:25 -0800, Sam Estep, 1, 0, 1, LINK)"
53540,1,4,1,5,"(70a43425e010ce92b1d6682f28c6b9abfd6fe98e, 2021-03-10 11:54:48 -0800, Jean Kossaifi, 4, 1, 5, LINK)"
53565,2,86,8,94,"(c6139b7915a9544c0c1cf1474f3c681a69dc86af, 2021-03-16 11:46:19 -0700, Nikita Shulga, 43, 4, 47, LINK), (f2689b1e1302f784c822bbd6697f53e39df59bb1, 2021-03-13 11:18:39 -0800, Nikita Shulga, 43, 4, 47, LINK)"
53587,3,191,51,242,"(547f43576399eb4237eb005ffb91039f29bdab58, 2021-03-14 20:36:59 -0700, Edward Yang, 69, 19, 88, LINK), (14222fd9024491ba6445016c3a8c084369c5e942, 2021-03-14 12:25:23 -0700, Edward Z. Yang, 69, 19, 88, LINK), (1b5177a4de3b13edd3eccbfad03d15d2e1e46da9, 2021-03-10 14:29:07 -0800, Edward Z. Yang, 53, 13, 66, LINK)"
53833,1,8,2,10,"(bbce574ccf68000db9c765512b647095ac6630a0, 2021-03-11 11:15:31 -0800, Sam Estep, 8, 2, 10, LINK)"
53840,1,7,2,9,"(4873641602ef8c15f07afba0ff5e0a171f458c87, 2021-03-12 07:03:12 -0800, Howard Huang, 7, 2, 9, LINK)"
542,1,1,1,2,"(fa24e47d1a6980246d63f73e45d7ab6561122f9d, 2018-02-27 21:39:41 +0000, onnxbot, 1, 1, 2, LINK)"
543,1,1,1,2,"(ddf6b3daaecf142c547c7e55e6627454f5a44f96, 2018-02-27 02:03:42 +0000, onnxbot, 1, 1, 2, LINK)"
5431,1,4,4,8,"(0d9b9100f977f677a0734af9096e9121ed85b337, 2018-09-14 09:12:45 -0700, Vishwak Srinivasan, 4, 4, 8, LINK)"
544,1,6,1,7,"(feecb0951757a5ef12171fa82af0511ad31874c9, 2017-07-14 17:17:04 -0700, Guillaume Dumont, 6, 1, 7, LINK)"
5442,1,23,1,24,"(7e55494502478d7f78138bc974e681df52b0635c, 2020-03-08 20:00:36 -0700, Mike Ruberry, 23, 1, 24, LINK)"
5462,1,337,351,688,"(27265503ad1b4c63e2caceb6b991a7abe998d7bd, 2018-03-01 18:11:39 -0500, Tongzhou Wang, 337, 351, 688, LINK)"
547,1,1,1,2,"(e3aae398ce8555c45fc1b574ad2e0d24e3883c15, 2018-02-24 00:33:05 +0000, onnxbot, 1, 1, 2, LINK)"
551,3,2561,783,3344,"(b875fb281c92dbe88da279a0ff7ad342e7b28b9e, 2018-05-10 23:14:27 -0700, Paul Jesse Hellemn, 2549, 779, 3328, LINK), (5aed120bc38c753753770e712f9ee1843741b27e, 2018-04-25 21:28:39 +0000, onnxbot, 1, 1, 2, LINK), (df2f52704c3a21e5364c0bec807dbb05a91cfab4, 2017-06-05 14:39:28 -0700, Luke Yeager, 11, 3, 14, LINK)"
5534,1,169,1,170,"(932c4c2364884af52609ea8a86c7232a926d958f, 2018-04-27 15:49:58 -0400, Richard Zou, 169, 1, 170, LINK)"
5542,1,2,3,5,"(6aeaa524761092b71928ab7ee82d4953b97bb241, 2018-03-04 15:02:47 +0800, peterjc123, 2, 3, 5, LINK)"
555,1,1,1,2,"(ea10b7bc63eb0055e97695f2a438c987ededaa97, 2018-02-28 22:08:33 +0000, onnxbot, 1, 1, 2, LINK)"
5552,1,29,16,45,"(cf2e1760490d369e93017b9425279b235c10772d, 2018-03-19 16:06:27 -0400, Richard Zou, 29, 16, 45, LINK)"
5554,1,13,2,15,"(371e14b807cfa8fc4087ecf7676ba076d0817453, 2018-03-28 17:21:38 -0400, Richard Zou, 13, 2, 15, LINK)"
5556,1,4,0,4,"(42bf2f9289daf59072e5b83ed4e2dd9a03eb9739, 2018-03-12 17:04:51 +0100, Benjamin Heinzerling, 4, 0, 4, LINK)"
563,1,1,1,2,"(0bce97b10141be07ffd0ba367a6cb93616a95f56, 2018-03-03 00:45:58 +0000, onnxbot, 1, 1, 2, LINK)"
5648,1,758,636,1394,"(6f80023c29e0fb55f46a32c4931bc5d4ba749846, 2018-03-19 21:09:43 +0100, Luca Antiga, 758, 636, 1394, LINK)"
566,1,1,1,2,"(7cdc272224ab844fa4bb93a81554a80abb739147, 2018-03-01 23:51:35 +0000, onnxbot, 1, 1, 2, LINK)"
5660,1,65,12,77,"(6e28d4d364246f35f5bdbd18bd8e12edc28538aa, 2018-06-26 19:31:07 +0300, Vadim Velikodniy, 65, 12, 77, LINK)"
5661,1,1,1,2,"(b543041e2119f31e4770c02190635fce82a7a564, 2018-03-09 16:03:25 -0500, Shagun Sodhani, 1, 1, 2, LINK)"
5704,1,4,0,4,"(42bf2f9289daf59072e5b83ed4e2dd9a03eb9739, 2018-03-12 17:04:51 +0100, Benjamin Heinzerling, 4, 0, 4, LINK)"
5718,1,4,4,8,"(025e43c2634023de4c62fe4f1afeda6a9f7565da, 2018-03-13 04:38:04 -0400, Calvin Lee, 4, 4, 8, LINK)"
5719,1,24,0,24,"(e831ad62046da7c330b566a275242b77099b28a0, 2018-04-03 11:49:40 -0400, Richard Zou, 24, 0, 24, LINK)"
573,1,1,1,2,"(8c92be5320c4830e8b777b06a92c30f7deecf3c0, 2018-03-23 17:07:11 +0000, onnxbot, 1, 1, 2, LINK)"
5739,1,23,4,27,"(9923701a0d746f68fd5061a058d544759fc1609f, 2018-03-23 22:22:39 -0400, Richard Zou, 23, 4, 27, LINK)"
574,1,1,1,2,"(70fdeb8e07063dbbfa98b1aae05c9ebd24deae60, 2018-03-09 07:23:55 +0000, onnxbot, 1, 1, 2, LINK)"
5748,1,199,146,345,"(ce2854c8758df972e15409cadc820bf5884f724b, 2018-04-16 11:42:57 -0700, li-roy, 199, 146, 345, LINK)"
5823,1,1129,1265,2394,"(227c8f2654c5aa4dda319d7401d319bb4636be47, 2018-07-06 15:25:30 -0700, Ailing Zhang, 1129, 1265, 2394, LINK)"
584,1,1,1,2,"(4c0e0ebb4e9109b577310e6cb66cc9eee608299a, 2018-03-07 05:14:09 +0000, onnxbot, 1, 1, 2, LINK)"
5851,1,36,3,39,"(d11b7fbd1c49ed7bd84c89d286e2763e6ba55f51, 2018-03-19 15:26:51 -0400, Sam Gross, 36, 3, 39, LINK)"
587,1,1,1,2,"(5d74462891671da4318d03dcf8f8aaef7d95b0ed, 2018-03-07 06:54:24 +0000, onnxbot, 1, 1, 2, LINK)"
5877,1,0,6,6,"(478fa180ee5c978556371bc0b8ea25ce36660805, 2020-10-16 15:40:07 -0700, Jane Xu, 0, 6, 6, LINK)"
588,1,1,1,2,"(807a4914c32fdace9f3dfdc727ee9eda214ff924, 2018-03-08 22:49:14 +0000, onnxbot, 1, 1, 2, LINK)"
5887,1,13,8,21,"(537e0e03300a64d17a521c8574455cdf0979e2fd, 2018-03-20 22:25:28 -0400, Tongzhou Wang, 13, 8, 21, LINK)"
592,1,1,1,2,"(5450ef50ed127e52deae36e8ede4fe45d2d0f1e8, 2018-03-08 04:11:03 +0000, onnxbot, 1, 1, 2, LINK)"
5921,1,102,16,118,"(e9f144b3e84f03d6a507faac40bdfce58b68c1fb, 2018-03-22 01:14:56 -0400, cpuhrsch, 102, 16, 118, LINK)"
5943,1,5,3,8,"(c9c978dff0747796b607b1b9f383bf6e33d4245e, 2018-03-22 16:30:55 -0400, Richard Zou, 5, 3, 8, LINK)"
5946,1,141,78,219,"(4f05cb710ef067e6d60e976651942e559ecf582d, 2018-03-29 13:26:12 -0400, Tongzhou Wang, 141, 78, 219, LINK)"
596,1,1,1,2,"(d90cd73aea0bfaed9749b1883567c203580325f6, 2018-03-08 21:40:13 +0000, onnxbot, 1, 1, 2, LINK)"
597,1,1,1,2,"(ff804ba1685044cb6045fc37390a862c8c3166b2, 2018-03-09 04:07:19 +0000, onnxbot, 1, 1, 2, LINK)"
5973,1,10,2,12,"(1ab248d09e256944d41c3099ef0fcfb8ab844523, 2018-03-26 21:40:30 +0800, peterjc123, 10, 2, 12, LINK)"
599,1,1,1,2,"(063f066394aaa015fb1132664397f2a065308454, 2018-03-09 16:45:55 +0000, onnxbot, 1, 1, 2, LINK)"
5994,1,70,15,85,"(54d5c53826479142fcf1e4de3ad77f8e4b81c123, 2018-12-10 08:05:06 -0800, SsnL, 70, 15, 85, LINK)"
6,6,20,14,34,"(0b93974075844601913c6df50f6566418a35eee8, 2021-02-25 14:32:13 -0800, Akao Kazutoshi, 2, 2, 4, LINK), (7e6d932208a866551ca1b9ea7f149d48eb3ad413, 2019-06-05 18:03:51 -0700, Junjie Bai, 7, 1, 8, LINK), (b90cbb841d98aeae435b1d02b1ff211e028cdf5b, 2019-04-05 12:44:49 -0700, Joakim Rishaug, 1, 1, 2, LINK), (9de4350b77cd7f257c1c60d325f267d50965531e, 2019-03-14 15:39:25 -0700, Lu Fang, 1, 1, 2, LINK), (be6ad7ddde64cebeec4cd9537ddc3bca9cbe18e5, 2019-02-22 07:54:47 -0800, Will Feng, 8, 8, 16, LINK), (4664808938b22c22abd216008926ecd81cb0c5e5, 2017-09-24 17:07:30 -0700, Igor Sugak, 1, 1, 2, LINK)"
60,1,71,0,71,"(8dff00a7b894a25e5b8a7681f6cc1b8bb1c779aa, 2016-03-03 22:13:12 +0100, Joost van Doorn, 71, 0, 71, LINK)"
6008,1,6,1,7,"(54d4fe3f49d781030cb4c3b7ec3944fb2cf7aae3, 2018-12-19 10:34:37 -0800, vfdev-5, 6, 1, 7, LINK)"
6028,1,61,21,82,"(d0f395f7446a89f21dd8a5d8bce6c509975436f3, 2018-04-10 01:39:31 +0800, Zhou Chang, 61, 21, 82, LINK)"
6068,1,5,728,733,"(9ce21b0e90095edbda80946cff95095a992b89d6, 2018-03-31 14:28:31 -0400, Edward Z. Yang, 5, 728, 733, LINK)"
607,2,2,2,4,"(c4e5001af8ebd506d23af54bc92be42469cb8944, 2018-03-27 21:47:02 +0000, onnxbot, 1, 1, 2, LINK), (2ad57eeea9fc51a36c3187c9e554afe36eb12346, 2018-03-27 20:11:54 +0000, onnxbot, 1, 1, 2, LINK)"
609,2,5,9,14,"(eea680a3549c3de1cad73d9eb75ddd417fb1e711, 2018-03-15 03:21:09 +0000, onnxbot, 1, 1, 2, LINK), (4d37ef878cad7391d3ddf5251602cbecf7fe9944, 2017-02-07 17:15:33 +0100, zhtvk, 4, 8, 12, LINK)"
610,1,1,1,2,"(30a37a21119b0a47b59fa5c3aed6231bf1e7bbd8, 2018-04-12 22:47:41 +0000, onnxbot, 1, 1, 2, LINK)"
6111,1,494,74,568,"(7a3c38ab595ea78f16935df788c4982a0ec56966, 2018-04-22 15:18:14 -0400, Richard Zou, 494, 74, 568, LINK)"
6168,1,20,1,21,"(efc91d8c6dbf9d3aa598a58ac17921354acec2af, 2018-04-04 23:07:31 -0400, Tongzhou Wang, 20, 1, 21, LINK)"
6187,1,136,29,165,"(14cbd9adb8efafbd51444fdd88d6a34e6438b1c5, 2018-07-05 08:58:16 -0700, Vishwak Srinivasan, 136, 29, 165, LINK)"
619,1,1,1,2,"(fe6c5ad4357be66be6a6142465a28573711f0cf4, 2018-03-23 08:03:43 +0000, onnxbot, 1, 1, 2, LINK)"
6190,1,198,37,235,"(6c0f74089fe4a338d292fe4b79cfc6a395ceab16, 2018-04-13 11:49:09 -0400, Richard Zou, 198, 37, 235, LINK)"
6217,1,12,1,13,"(aa99aa1cb81fa4f5ff98785fcaba2cb88bedb57f, 2018-04-10 11:47:22 -0400, Sam Gross, 12, 1, 13, LINK)"
6219,1,20,22,42,"(19ad55cc0288fe154a1fde8592e7819c22443198, 2018-08-14 21:16:32 -0700, Wei Yang, 20, 22, 42, LINK)"
6245,1,21,20,41,"(cb1bfe91afcab1f7431202afe03381a5d59e4ee3, 2018-07-02 15:44:12 -0700, Wei Yang, 21, 20, 41, LINK)"
6271,1,204,29,233,"(302adb7cc827adbcf5cd29c531cd8cbe52b2f7dc, 2018-07-25 14:59:35 -0700, Wei Yang, 204, 29, 233, LINK)"
629,1,1,1,2,"(2d8a674141984a410b126c4ce8a3dc90b3b89a2b, 2018-03-20 05:59:14 +0000, onnxbot, 1, 1, 2, LINK)"
6312,1,5,8,13,"(1b3a5a4e7d97d34fc446a2670a634d3c98307837, 2018-04-09 13:57:26 -0400, Richard Zou, 5, 8, 13, LINK)"
632,1,2,2,4,"(0c1c0e21b8c90545bfc451589c9ebec774361b6e, 2016-12-16 15:37:06 -0500, Gao Yingkai, 2, 2, 4, LINK)"
635,2,250,18,268,"(ece288392a76bc954ef373c28f5365c55e5e1e93, 2018-03-21 07:03:57 +0000, onnxbot, 1, 1, 2, LINK), (82088a81106e45b7fe642fd20b836af10c51e9f0, 2017-01-12 15:57:30 -0500, Trevor Killeen, 249, 17, 266, LINK)"
638,1,1,1,2,"(4b54f04eab8590bfe89ee37dbf6cf1875b68b7f3, 2018-03-21 22:13:30 +0000, onnxbot, 1, 1, 2, LINK)"
6386,1,13,5,18,"(5651695a99b12bc081299ecd7b7dc1effcaa5204, 2018-04-10 01:54:10 +0800, peterjc123, 13, 5, 18, LINK)"
6397,1,2,1,3,"(4d0097fab83c9550e109a6a41c8ace735e8d23be, 2018-04-16 14:31:34 -0400, Richard Zou, 2, 1, 3, LINK)"
6398,1,14,1,15,"(0a6331792dd1312e8ad7fdf21f75b69fc8daad2f, 2018-04-12 11:10:06 +0800, peterjc123, 14, 1, 15, LINK)"
640,1,1,1,2,"(81a29967c54cb445a615be8ac12204f79da928d4, 2018-03-23 03:23:28 +0000, onnxbot, 1, 1, 2, LINK)"
6479,1,113,11,124,"(2b44c420c8e61501ef04a5e4af2347ecc3c86202, 2018-04-26 17:11:20 +0200, Thomas Viehmann, 113, 11, 124, LINK)"
651,1,1,1,2,"(5f90d4121174bc826555ac5af75f413dc7596786, 2018-03-27 18:45:21 +0000, onnxbot, 1, 1, 2, LINK)"
653,2,23,2,25,"(d11fc903176e524cd10d7bd72d6ba2cf9caed1a8, 2018-03-26 19:26:09 -0700, mlappelbaum, 22, 1, 23, LINK), (f2bc1dc099f23fd1b08db1bc883fc68b11df9bcb, 2018-03-26 20:23:03 +0000, onnxbot, 1, 1, 2, LINK)"
6556,1,22,0,22,"(6dfaa1071aaea2e5eab269909345457b6e70d9d5, 2018-04-19 14:12:16 -0400, Edward Z. Yang, 22, 0, 22, LINK)"
656,1,1,1,2,"(7375ba5e60d306dee8ad4d8b18eabeaf2d8c36a5, 2018-03-23 22:36:29 +0000, onnxbot, 1, 1, 2, LINK)"
657,2,23,2,25,"(d11fc903176e524cd10d7bd72d6ba2cf9caed1a8, 2018-03-26 19:26:09 -0700, mlappelbaum, 22, 1, 23, LINK), (2a47fb3082457a41417cdf161776a162f64420f3, 2018-03-26 20:51:33 +0000, onnxbot, 1, 1, 2, LINK)"
6593,1,16,2,18,"(560530aeecdae8c37d47c8ee7967c8583843a0bf, 2018-12-19 10:40:48 -0800, Tugrul Ates, 16, 2, 18, LINK)"
6622,2,85,43,128,"(ef91cfd68b952fc24fd871837be019ced8f76f8e, 2018-12-04 12:21:17 -0800, Ailing Zhang, 62, 34, 96, LINK), (c730792d5133f489e368adf2702ef11825e8f503, 2018-04-27 21:45:26 +0200, Thomas Viehmann, 23, 9, 32, LINK)"
666,1,1,1,2,"(aecec8b4121bd791236d227bc1d2dfef849fc1ec, 2018-04-07 14:59:32 +0000, onnxbot, 1, 1, 2, LINK)"
671,1,1,1,2,"(e114e84d9169047f2f014f0c225230fc1d558999, 2018-03-28 06:58:24 +0000, onnxbot, 1, 1, 2, LINK)"
6721,1,54,18,72,"(aa3156c235995adcaa24bdeec593a3a9d32777d9, 2017-03-01 03:19:32 -0800, Aapo Kyrola, 54, 18, 72, REGEX)"
674,1,1,1,2,"(0c7c34253b54d5e3399ec2971b0bfbac73d2825d, 2018-03-28 06:54:44 +0000, onnxbot, 1, 1, 2, LINK)"
6742,1,1,1,2,"(533beab5bbd9547be1872634ebbbd6aaac8bf37d, 2018-04-19 11:25:43 +0200, Thomas Viehmann, 1, 1, 2, LINK)"
6759,1,12,1,13,"(d1a992a85ebce32b3aaa8efc520c35cbb17d97b0, 2018-04-19 18:31:14 -0400, Richard Zou, 12, 1, 13, LINK)"
677,1,1,1,2,"(df8991b1b7549c237bd6a18d77458c7ca00715e0, 2018-03-29 17:27:21 +0000, onnxbot, 1, 1, 2, LINK)"
6773,1,26,5,31,"(d6cbcb43c59cee08df6555a7d3bc3d6212f93741, 2018-12-20 15:18:39 -0800, rory, 26, 5, 31, LINK)"
678,1,2,1,3,"(c33512bdfc2d2bd702bea26d950032b407a5305f, 2019-01-21 09:43:40 -0800, Lu Fang, 2, 1, 3, LINK)"
680,1,17,90,107,"(224f5eabf5cfb3a19abc1819f7dac230500b6bdb, 2017-04-28 10:46:42 -0700, Boris Fomitchev, 17, 90, 107, LINK)"
6817,2,190,40,230,"(cffeb03a2db7dd1b1f4542a0b7050cce370a9053, 2018-10-17 21:02:12 -0700, Sepehr Sameni, 56, 21, 77, LINK), (f98b7780867c847eef27fbf492c9ee8dfe023c20, 2018-04-26 12:54:53 +0200, Thomas Viehmann, 134, 19, 153, LINK)"
6879,1,75,15,90,"(ab5c391100aa0115cca29888141d7c1611d96712, 2018-05-10 08:19:17 -0700, anderspapitto, 75, 15, 90, LINK)"
6885,1,1,1,2,"(b109549bf374202809dfab1a043a8e76fe9a7075, 2019-01-31 11:14:26 -0800, sebftw, 1, 1, 2, LINK)"
6911,1,42,42,84,"(a161639fcdb948639da78c6ca5d18f900654f385, 2018-06-12 02:12:41 -0400, Edward Z. Yang, 42, 42, 84, LINK)"
6917,1,1,1,2,"(5dc5a71d74d4080a4dd99d2037970c4124087f79, 2018-04-26 16:58:27 +0200, Thomas Viehmann, 1, 1, 2, LINK)"
6932,1,8,7,15,"(03767b66dbeb451a1f77348d3eedc402b02cb6ce, 2018-05-13 02:54:26 +0200, Maxim Berman, 8, 7, 15, LINK)"
6959,1,102,42,144,"(c8b5f1d2f8f31781e664917f132af31a9abf9cbd, 2019-06-25 09:04:47 -0700, mal, 102, 42, 144, LINK)"
6962,1,401,294,695,"(02921e79852e8530911ff89a4beaf7e151c0e8d3, 2019-11-07 12:47:33 -0800, Xiang Gao, 401, 294, 695, LINK)"
6968,1,201,187,388,"(ded6fb0293f45b4f6ab70a831e66516266fdc96f, 2019-01-29 12:23:06 -0800, SsnL, 201, 187, 388, LINK)"
6996,1,38,6,44,"(20c965f7d6a664e5b5bd6b1f14762bb2d07f87b5, 2018-04-30 21:02:47 +0200, Thomas Viehmann, 38, 6, 44, LINK)"
7,8,93,19,112,"(0b93974075844601913c6df50f6566418a35eee8, 2021-02-25 14:32:13 -0800, Akao Kazutoshi, 2, 2, 4, LINK), (7e6d932208a866551ca1b9ea7f149d48eb3ad413, 2019-06-05 18:03:51 -0700, Junjie Bai, 7, 1, 8, LINK), (b90cbb841d98aeae435b1d02b1ff211e028cdf5b, 2019-04-05 12:44:49 -0700, Joakim Rishaug, 1, 1, 2, LINK), (cb2ea1770791ac5a942f51d1cb1268e288abe86b, 2019-03-15 16:43:18 -0700, Jack Montgomery, 5, 3, 8, LINK), (be6ad7ddde64cebeec4cd9537ddc3bca9cbe18e5, 2019-02-22 07:54:47 -0800, Will Feng, 8, 8, 16, LINK), (4664808938b22c22abd216008926ecd81cb0c5e5, 2017-09-24 17:07:30 -0700, Igor Sugak, 1, 1, 2, LINK), (4bd220d91a8ba0c629785bcbe18842d1f5e2cfaa, 2017-03-13 08:26:02 -0700, Yangqing Jia, 68, 2, 70, LINK), (b856798020f5d73ce83a8baabf8390303bb3c5ee, 2015-07-27 18:28:44 -0700, Jeff Donahue, 1, 1, 2, LINK)"
7002,1,23,33,56,"(c21a7740765a315673c6a683e1e53ab14958d5bb, 2019-08-09 13:43:19 -0700, Mike Ruberry, 23, 33, 56, LINK)"
7012,1,220,15,235,"(b70b7a80d45f03a80c02035adfc8ea0375cdacec, 2018-04-30 08:48:44 -0700, Peter Goldsborough, 220, 15, 235, LINK)"
7021,1,55,6,61,"(8fbab83c2a036b3ba00944d6c95504b430734db3, 2018-04-30 10:20:00 +0200, Thomas Viehmann, 55, 6, 61, LINK)"
707,1,1,1,2,"(11b9180563705639d96f2bbe0dff5c51b9174e13, 2018-04-13 23:03:37 +0000, onnxbot, 1, 1, 2, LINK)"
7088,1,3,3,6,"(0b0279981dcc0c600a85b94c73b50c04ba05ec71, 2018-05-01 14:29:13 +1000, Joel Wong, 3, 3, 6, LINK)"
7095,1,21,1,22,"(c4078b42b48d8a6dff07658e0f1a40afa7b33f87, 2018-05-03 08:58:32 +0200, Thomas Viehmann, 21, 1, 22, LINK)"
7126,1,1,1,2,"(f6e4fc071a63b8ffe89bbea892e97c598f008120, 2018-11-13 09:38:55 -0800, Stuart Golodetz, 1, 1, 2, LINK)"
7150,1,0,3,3,"(f9393ffc903c8694dda20bceaaf75fb835b04c65, 2018-05-03 04:07:58 -0300, Daniel Bermond, 0, 3, 3, LINK)"
7156,1,20,2,22,"(eaa3f2e6139119bd4dcb7e9539ff1cb804854613, 2018-05-12 23:24:40 -0400, Richard Zou, 20, 2, 22, LINK)"
716,1,1,1,2,"(81676d8554fe6ae37a1b5e9c637caef8ad2d5f30, 2018-04-06 05:17:56 +0000, onnxbot, 1, 1, 2, LINK)"
718,3,10,22,32,"(482e1511ff1626f1e028d27bc04c2bf9d4464bca, 2018-04-05 16:06:29 -0400, Edward Z. Yang, 3, 3, 6, LINK), (d33ec12d1e3f4739e10cacf1436764bc54ff89a3, 2018-04-05 17:57:26 +0000, onnxbot, 1, 1, 2, LINK), (e967b756667c27ab4ae7a1857438459de49f6e7c, 2016-07-25 22:50:43 +0200, Andreas Köpf, 6, 18, 24, LINK)"
719,1,1,1,2,"(15f636bd1057db37b6e2106569a753706e072091, 2018-04-05 20:38:11 +0000, onnxbot, 1, 1, 2, LINK)"
720,1,1,1,2,"(f9b83f2e6c418a9743c6d2b7d641e137285ba9eb, 2018-05-06 19:56:05 +0000, onnxbot, 1, 1, 2, LINK)"
7209,1,2,1,3,"(6363faf1847993c58931b381f6ef84d16af683ae, 2018-05-04 10:51:46 +0200, vfdev, 2, 1, 3, LINK)"
722,1,1,1,2,"(c21ce7e083c65d3adc84d6e0108495eba95ff317, 2018-04-05 19:34:39 +0000, onnxbot, 1, 1, 2, LINK)"
7222,1,3,1,4,"(c719c8032c3585b8f7c3e612fa781a1753dbb7c1, 2018-06-05 22:29:55 +0800, Ir1dXD, 3, 1, 4, LINK)"
7228,1,30,1,31,"(1c3580b6fef05a11666e98c51c97b83429a9223a, 2018-07-17 17:09:14 -0700, vishwakftw, 30, 1, 31, LINK)"
7237,1,1,1,2,"(755d3105b6f61bf3834461fc3bc5bb77bd76a813, 2018-05-08 18:30:47 -0400, Richard Zou, 1, 1, 2, LINK)"
7249,1,1,1,2,"(cf9751207e8b97f5e844aacdaea494a2ba997caf, 2018-05-12 20:30:46 -0700, Mahdi Nazemi, 1, 1, 2, LINK)"
725,1,1,1,2,"(9dfc01b65900aba360f090f9f1e92f90fe22ac9c, 2018-04-13 20:41:22 +0000, onnxbot, 1, 1, 2, LINK)"
726,1,1,1,2,"(2f30fe64fd4a1140ed316291a81fcda4f77d0d98, 2018-04-05 22:17:19 +0000, onnxbot, 1, 1, 2, LINK)"
7266,1,2,2,4,"(3185d8342ec4766ff9a30f3b821374836400b23c, 2018-05-08 18:31:45 -0400, Richard Zou, 2, 2, 4, LINK)"
727,1,1,1,2,"(04fae733234d59f6409485531a049437a5f216e6, 2018-04-16 17:54:50 +0000, onnxbot, 1, 1, 2, LINK)"
728,1,1,1,2,"(5198d2b9ab2f067c3fe86912eab65fbe9a64593d, 2018-04-06 02:30:58 +0000, onnxbot, 1, 1, 2, LINK)"
7286,1,195,210,405,"(03d0a70a4da8351fb6d8274eb09104f737a7c430, 2018-06-27 20:00:53 -0700, Peter Goldsborough, 195, 210, 405, LINK)"
7288,1,195,210,405,"(03d0a70a4da8351fb6d8274eb09104f737a7c430, 2018-06-27 20:00:53 -0700, Peter Goldsborough, 195, 210, 405, LINK)"
7289,1,195,210,405,"(03d0a70a4da8351fb6d8274eb09104f737a7c430, 2018-06-27 20:00:53 -0700, Peter Goldsborough, 195, 210, 405, LINK)"
729,1,1,1,2,"(afaa72716b665907f6da6d0cebc330ace42ecf96, 2018-04-10 02:03:16 +0000, onnxbot, 1, 1, 2, LINK)"
730,1,1,1,2,"(f2130ae495963d5ed47568c677a38b98be742840, 2018-04-06 23:18:10 +0000, onnxbot, 1, 1, 2, LINK)"
7302,1,0,0,0,"(24681a8e4914b46257682891d803e6b09503b7c6, 2018-05-04 16:44:58 -0400, Richard Zou, 0, 0, 0, LINK)"
7318,1,1768,0,1768,"(eac4c5d90171c36ae0359823fdbc8064eb49c079, 2019-01-23 23:07:51 -0500, Edward Z. Yang, 1768, 0, 1768, LINK)"
7320,1,5,7,12,"(976b1d5ec1e2c38a1de36d9d36d0840a4aea7377, 2018-05-12 22:57:07 -0400, Sam Gross, 5, 7, 12, LINK)"
7327,1,16,3,19,"(215fe057ea0c178d5cbfe2e815a251351c7d3263, 2018-05-30 00:32:23 +0530, Vedaanta Agarwalla, 16, 3, 19, LINK)"
733,1,1,1,2,"(26eb08abfae978aca95470069a340ee2f097728b, 2018-04-09 21:58:48 +0000, onnxbot, 1, 1, 2, LINK)"
7354,1,6,1,7,"(54d4fe3f49d781030cb4c3b7ec3944fb2cf7aae3, 2018-12-19 10:34:37 -0800, vfdev-5, 6, 1, 7, LINK)"
741,1,1,1,2,"(432425c76bb8228a2a8720bb1f07a8125538b53b, 2018-04-10 20:44:44 +0000, onnxbot, 1, 1, 2, LINK)"
7415,1,5,0,5,"(d793473e6040f7db398537a9d3225b02122aad30, 2018-06-29 16:42:46 -0700, Ailing Zhang, 5, 0, 5, LINK)"
742,1,39,6,45,"(6bd4ecd15390517c68d598d236ffb0929ade277c, 2017-04-04 21:05:10 -0400, Sam Gross, 39, 6, 45, LINK)"
7420,1,2,2,4,"(9cffe783f16c107d7a26781b5735644faec5a92c, 2018-08-15 12:02:53 -0700, Brian Hart, 2, 2, 4, LINK)"
7434,3,2203,59,2262,"(c2fa1f363bed12484f4ab5e692c4f110e28b23a5, 2018-05-29 14:06:48 -0700, Teng Li, 573, 0, 573, LINK), (0d27d2686c036757baa068ec36da5e846a93b703, 2018-05-17 13:38:06 -0700, Teng Li, 1094, 59, 1153, LINK), (d5e77fb058f20470fe08d5ffee6446534da5516f, 2018-05-10 16:04:19 -0700, Pieter Noordhuis, 536, 0, 536, LINK)"
7441,1,30,12,42,"(6c7a8318c40412e5d9b52b299e424bce5aca2365, 2018-05-10 18:22:13 -0400, Sam Gross, 30, 12, 42, LINK)"
745,2,67,32,99,"(fbd53d87bff67cc12eb5b4d5b20c6e5b3caa461b, 2017-04-12 18:04:43 -0400, Trevor Killeen, 66, 32, 98, LINK), (593f867e3ef74e038c1b282a06d0bbb7c06ad607, 2017-02-15 14:49:03 +0800, Zhou Chang, 1, 0, 1, LINK)"
7464,1,18,16,34,"(1ce5431aaf5318e3f707961337e17924515d02e3, 2018-05-13 21:44:24 +0200, Thomas Viehmann, 18, 16, 34, LINK)"
7502,1,9,22,31,"(c76da6494bad35a44a9b44631b0747ca7f60c807, 2018-05-15 23:57:16 -0400, Richard Zou, 9, 22, 31, LINK)"
751,1,1,1,2,"(3140fe0ed19d6db4a0e5fb08fd6a9d72fbffbb98, 2018-04-13 16:52:17 +0000, onnxbot, 1, 1, 2, LINK)"
7518,1,18,16,34,"(1ce5431aaf5318e3f707961337e17924515d02e3, 2018-05-13 21:44:24 +0200, Thomas Viehmann, 18, 16, 34, LINK)"
7532,1,5,1,6,"(61afbbbd185a153211fc2280b76453b656d51bde, 2018-05-14 21:36:00 +0200, andreh7, 5, 1, 6, LINK)"
757,2,2,2,4,"(241a1e0f52bd0bff05b548674fa3e4d635195528, 2018-04-25 08:16:31 +0000, onnxbot, 1, 1, 2, LINK), (40301c3be7aeab68f9cdb5b9468fc7bc77ed14fb, 2018-04-25 06:05:47 +0000, onnxbot, 1, 1, 2, LINK)"
758,1,1,1,2,"(530e1e89f0ecd3e2d79062ccd9d32f1d3c2f56ad, 2018-04-18 18:20:13 +0000, onnxbot, 1, 1, 2, LINK)"
759,2,13,1,14,"(0e246305aba027a0cc4bac888aa9245cd93f2592, 2018-04-14 01:40:58 +0000, onnxbot, 1, 1, 2, LINK), (c26f6877a001809a5fd3bde1240abd733cde9c02, 2017-04-28 11:57:15 -0400, Trevor Killeen, 12, 0, 12, LINK)"
760,1,1,1,2,"(caadc9301f0534001f9726866cb9db2e2b0e2758, 2018-04-14 22:27:55 +0000, onnxbot, 1, 1, 2, LINK)"
763,1,0,1,1,"(0b476e6456c72855bbc462ca96ec089699834c82, 2017-11-09 13:53:21 -0800, Christoph Conrads, 0, 1, 1, LINK)"
764,1,1,1,2,"(f50f1769eca84a1e4eb46c2f10fc471e6fdca034, 2018-04-17 23:33:10 +0000, onnxbot, 1, 1, 2, LINK)"
7640,1,1,0,1,"(e37da05bd5b0c0b30aa021f8ddc906b282a42fdf, 2018-05-18 11:16:25 -0400, Richard Zou, 1, 0, 1, LINK)"
7645,1,29,9,38,"(f7bc7007d48433ef9ad6e8add86a62c772c6c04d, 2018-05-18 16:39:41 +0200, Thomas Viehmann, 29, 9, 38, LINK)"
7651,1,15,1,16,"(bf95dff85bccc212cfe83c42f98fa6e998d257b3, 2018-05-18 16:35:00 +0200, Thomas Viehmann, 15, 1, 16, LINK)"
768,1,126,6,132,"(c691fc6dc711814a06107d4a9b763f34bff5afca, 2017-07-02 21:39:40 -0700, Christian Sarofeen, 126, 6, 132, LINK)"
7689,1,12,0,12,"(aa214a8b8cc8bb7fa0a655499a709fc580e417db, 2018-05-23 23:28:37 +0200, Thomas Viehmann, 12, 0, 12, LINK)"
771,2,33,22,55,"(188b6e934653b42c0e625dd7226dd036c497125a, 2018-04-20 16:05:40 +0000, onnxbot, 1, 1, 2, LINK), (13a5090695fd5ed89c4005ff03d7359d5739e7f1, 2017-02-25 21:53:30 +0800, Zhou Chang, 32, 21, 53, LINK)"
7722,1,20,1,21,"(d0ca8896d54ef93e0b2ba6c78b674c782c9b6499, 2018-06-07 04:54:23 +0200, Thomas Viehmann, 20, 1, 21, LINK)"
776,3,29,13,42,"(fff80c2c1f81095785963b4fe4315fb36b0a0deb, 2018-04-19 04:53:09 +0000, onnxbot, 1, 1, 2, LINK), (b87f26ce267cb9c327c0913fccc3521aa2949a96, 2016-09-27 20:59:27 +0800, BTNC, 14, 6, 20, LINK), (a0cf6658c57fa54dc82f93574058381f7a63e00c, 2016-09-27 20:59:27 +0800, BTNC, 14, 6, 20, LINK)"
7763,1,2,1,3,"(42a68749bf3efda9d27bb3b594cf154f602c5b3a, 2018-05-29 12:26:39 +0200, Thomas Viehmann, 2, 1, 3, LINK)"
779,2,63,48,111,"(02544f44728fbd6db07350a20bbe26998c4ead84, 2018-04-20 20:05:40 +0000, onnxbot, 1, 1, 2, LINK), (3564b775537f3a49fe8693f502cca87b14319d48, 2016-10-02 03:27:30 +0800, BTNC, 62, 47, 109, LINK)"
7793,1,1,1,2,"(52cbf4b7749a94dad280f96388dd358c96d36cbd, 2018-10-15 16:51:26 -0700, Bowen Bao, 1, 1, 2, LINK)"
7800,1,365,93,458,"(3b886500a0481401267887c21c378c7752e06236, 2018-07-18 14:31:58 -0700, Peter Goldsborough, 365, 93, 458, LINK)"
781,1,1,1,2,"(5945f3a7b40da2732cfe998b7747d6b4e42686a8, 2018-04-21 03:28:57 +0000, onnxbot, 1, 1, 2, LINK)"
7817,1,24,14,38,"(d5c466e5ce93115a8ce4ab18bf4fa661d7ecc102, 2018-05-25 12:56:57 -0700, anderspapitto, 24, 14, 38, LINK)"
782,1,1,1,2,"(6fed2341e9ce71151ca283f23f09db0c6b84d50e, 2018-04-19 19:25:37 +0000, onnxbot, 1, 1, 2, LINK)"
784,2,158,1,159,"(264ffd143c3694df6f39a16ca0c5df3ba34a0d32, 2018-04-19 22:27:53 +0000, onnxbot, 1, 1, 2, LINK), (78ecc2d3b1b8f0e9b0d696a8d3e09424d1d34628, 2017-07-11 13:23:35 -0400, Amartya Sanyal, 157, 0, 157, LINK)"
7849,1,1,1,2,"(8e6cd43291ce29654afcb65cc91c74333a89ded4, 2018-05-30 16:51:23 -0400, Richard Zou, 1, 1, 2, LINK)"
785,1,65,4,69,"(bfaddc0a19ad390988932903268267f05e0e1504, 2017-06-28 21:14:07 -0700, ngimel, 65, 4, 69, LINK)"
7851,1,3,2,5,"(952df2ba8f3cf0117b20cd3505756568ef8b9ddf, 2018-10-22 18:15:01 -0700, Edward Yang, 3, 2, 5, LINK)"
786,1,1,1,2,"(1a53e45558127755a151a8925be25c1f696b07e3, 2018-04-19 23:49:32 +0000, onnxbot, 1, 1, 2, LINK)"
788,1,1,1,2,"(503be98d610b464fd1fd9213ce336cfea22671c9, 2018-04-20 04:35:38 +0000, onnxbot, 1, 1, 2, LINK)"
7881,1,1,1,2,"(15314c7b8e18ca9c8317491286cfa1b2270895c0, 2018-08-30 16:35:31 -0700, Tongliang Liao, 1, 1, 2, LINK)"
789,1,1,1,2,"(945cb0fabc75e07b40a2f8ca821c49f1e113e869, 2018-04-20 05:02:50 +0000, onnxbot, 1, 1, 2, LINK)"
790,2,6,6,12,"(dd1525d3465437beb4da88649fd551a8fe6b3c3a, 2017-06-20 13:55:59 -0700, Davin Wang, 4, 4, 8, LINK), (838842d4b26ef341ca8d0e3fe9866d79a417e998, 2017-02-23 15:59:29 +0800, 陈云, 2, 2, 4, LINK)"
7908,1,55,3,58,"(7f9fd1cc264729c1b9f48e5ac398119999b0cd31, 2018-08-28 10:10:35 -0700, Wei Yang, 55, 3, 58, LINK)"
791,1,1,1,2,"(378f742792a8e11971f89a06846391f0db546e7b, 2018-04-20 15:36:16 +0000, onnxbot, 1, 1, 2, LINK)"
7929,1,998,789,1787,"(c61f0217a536d19c9ff3290067ddcbb9ce3a5c6a, 2018-07-01 05:24:04 -0700, Roy Li, 998, 789, 1787, LINK)"
795,1,1,1,2,"(afea1331133819c930e879a2d0de97112643c1d6, 2018-04-20 23:24:08 +0000, onnxbot, 1, 1, 2, LINK)"
8022,2,28,10,38,"(c21465e32ea0340a3c9eb37be8a569a3e2976598, 2018-06-05 22:03:04 -0400, Edward Z. Yang, 5, 9, 14, LINK), (bf58bb5e59fa64fb49d77467f3466c6bc0cc76c5, 2018-06-05 13:37:05 -0400, Edward Z. Yang, 23, 1, 24, LINK)"
804,3,3,3,6,"(c820fda180346a6062c89171450806836f558f6d, 2018-04-25 08:15:37 +0000, onnxbot, 1, 1, 2, LINK), (e28508afa5e8d8c966325db06d09e246f22835a5, 2018-04-24 23:53:27 +0000, onnxbot, 1, 1, 2, LINK), (06f1c8a2e192fed2d62750a64bb6bfa220f71dca, 2016-05-02 18:59:48 +0200, fsuzanomassa, 1, 1, 2, LINK)"
805,1,9,12,21,"(2d07360938576f3a1df5064fe92aa0b6c2c84e28, 2017-12-11 13:28:14 -0800, Pieter Noordhuis, 9, 12, 21, LINK)"
8076,1,65,31,96,"(6b338c80264280b1c983ba49d0ffa43a499cd2fe, 2018-08-01 19:10:27 -0700, Richard Zou, 65, 31, 96, LINK)"
8084,1,1,1,2,"(4485ce66c293935d36745b9b11d8927aba16d64d, 2018-06-12 20:06:24 -0400, Edward Z. Yang, 1, 1, 2, LINK)"
81,3,56,26,82,"(c8c967fa431920cfb232aeabe85ba6b178fa5a78, 2017-10-06 15:30:25 -0400, Sam Gross, 26, 7, 33, LINK), (18eb4bbdf9563c0620bbc93daa045c2258b63bde, 2017-10-06 15:30:25 -0400, Sam Gross, 26, 7, 33, LINK), (3931beee812cb59904e56f1762cd0acc1fabc32c, 2016-10-17 11:41:21 -0700, Sam Gross, 4, 12, 16, LINK)"
8110,1,38,9,47,"(96a77b5aa80a3d7512e7916c28af469eae353962, 2018-06-04 12:12:59 -0400, Edward Z. Yang, 38, 9, 47, LINK)"
812,2,2550,780,3330,"(b875fb281c92dbe88da279a0ff7ad342e7b28b9e, 2018-05-10 23:14:27 -0700, Paul Jesse Hellemn, 2549, 779, 3328, LINK), (9db779f3314e91cb2ac3ca4b4f0016e37d2457f0, 2018-04-27 04:51:00 +0000, onnxbot, 1, 1, 2, LINK)"
815,1,1,1,2,"(53a8158d6d8e9a6de269f5e53ea078e669ea0ec7, 2018-04-24 22:23:24 +0000, onnxbot, 1, 1, 2, LINK)"
818,1,1,1,2,"(138d69c688af40bdef1982d4c0ef5846bc3cae1c, 2018-04-25 15:48:39 +0000, onnxbot, 1, 1, 2, LINK)"
8208,1,72,19,91,"(fc22bf3e82723178015708ae1265ec14710c2dec, 2018-06-24 23:15:13 +0200, Thomas Viehmann, 72, 19, 91, LINK)"
821,2,2550,780,3330,"(b875fb281c92dbe88da279a0ff7ad342e7b28b9e, 2018-05-10 23:14:27 -0700, Paul Jesse Hellemn, 2549, 779, 3328, LINK), (075ca76c26d07876a4f2b8fe20900a07ea9357d0, 2018-04-25 19:57:13 +0000, onnxbot, 1, 1, 2, LINK)"
823,2,2550,780,3330,"(b875fb281c92dbe88da279a0ff7ad342e7b28b9e, 2018-05-10 23:14:27 -0700, Paul Jesse Hellemn, 2549, 779, 3328, LINK), (6ce376fee374de52554987adf2ed701d509dea9b, 2018-04-27 21:01:58 +0000, onnxbot, 1, 1, 2, LINK)"
8330,1,90,26,116,"(572132fb1701e3c9a16dea50547355773a66a9a2, 2018-09-30 11:45:17 -0700, Wei Yang, 90, 26, 116, LINK)"
8333,1,6,0,6,"(77660a9cbb0498d7951a8e3e53409ac944479d6c, 2018-06-11 12:15:50 -0400, Edward Z. Yang, 6, 0, 6, LINK)"
8335,1,2,2,4,"(0cced57cb8ff14ac04ddf624f4a51c33c864f170, 2018-06-11 21:05:12 -0400, Edward Z. Yang, 2, 2, 4, LINK)"
834,2,2550,780,3330,"(b875fb281c92dbe88da279a0ff7ad342e7b28b9e, 2018-05-10 23:14:27 -0700, Paul Jesse Hellemn, 2549, 779, 3328, LINK), (19cb5a0436736d36cd39f206e1fe4a904c8ab735, 2018-04-26 22:17:52 +0000, onnxbot, 1, 1, 2, LINK)"
8351,1,15,0,15,"(9abc66674559ac214dad31ca42bc0d981d5260db, 2018-09-13 11:51:17 -0700, Roy Li, 15, 0, 15, LINK)"
836,2,2550,780,3330,"(b875fb281c92dbe88da279a0ff7ad342e7b28b9e, 2018-05-10 23:14:27 -0700, Paul Jesse Hellemn, 2549, 779, 3328, LINK), (f6083b343b8d13c267cee348ca35b426ac616821, 2018-04-27 18:06:39 +0000, onnxbot, 1, 1, 2, LINK)"
8366,1,179,17,196,"(c1dce21fd5505085ef148aa9d70a312d8d14257f, 2018-09-11 13:06:47 -0700, Thomas Viehmann, 179, 17, 196, LINK)"
8385,1,16,0,16,"(ad6d62250ae4be3face0a75ce98470dde249cf5a, 2018-08-01 14:59:27 -0700, Richard Zou, 16, 0, 16, LINK)"
839,2,2550,780,3330,"(b875fb281c92dbe88da279a0ff7ad342e7b28b9e, 2018-05-10 23:14:27 -0700, Paul Jesse Hellemn, 2549, 779, 3328, LINK), (bb9c8592532749ce14617fa81b90e302d1ae3f34, 2018-04-28 04:18:49 +0000, onnxbot, 1, 1, 2, LINK)"
8410,1,368,208,576,"(f74207c99fea86e8a613a037f3c15c31dfff2887, 2018-06-25 18:40:04 -0700, Zachary DeVito, 368, 208, 576, LINK)"
8420,1,10,3,13,"(f1b512430619e3b747f63117d2406f070fba2b65, 2018-06-13 14:26:28 -0400, Vishwak Srinivasan, 10, 3, 13, LINK)"
8439,1,73,60,133,"(75f49befeb922a577a1e0e38f26e963b57c1f8ea, 2018-09-13 12:25:20 -0700, Roy Li, 73, 60, 133, LINK)"
845,3,2610,800,3410,"(b875fb281c92dbe88da279a0ff7ad342e7b28b9e, 2018-05-10 23:14:27 -0700, Paul Jesse Hellemn, 2549, 779, 3328, LINK), (bf9fab3cf36eead4279b05a01a2fe0030cfe47b5, 2018-04-30 19:45:21 +0000, onnxbot, 1, 1, 2, LINK), (62063b2f62ad21cf8bb6401a4bb03c152045693a, 2017-03-15 15:08:05 +0000, Alykhan Tejani, 60, 20, 80, LINK)"
8452,1,40,17,57,"(0bd9e96b0860a521307d38b54e164d0cdd80e48b, 2018-06-28 16:02:30 -0700, Wanchao Liang, 40, 17, 57, LINK)"
846,2,2550,780,3330,"(b875fb281c92dbe88da279a0ff7ad342e7b28b9e, 2018-05-10 23:14:27 -0700, Paul Jesse Hellemn, 2549, 779, 3328, LINK), (ca8ee4c1e1ece7c49b99f3cb8888629ff39f3647, 2018-05-01 17:54:27 +0000, onnxbot, 1, 1, 2, LINK)"
847,2,129,1,130,"(e6330559c8769d4f9bfe4e1a11301a8cbfd63081, 2018-05-02 16:41:28 +0000, onnxbot, 1, 1, 2, LINK), (02e5367bdd82df0aaff0224eea91c7653b92d0aa, 2017-08-06 12:58:50 -0700, Geunsik Lim, 128, 0, 128, LINK)"
8481,1,36,19,55,"(623ae0c07c83d217b7ba2efabfddd4ce59cdd934, 2018-07-01 22:12:49 -0700, Tongzhou Wang, 36, 19, 55, LINK)"
849,2,2550,780,3330,"(b875fb281c92dbe88da279a0ff7ad342e7b28b9e, 2018-05-10 23:14:27 -0700, Paul Jesse Hellemn, 2549, 779, 3328, LINK), (881af544fdbeb09ee25aa8c583ca72aea7260f1f, 2018-04-30 07:00:36 +0000, onnxbot, 1, 1, 2, LINK)"
8502,1,172,164,336,"(47c1badf9003afd7f6959ba3e91f325085947f32, 2018-07-27 22:47:29 -0700, Wanchao Liang, 172, 164, 336, LINK)"
8508,1,2,0,2,"(49a3e49627c71a4abe551c832e4720e8b21704fe, 2018-06-25 18:06:51 -0400, Praveen Palanisamy, 2, 0, 2, LINK)"
8515,1,49,4,53,"(7671f4ab1c921888554bef92d1cee55785bcf232, 2018-09-17 14:03:14 -0700, David Riazati, 49, 4, 53, LINK)"
8516,1,156,86,242,"(3d43a8244091ff4ffa70404110263e202fd94a0c, 2018-08-23 15:06:16 -0700, Zachary DeVito, 156, 86, 242, LINK)"
8518,1,8,5,13,"(4ed5b9267cf3953b89b2247081b77b0e1c1a7985, 2018-08-01 16:02:28 -0700, Jenny Ramseyer, 8, 5, 13, LINK)"
8520,1,31,7,38,"(4bf5fc44c86d835f4812e7b3baffae9c65de0677, 2018-09-07 15:25:07 -0700, David Riazati, 31, 7, 38, LINK)"
8525,1,31,7,38,"(4bf5fc44c86d835f4812e7b3baffae9c65de0677, 2018-09-07 15:25:07 -0700, David Riazati, 31, 7, 38, LINK)"
853,2,2550,780,3330,"(b875fb281c92dbe88da279a0ff7ad342e7b28b9e, 2018-05-10 23:14:27 -0700, Paul Jesse Hellemn, 2549, 779, 3328, LINK), (c5978db0944800afa2b5cd3a8644e48762baa126, 2018-04-30 15:37:06 +0000, onnxbot, 1, 1, 2, LINK)"
8560,1,34,2,36,"(656e81db9372ea62f80155acded8b90b3445f0fd, 2018-09-06 07:43:10 -0700, Richard Zou, 34, 2, 36, LINK)"
8599,1,3,0,3,"(9a9eadacc6ac3b734a6d607ae6f63ec1a0d1438d, 2018-06-19 17:53:46 +0200, Thomas Viehmann, 3, 0, 3, LINK)"
8611,1,1,1,2,"(b109549bf374202809dfab1a043a8e76fe9a7075, 2019-01-31 11:14:26 -0800, sebftw, 1, 1, 2, LINK)"
863,2,2550,780,3330,"(b875fb281c92dbe88da279a0ff7ad342e7b28b9e, 2018-05-10 23:14:27 -0700, Paul Jesse Hellemn, 2549, 779, 3328, LINK), (23a5ddd3c86b9aab916707b6ac6aaa35050b5b3f, 2018-05-01 08:21:41 +0000, onnxbot, 1, 1, 2, LINK)"
8652,1,3,3,6,"(ba8e13384474c31caf685993985c5f0c1cdc9f96, 2018-06-27 15:51:22 -0700, Dmitriy Serdyuk, 3, 3, 6, LINK)"
8659,1,7,0,7,"(d97c9dd01904ff423554345cd877ebc1e520c21e, 2018-06-20 12:23:22 -0400, Vishwak Srinivasan, 7, 0, 7, LINK)"
8690,1,2,0,2,"(6a1e8010713794f940739841297e177a865900c9, 2018-06-29 08:09:37 -0700, Thomas Viehmann, 2, 0, 2, LINK)"
8692,1,1,1,2,"(3e25b4af6d3878f4f2b68106c00e0422d48efd35, 2018-06-20 15:17:54 -0400, Vishwak Srinivasan, 1, 1, 2, LINK)"
871,1,1,1,2,"(a10870a2d11d428e4b301755efff0e16fddef88e, 2018-05-02 23:36:33 +0000, onnxbot, 1, 1, 2, LINK)"
8710,1,16,3,19,"(05559b40716d4161fadabff6130805f07172ef83, 2018-07-11 10:20:13 -0700, Richard Zou, 16, 3, 19, LINK)"
8714,1,8,8,16,"(66dc97e51ca872e01d6430363770256c76f94361, 2018-07-08 16:33:44 -0700, Jenny Ramseyer, 8, 8, 16, LINK)"
8715,1,42,28,70,"(00b5d397aef410f5926cb50e7d6e4e676aef71a8, 2018-06-28 22:43:36 -0700, James Reed, 42, 28, 70, LINK)"
8716,1,166,96,262,"(2e23bc1a20304dd51ed8fc6190d3e920f8c15b39, 2018-06-28 16:24:08 -0700, James Reed, 166, 96, 262, LINK)"
8774,1,18,8,26,"(86eeeab7587ec5ae4f77c57daf681eef26ed5209, 2018-07-13 14:37:09 -0700, Vishwak Srinivasan, 18, 8, 26, LINK)"
8786,1,12,0,12,"(1d4cf095b808f66867dae79d289d315bef974a7f, 2018-06-22 16:14:27 -0400, Vishwak Srinivasan, 12, 0, 12, LINK)"
882,2,2,2,4,"(159c75a2ca3612eb255cfec20c8848b395565c46, 2018-05-04 08:03:07 +0000, onnxbot, 1, 1, 2, LINK), (d856bfc1bf0751a95f2cec3a501e196ac8718b97, 2018-05-04 06:47:08 +0000, onnxbot, 1, 1, 2, LINK)"
8840,1,1,1,2,"(50410c95725da83572171dca8b9600df6bc708ba, 2018-06-25 08:01:05 +0200, ptrblck, 1, 1, 2, LINK)"
8857,1,16,0,16,"(4643269eb5e0df7ff591ed013fd6ede1d26a5440, 2018-06-28 22:01:15 -0700, vishwakftw, 16, 0, 16, LINK)"
8867,1,166,96,262,"(2e23bc1a20304dd51ed8fc6190d3e920f8c15b39, 2018-06-28 16:24:08 -0700, James Reed, 166, 96, 262, LINK)"
890,1,1,1,2,"(56ed857f1bfc46aa0faec8125a4506d4c97bd980, 2018-05-04 21:50:10 +0000, onnxbot, 1, 1, 2, LINK)"
8900,1,3,2,5,"(37e526e1a8cfedb9112c161b01a7f7a143d0998b, 2018-06-29 08:14:11 -0700, Karan Dwivedi, 3, 2, 5, LINK)"
891,2,7,1,8,"(e1c7e6dce2c159cc5180ed993ea455efd7977c7c, 2018-05-04 21:04:54 +0000, onnxbot, 1, 1, 2, LINK), (f366e5fc81eb43e518fb1a461f3c42d776a252e0, 2017-03-02 20:08:05 +0800, Zhou Chang, 6, 0, 6, LINK)"
8928,1,64,67,131,"(a47a30b9ce4e515358bb2a53c540a45b04108ad6, 2018-07-10 15:05:10 -0700, Roy Li, 64, 67, 131, LINK)"
8940,1,30,3,33,"(b7956204429ba7717780fff463dabea5bf92b8be, 2018-06-29 06:47:54 -0700, vishwakftw, 30, 3, 33, LINK)"
8949,1,2,1,3,"(30549a129324a0ddbf2fc826a2a414eece6eb347, 2018-06-28 16:37:43 -0700, Christian Puhrsch, 2, 1, 3, LINK)"
8957,1,3,3,6,"(ba8e13384474c31caf685993985c5f0c1cdc9f96, 2018-06-27 15:51:22 -0700, Dmitriy Serdyuk, 3, 3, 6, LINK)"
8981,1,1,1,2,"(73102294265b21fb63c9411180cd6a0e4d99bb5e, 2018-06-28 11:40:49 -0700, Richard Zou, 1, 1, 2, LINK)"
8988,1,138,0,138,"(d4060d2d0e0e4ce54186a618a4794c1e0a2b7d25, 2018-09-04 20:56:32 -0700, Thomas Viehmann, 138, 0, 138, LINK)"
9049,1,6,0,6,"(2c6c53f5ceb48503ac5d1a5e7f81bba69e32f31f, 2018-06-30 10:30:30 -0700, Luca Antiga, 6, 0, 6, LINK)"
9054,1,4,7,11,"(ad74006ffa22c79285e21c7777e9d386607ebbea, 2018-07-16 19:18:33 -0700, Will Feng, 4, 7, 11, LINK)"
9062,1,13,2,15,"(6834dcab1c87e1f2aac3e189ec7ccb20bab8028e, 2018-09-21 10:13:23 -0700, Thomas Viehmann, 13, 2, 15, LINK)"
9079,1,18,1,19,"(179807a8c7c27b71db832ace68f22c2d5846cdde, 2018-07-01 22:12:24 -0700, Tongzhou Wang, 18, 1, 19, LINK)"
9092,2,181,153,334,"(587f769a99552c7379f17291669f9d19ab336e60, 2018-11-14 11:33:58 -0800, Lara Haidar-Ahmad, 5, 5, 10, LINK), (53083b83530441dcc08aad07886a72a04dda845e, 2018-07-23 06:35:39 -0700, peter, 176, 148, 324, LINK)"
9103,1,233,254,487,"(21c786071b8919222daef7128f9218c825182db3, 2018-07-02 19:32:02 -0700, Roy Li, 233, 254, 487, LINK)"
9109,1,10,6,16,"(ee022a476a2747abed4a950ed88a27f620f1d1f7, 2018-08-23 16:22:12 -0700, Tigran Hakobyan, 10, 6, 16, LINK)"
911,1,365,0,365,"(e908cf28f45edce9de6fd736a2e16c67e3070674, 2017-08-09 13:52:56 -0700, Aaron Markham, 365, 0, 365, LINK)"
9110,1,171,61,232,"(b432837a9d57023add43e267eacbf0b4969b2316, 2018-07-03 12:58:23 -0700, Edward Yang, 171, 61, 232, LINK)"
9130,1,1,8,9,"(49f88ac9561c289e41d04dfa0f5b55f92a9c1b78, 2018-07-03 18:54:31 -0700, vishwakftw, 1, 8, 9, LINK)"
9132,2,54,4,58,"(5eaed750c237ca633b4666fecaa440291329de81, 2018-07-18 08:16:04 -0700, bhushan23, 28, 3, 31, LINK), (5eb9d40cc6b5f248db203b9b76de9b30f1c56d65, 2018-07-15 07:53:23 -0700, bhushan, 26, 1, 27, LINK)"
9141,1,22,6,28,"(149d4f776b4a896945bdec81b89a150f5c9ee66d, 2018-08-03 17:40:24 -0700, Wei Yang, 22, 6, 28, LINK)"
9142,1,1,1,2,"(b479494ed4e2821e47722331fd11c5f26f36671c, 2018-07-03 14:09:42 -0700, Roy Fejgin, 1, 1, 2, LINK)"
9147,1,14,1,15,"(08daed40f729a7813b30a5d9ac3b015f642a2b14, 2018-07-04 07:17:31 -0700, vishwakftw, 14, 1, 15, LINK)"
9160,1,33,2,35,"(30292d994fabf24146fe0dbcfe9621d4f87325e2, 2019-04-19 10:08:50 -0700, MilesCranmer, 33, 2, 35, LINK)"
9167,1,3,9,12,"(342dbcc35a5118b0fa8cccbbd2c45542d234871a, 2018-07-09 16:48:12 -0700, Kaiyu Shi, 3, 9, 12, LINK)"
9200,1,3,0,3,"(19ecb5f8adf863ccb1825f8f984b8512245d4c13, 2018-07-09 18:42:56 -0700, peter, 3, 0, 3, LINK)"
923,1,365,0,365,"(e908cf28f45edce9de6fd736a2e16c67e3070674, 2017-08-09 13:52:56 -0700, Aaron Markham, 365, 0, 365, LINK)"
9232,1,10,3,13,"(506142ac8aebe0b3794ba66d6d6c4019fc2182c8, 2018-08-05 21:13:58 -0700, peter, 10, 3, 13, LINK)"
9247,1,322,157,479,"(e8536c08a16b533fe0a9d645dd4255513f9f4fdd, 2018-07-08 18:54:24 -0700, Tongzhou Wang, 322, 157, 479, LINK)"
9264,1,122,124,246,"(1597fc594d36a18d1d4aee16d09ea49ae7065610, 2018-07-10 06:28:07 -0700, Tongzhou Wang, 122, 124, 246, LINK)"
9301,1,22,6,28,"(149d4f776b4a896945bdec81b89a150f5c9ee66d, 2018-08-03 17:40:24 -0700, Wei Yang, 22, 6, 28, LINK)"
9332,1,1652,0,1652,"(5e462a3ed6ec88a022e1ab4d60f9e2282e96ec44, 2019-03-26 07:49:58 -0700, vishwakftw, 1652, 0, 1652, LINK)"
9348,1,3,3,6,"(00b4b4703e27b4f531db5e8a88fb2348c77b4ee4, 2018-07-11 21:15:34 -0700, Tongzhou Wang, 3, 3, 6, LINK)"
9378,1,107,0,107,"(360c1bbd5b36fd84670292b2ea93170c31cbd5cf, 2018-07-24 11:58:22 -0700, Vishwak Srinivasan, 107, 0, 107, LINK)"
9382,1,251,2,253,"(ef4817fe5a16ba9969562911c5363736a1003bb0, 2020-10-07 23:12:41 -0700, Kurt Mohler, 251, 2, 253, LINK)"
9390,2,16,2,18,"(886a367247a6350ef82a7e7769c2d48734f2f49e, 2018-07-20 07:43:57 -0700, Tongzhou Wang, 8, 1, 9, LINK), (bfe2aa093e17c84db863672ad446de064e47dc7e, 2018-07-20 07:43:57 -0700, Tongzhou Wang, 8, 1, 9, LINK)"
9395,1,120,74,194,"(478886be308c5c14f5898bfe4d9833f4debba20a, 2018-10-24 18:10:32 -0700, Ailing Zhang, 120, 74, 194, LINK)"
940,1,6,2,8,"(c7c4778af633d5ba4c22a5b1552f174d6cd9e68b, 2017-03-10 22:54:43 +0800, 陈云, 6, 2, 8, LINK)"
9404,2,223,223,446,"(416c8ef1d1eb8ee8c8e505615055df6926b47a2a, 2018-07-19 11:24:56 -0700, Tongzhou Wang, 0, 0, 0, LINK), (f33cd36c9bb6d3eecd42cb185f22cf76e304fc1b, 2018-07-19 11:24:56 -0700, Tongzhou Wang, 223, 223, 446, LINK)"
9406,1,172,106,278,"(8db44eda013d71ebc5837e45d5ed16b00993a0d2, 2018-12-20 09:35:08 -0800, Erik Brinkman, 172, 106, 278, LINK)"
9409,1,1,1,2,"(5ff686651fecad791e845bf066d730a8b283e8d9, 2018-07-16 15:28:31 -0700, Wanchao Liang, 1, 1, 2, LINK)"
9412,1,1286,60,1346,"(83a1ab213652ffab27bd68569d6d28fead86e7bd, 2018-09-05 19:31:28 -0700, Tongzhou Wang, 1286, 60, 1346, LINK)"
9416,1,59,13,72,"(52cc073212845419af788a97a3ae17a4f401e6fd, 2018-07-17 08:40:07 -0700, vishwakftw, 59, 13, 72, LINK)"
9418,1,10,1,11,"(371a786b18f9b39ac03fa4be6b59f5871c1f947a, 2018-07-31 12:09:12 -0700, Ailing Zhang, 10, 1, 11, LINK)"
9419,1,2,2,4,"(a4f63576b6915a74cba5659d6699ca70e141fe70, 2018-07-14 12:12:40 -0700, Thomas Viehmann, 2, 2, 4, LINK)"
9421,1,17,5,22,"(8444e1660b66082e0ee399d95691921ed504252b, 2018-07-14 12:12:30 -0700, Thomas Viehmann, 17, 5, 22, LINK)"
9447,1,139,193,332,"(976f9253a5425918eda7cf865b097cf42b5da8d7, 2018-07-16 15:17:57 -0700, Edward Yang, 139, 193, 332, LINK)"
9468,2,45,14,59,"(267e1ec112b34bdb925c78fd399ef049f66777d6, 2018-09-05 10:17:08 -0700, Thomas Viehmann, 31, 13, 44, LINK), (6c7fb1582f6d60f2b83b3380b8cb2f3520670b09, 2018-07-30 14:37:21 -0700, Thomas Viehmann, 14, 1, 15, LINK)"
9479,1,39,47,86,"(aee9e90abd8e952253d61961db6dec1e229905fb, 2018-07-19 09:10:40 -0700, Tongzhou Wang, 39, 47, 86, LINK)"
948,1,14,11,25,"(bd0e9a73c79128153be56a4de1a3086ae1f4e960, 2017-03-07 22:47:49 +0800, Zhou Chang, 14, 11, 25, LINK)"
9499,1,98,77,175,"(1bec8f773b87ca95dee0f6deae664bb04b8b541b, 2018-10-26 15:18:02 -0700, William Horton, 98, 77, 175, LINK)"
9502,2,16,2,18,"(886a367247a6350ef82a7e7769c2d48734f2f49e, 2018-07-20 07:43:57 -0700, Tongzhou Wang, 8, 1, 9, LINK), (bfe2aa093e17c84db863672ad446de064e47dc7e, 2018-07-20 07:43:57 -0700, Tongzhou Wang, 8, 1, 9, LINK)"
9507,2,16,2,18,"(886a367247a6350ef82a7e7769c2d48734f2f49e, 2018-07-20 07:43:57 -0700, Tongzhou Wang, 8, 1, 9, LINK), (bfe2aa093e17c84db863672ad446de064e47dc7e, 2018-07-20 07:43:57 -0700, Tongzhou Wang, 8, 1, 9, LINK)"
9513,1,353,225,578,"(4e1c64caee5037917f603c3683973667238c0163, 2018-10-25 16:06:00 -0700, Wanchao Liang, 353, 225, 578, LINK)"
953,1,1,1,2,"(b84d9b48d84807ca2d77d7180bdcf1f68097c61e, 2020-11-30 12:00:47 -0800, Siyeong, 1, 1, 2, LINK)"
9534,1,54,1,55,"(8aedc27a6368c6a08038522c72b225f401e64e88, 2018-09-18 20:15:33 -0700, Wei Yang, 54, 1, 55, LINK)"
9542,1,42,0,42,"(7a377b9a538e813148f5b700f6e482ce42be0b9a, 2018-08-03 11:26:57 -0700, Owen Anderson, 42, 0, 42, LINK)"
9546,1,13,3,16,"(ea67a2bd1160666ae238cdae294b74b56a2d7c73, 2018-07-25 09:20:18 -0700, bhushan, 13, 3, 16, LINK)"
9554,1,5,5,10,"(e0446fcfa9d1129e66978d685056a7122e687bd6, 2018-07-19 08:53:32 -0700, Will Feng, 5, 5, 10, LINK)"
958,1,1,1,2,"(ff5fa111299bbe3aa47fd55bd94d971b90cda646, 2017-03-02 10:37:25 -0800, ngimel, 1, 1, 2, LINK)"
9589,2,16,2,18,"(886a367247a6350ef82a7e7769c2d48734f2f49e, 2018-07-20 07:43:57 -0700, Tongzhou Wang, 8, 1, 9, LINK), (bfe2aa093e17c84db863672ad446de064e47dc7e, 2018-07-20 07:43:57 -0700, Tongzhou Wang, 8, 1, 9, LINK)"
959,1,10,8,18,"(c42a2d4d24a903bc5181f4d7d33529d0cbc72151, 2017-03-03 06:05:06 -0800, Pavan Yalamanchili, 10, 8, 18, LINK)"
9677,1,1,0,1,"(799c947cf3fc6edd50a78af65fa1342a2be0a5f6, 2018-07-31 18:29:10 -0700, Shuichi KITAGUCHI, 1, 0, 1, LINK)"
9687,1,18,8,26,"(4ca1a54526c3bb4583ffee1a0e75075750fabfbd, 2019-02-26 14:11:18 -0800, bhushan, 18, 8, 26, LINK)"
9692,1,57,34,91,"(760679352e8a6fda08b55c7e0cf2c916c7ed6d53, 2018-09-13 18:19:24 -0700, Tongzhou Wang, 57, 34, 91, LINK)"
97,1,104,12,116,"(0f58d20fe43e89138ffcbbf64fb48569539f2e4e, 2019-06-03 20:31:51 -0700, Jianyu Huang, 104, 12, 116, LINK)"
9702,2,3092,2725,5817,"(6a55238a3ff4ae3dfdfe5d87cf35d92fcd10bf2a, 2018-08-10 12:34:53 -0700, Tongzhou Wang, 1404, 1042, 2446, LINK), (43b151224e5487eea00c7ce4e0efd442ee623715, 2018-08-01 07:52:01 -0700, Tongzhou Wang, 1688, 1683, 3371, LINK)"
973,1,153,1,154,"(69e3ee2d5f524e35eb53475d8fb775452634b971, 2020-04-14 07:08:37 -0700, Wojciech Baranowski, 153, 1, 154, LINK)"
9743,1,4,0,4,"(9df9c46992d596cdbc74ef94ead6d628c8e54c08, 2018-07-26 17:03:11 -0700, Ailing Zhang, 4, 0, 4, LINK)"
9754,1,12,11,23,"(7050d83dd728858cb1095788285316d1c3297b86, 2018-07-24 12:35:10 -0700, Thomas Viehmann, 12, 11, 23, LINK)"
9756,2,34,10,44,"(8013dac43d2acb592cab75317f17d4f9c5b9eb6a, 2018-08-15 20:43:20 -0700, Vishwak Srinivasan, 21, 6, 27, LINK), (b43beec07079f64d7407b93e610eab5c0755d766, 2018-08-09 12:26:21 -0700, Vishwak Srinivasan, 13, 4, 17, LINK)"
9776,1,2,2,4,"(bf32ea80942ce720b105efcd517fd11182edeb08, 2018-07-27 09:15:42 -0700, Eugene Vorontsov, 2, 2, 4, LINK)"
9784,2,148,67,215,"(41dce17e223a19ad0fba571ab8bc7ea599698fd0, 2018-08-03 18:20:19 -0700, Edward Yang, 91, 45, 136, LINK), (1d427fd6f66b0822db62f30e7654cae95abfd207, 2018-08-01 15:20:13 -0700, Edward Yang, 57, 22, 79, LINK)"
9817,1,2,8,10,"(e41eb4332783ce32d26fdf3418688a583a5cc478, 2018-07-26 20:48:55 -0700, Vishwak Srinivasan, 2, 8, 10, LINK)"
9818,1,6,2,8,"(3d6015db0e7a43f21a6c7ef56454466ef149897d, 2018-07-29 08:11:58 -0700, peter, 6, 2, 8, LINK)"
9917,1,1098,623,1721,"(24e958a0a779e3dcd7bda19ef3fa702ee654e9dc, 2018-09-19 16:17:18 -0700, Tongzhou Wang, 1098, 623, 1721, LINK)"
9929,1,79,70,149,"(151e7de893c00e11fb1de6b02b386087c1c21721, 2018-08-15 15:10:16 -0700, Thomas Viehmann, 79, 70, 149, LINK)"
9930,1,5,1,6,"(faa96c1c47740823c79bd50832be41df52872ecd, 2018-07-30 12:46:07 -0700, Thomas Viehmann, 5, 1, 6, LINK)"
9934,1,5,5,10,"(5d27d687793f3d62a397b65f6f6218ee871e3dd9, 2018-08-15 12:10:08 -0700, Ailing Zhang, 5, 5, 10, LINK)"
9940,2,393,200,593,"(ed47b85d3bd9c33ed723d2ae5309bebb4d619ac6, 2019-03-22 13:48:59 -0700, Natalia Gimelshein, 93, 32, 125, LINK), (86c9856d9c878631e611de0e138bc409228bbfef, 2018-08-17 14:08:05 -0700, Richard Zou, 300, 168, 468, LINK)"
9941,1,69,96,165,"(b89b46abfb20fb726cd1bc921ebdf6586e80f262, 2018-12-19 21:35:01 -0800, Wanchao Liang, 69, 96, 165, LINK)"
9963,1,24,1,25,"(733402bef4a470ec58086ac254da64920c385da2, 2018-09-07 12:41:16 -0700, vishwakftw, 24, 1, 25, LINK)"
997,1,7,0,7,"(5954211ed90374b54fa44bc8e9ca25ae15bca760, 2017-08-01 11:09:56 -0700, Yangqing Jia, 7, 0, 7, LINK)"
9977,1,25,5,30,"(52d85bedb7e5ea7ce4d81339060994b52765be46, 2018-08-09 08:41:49 -0700, Thomas Viehmann, 25, 5, 30, LINK)"
9981,1,12,1,13,"(4d28b65fb8978f1c34765d56f18c07042e70a43a, 2018-09-01 23:53:32 -0700, Marcin Elantkowski, 12, 1, 13, LINK)"
9984,1,74,32,106,"(54107ae8cf476b4ebe7c631f75273e0b014e748c, 2018-09-11 20:20:54 -0700, Wei Yang, 74, 32, 106, LINK)"
9996,1,102,22,124,"(674f7a977802776c58add622255134df4f38569b, 2018-08-10 13:46:54 -0700, Edward Yang, 102, 22, 124, LINK)"
9997,1,273,9,282,"(2cc98d8df7365aa26eca555028035aef20da3088, 2018-08-29 16:24:16 -0700, pbialecki, 273, 9, 282, LINK)"
