Issue.ID,Number.of.issue.solving.commits.found,Total.additions.made.to.fix.the.issue,Total.deletions.made.to.fix.the.issue,Total.changes.made.to.fix.the.issue,Commits..commit.hashcode..date.of.commit..commit.s.author..number.of.additions.made.by.the.commit..number.of.deletions.made.by.the.commit..number.of.total.changes.made.by.the.commit..approach.used.to.find.the.commit.
1,12,36062,8407,44469,"(cb5b5ffcf18b26c8125b2a9c4c71971c717b52a1, 2021-01-14 16:41:57 -0800, Ken Franko, 57, 1, 58, LINK), (746817af146e65e1e7ebca3a893cb217a4bec938, 2021-01-05 13:37:31 -0800, Advait Jain, 13, 8, 21, LINK), (b092dd17335aae4d970ddaa433fb6d2096f3feb6, 2020-02-18 17:34:51 -0800, Eugene Zhulenev, 201, 6, 207, LINK), (fa91d6a17f1eaca6cf3f93410f3e1d90c7958939, 2020-01-16 00:20:53 +0900, Frédéric Rechtenstein, 18, 0, 18, LINK), (bf57fb99285fff21a85455de7f330b08a53be095, 2019-04-05 19:36:42 -0700, Chris Lattner, 151, 35, 186, LINK), (2303b8eeeb9637f1f7b721e80f23209ff70643c0, 2018-10-30 17:43:06 -0700, Uday Bondhugula, 299, 23, 322, LINK), (231761f671f5ec9860c3df1e99350137cc3b8af5, 2019-02-26 12:37:26 -0800, A. Unique TensorFlower, 1, 1, 2, LINK), (76eb8726160a192ebe6ac5e61d0a0a539cc0dc1a, 2017-10-04 18:51:57 -0700, Colin Raffel, 1, 1, 2, LINK), (cf7c008ab150ac8e5edb3ed053d38b2919699796, 2017-06-28 11:07:44 -0700, Yifei Feng, 35256, 8213, 43469, LINK), (3faa4d2d9672fb6f8ba8f80a0df45dabeb5a3382, 2017-06-26 10:16:32 -0700, A. Unique TensorFlower, 2, 0, 2, LINK), (052e207e4f1076ac6b7464c01a67ecf4f986766d, 2017-03-30 11:35:17 -0800, Eugene Brevdo, 29, 71, 100, LINK), (45009de073a203f54bff7cec0ea83f88c48237b9, 2016-11-23 12:59:05 -0800, Mustafa Ispir, 34, 48, 82, LINK)"
10,19,59752,13656,73408,"(cf7c008ab150ac8e5edb3ed053d38b2919699796, 2017-06-28 11:07:44 -0700, Yifei Feng, 35256, 8213, 43469, LINK), (3faa4d2d9672fb6f8ba8f80a0df45dabeb5a3382, 2017-06-26 10:16:32 -0700, A. Unique TensorFlower, 2, 0, 2, LINK), (1c156f643c9e5cdf5b349f43111b0cd1391ef468, 2017-02-20 21:11:19 +0100, Hans Pabst, 21, 15, 36, LINK), (c80be35454a418c18b3fd57614bfcb5265274c33, 2016-11-21 11:24:53 -0800, Asim Shankar, 200, 77, 277, LINK), (86e348e59ffe6529c150bb2b3c0ce4bc1fcec5d2, 2016-11-18 10:15:20 -0800, Asim Shankar, 94, 42, 136, LINK), (1f0c5119a0230c5160d45496175b9256f097e144, 2016-11-15 00:15:48 -0800, Asim Shankar, 86, 127, 213, LINK), (4187c410e552ea6a27a9a0ad6402ba5ab2dcb4bf, 2016-10-17 15:33:15 -0800, Asim Shankar, 755, 11, 766, LINK), (47318618b24d493877668750f84d114179120ca5, 2016-10-14 12:33:30 -0800, Asim Shankar, 46, 0, 46, LINK), (b17bbb58663502f0b1f45cf278ce7c0573f92154, 2016-10-11 21:39:46 -0800, Asim Shankar, 216, 1, 217, LINK), (6586a66b1eac161221155b8bf1c2a75677623bc3, 2016-10-10 15:24:11 -0800, Asim Shankar, 203, 6, 209, LINK), (b5b1671163c90cf786fe0c65ca6754a85d017847, 2016-10-07 09:56:00 -0800, Asim Shankar, 297, 106, 403, LINK), (2098b9abcf20d2c9694055bbfd6997bc00b73578, 2016-10-05 09:55:48 -0700, Yifei Feng, 14953, 3894, 18847, LINK), (2b929c1cb298d742c8c10ae28146e1c6562aecd8, 2016-10-04 15:12:44 -0800, Asim Shankar, 74, 1, 75, LINK), (2f6e25df47c24b9c84907b605bdbac4a3b208288, 2016-09-29 13:34:47 -0800, Asim Shankar, 9, 7, 16, LINK), (bad7c50b9dc9789ad7dd0a62daca40b7269841ed, 2016-09-28 20:16:51 -0700, Jonathan Hseu, 6894, 1125, 8019, LINK), (7cacfdf03872c36cfc3f43e75e8c342234160e3a, 2016-09-28 10:37:31 -0800, Asim Shankar, 308, 9, 317, LINK), (7bffed6ba12a4d463a0dfb1978e2108343c63eaf, 2016-09-23 10:25:02 -0800, Asim Shankar, 174, 20, 194, LINK), (bb2aa864b335d18d8468d66cb3dd67203484e2d3, 2016-09-23 09:10:07 -0800, Asim Shankar, 86, 2, 88, LINK), (634105240d4ccc4e17b0639584ce647b0bfbc639, 2015-11-25 00:15:45 -0800, Illia Polosukhin, 78, 0, 78, LINK)"
100,1,2,1,3,"(5ff25c9f61e69c6f4b92611093b25b188fd4086b, 2016-02-13 14:34:59 -0800, Illia Polosukhin, 2, 1, 3, LINK)"
1000,1,5,2,7,"(880011919c7b113802eb23c54ed5b8e2218e4416, 2016-02-08 17:22:40 +0100, panmari, 5, 2, 7, LINK)"
10036,1,8,5,13,"(efbfee8f8781e77bd523fa0ca1883a7c0b6689d7, 2017-06-14 16:30:39 +0200, Androbin, 8, 5, 13, LINK)"
10086,1,9,4,13,"(aff4d124b25c9d6fbf0673dbf9bcad750d8771c0, 2017-06-07 19:07:44 -0700, Yuxin Wu, 9, 4, 13, LINK)"
101,1,328,339,667,"(5c46a3d3bf7653036ecb4b9d3c9d48c426f04300, 2019-08-27 12:43:55 -0700, River Riddle, 328, 339, 667, LINK)"
10124,2,9530,2545,12075,"(e55574f28257bdacd744dcdba86c839e661b1b2a, 2017-09-15 19:38:25 -0700, drpngx, 6502, 1910, 8412, REGEX), (2bc7a155a72d207b4e6254e2cc9a240d523c768e, 2017-09-13 10:03:00 -0700, Yong Tang, 22, 2, 24, REGEX)"
10131,1,48,2,50,"(e18c81a0c5e20c170c4de5d1c484034eafd2aa55, 2017-05-26 13:55:12 -0700, Joshua V. Dillon, 48, 2, 50, LINK)"
10216,1,5,0,5,"(5393c03c69394ba3e5940e204606795c16a8d2da, 2017-06-09 11:43:41 -0700, Geoffrey Irving, 5, 0, 5, LINK)"
10236,1,0,2,2,"(3039d7da20e6ace6a7297b8ce581b7c387f3891a, 2017-06-06 06:50:37 +0200, Androbin, 0, 2, 2, LINK)"
10258,1,6,0,6,"(1b6453bec58e3c0c020fe654d04ba4fb8dbb20a3, 2017-06-07 07:03:27 +0200, Joan Puigcerver, 6, 0, 6, LINK)"
10299,1,14,6,20,"(2b351062ac016c8d64e5f6e12bb067154c61b623, 2017-06-08 19:13:04 +0200, Androbin, 14, 6, 20, LINK)"
10315,1,17,3,20,"(7a97dfc3ec5fa7bee974cfc163cb537cb5a63d0e, 2017-09-15 18:35:54 -0700, Yong Tang, 17, 3, 20, REGEX)"
10348,1,29,16,45,"(bfd39838de87cba85f9edf028c1c30bae86da164, 2017-11-03 17:07:50 -0700, Andrew Harp, 29, 16, 45, LINK)"
1035,1,37,19,56,"(73b9dd18ce3017829edef4a5b4190a4f0579369c, 2016-02-11 08:14:54 -0800, Sherry Moore, 37, 19, 56, LINK)"
10369,2,94,52,146,"(d5b89b184c58da9be8f3507db47b7495385ed934, 2017-06-02 14:50:27 -0700, Derek Murray, 47, 26, 73, LINK), (8939b8562027189b24e7609b77e17122dc3a21d4, 2017-06-02 14:50:27 -0700, Derek Murray, 47, 26, 73, LINK)"
10371,1,1,1,2,"(69ba4d3d49bd5775131ae7f00830a41f478dbbf5, 2017-06-05 09:13:06 -0700, Asim Shankar, 1, 1, 2, LINK)"
104,2,424,22,446,"(c6155d1a134ae61233406c881eb427c55cfef084, 2019-09-03 12:13:59 -0700, Uday Bondhugula, 174, 11, 185, LINK), (331cfd4d6f06bea9272eee7442a61aa70a931ead, 2019-09-03 12:13:59 -0700, Uday Bondhugula, 250, 11, 261, LINK)"
1040,1,3,2,5,"(b2757fb5797252bb1ef12bbf04be796cc83000cc, 2016-02-10 13:21:35 -0800, Geoffrey Irving, 3, 2, 5, LINK)"
10437,1,233,14,247,"(cd5ac40b31afaec237aaee35007f2dc846caf811, 2017-06-07 20:13:37 -0700, Peter Hawkins, 233, 14, 247, LINK)"
10447,1,11,4,15,"(4c0052dc4b7c49a876166113b49960a57f7db939, 2017-06-09 12:02:13 +0530, Lakshay Garg, 11, 4, 15, LINK)"
10454,2,4392,1661,6053,"(70fc9bf9b668adebe20ef6d1f7a0e182d7d02cc4, 2017-10-04 13:33:07 -0700, Asim Shankar, 145, 3, 148, LINK), (083bd5dde5e6845a6f5e3b83ea2e074d7b28d61f, 2017-10-04 13:33:07 -0700, Asim Shankar, 145, 3, 148, LINK)"
10494,1,3,3,6,"(51c9b3ab4553acf6f18278e3a66c532e92b95be8, 2017-06-09 12:22:36 +0200, Androbin, 3, 3, 6, LINK)"
105,2,31,0,31,"(fee62e21861aa80d5da2b450a86c33ed879399b7, 2019-08-28 13:55:11 -0700, Eric Schweitz, 13, 0, 13, LINK), (9034ed18511b4893dbaa061c247e85b1b29b056c, 2019-08-28 13:55:11 -0700, Eric Schweitz, 18, 0, 18, LINK)"
10519,1,223,89,312,"(f5fcd1fdcf896f46aed03c7e61525b48b75d1acc, 2017-06-14 14:05:06 -0700, Derek Murray, 223, 89, 312, LINK)"
1052,1,2,2,4,"(97f6b6fb66cd8e52af4750bd183dfc555d08ef4d, 2016-02-25 13:44:06 -0800, Vijay Vasudevan, 2, 2, 4, LINK)"
10521,4,48,21,69,"(8aff5e540a4771a56926ac30be0ebb4cc512e606, 2018-11-15 11:21:55 -0800, A. Unique TensorFlower, 9, 3, 12, LINK), (56e2ee40d3730e1b692ebd7f5a0b970ef3d314ad, 2018-11-07 08:51:44 -0800, A. Unique TensorFlower, 5, 13, 18, LINK), (c2368f875b53e9144a1803a3e67c5a61aa9c5862, 2018-06-07 01:20:14 -0700, A. Unique TensorFlower, 10, 2, 12, LINK), (db47fa9c92f5e8242038021fff0545d0f705802a, 2018-01-08 16:16:19 +0100, Yun Peng, 24, 3, 27, LINK)"
106,2,118,47,165,"(dc378478c81901b918c7ccc7c3d464683b770c09, 2019-09-04 06:58:39 -0700, Uday Bondhugula, 20, 12, 32, LINK), (0d78918b81a0199d2dbc70c0f1fdff5c414fc358, 2019-09-04 06:58:39 -0700, Uday Bondhugula, 98, 35, 133, LINK)"
1064,1,1,1,2,"(59a3e7e367dde6c6764e268550d2c80d84fffebb, 2016-02-13 15:58:23 -0800, Martin Wicke, 1, 1, 2, LINK)"
1069,1,119,80,199,"(14ac2235699509f512b44b71160239c153ab413d, 2016-05-26 15:20:44 -0700, David Z. Chen, 119, 80, 199, LINK)"
107,2,112,86,198,"(33816654d2bab7a394886852a5a484cda7ada5e9, 2019-08-29 01:13:01 -0700, Uday Bondhugula, 23, 11, 34, LINK), (a03eebc2376b333f2ceec13c7a4addecbf36ac96, 2019-08-29 01:13:01 -0700, Uday Bondhugula, 89, 75, 164, LINK)"
10725,1,15,0,15,"(1111e06d9cd691cbdfcb67cf9f234a504f4e0f6d, 2017-06-16 10:15:27 -0700, Vijay Vasudevan, 15, 0, 15, LINK)"
10741,1,1,1,2,"(76a0a15cb90c370e41766d124a7a11b28c18089a, 2017-06-15 14:56:36 -0700, Andrew Selle, 1, 1, 2, LINK)"
10749,2,686,439,1125,"(4a3cbea5f3d1f79eb2ff6bb2c64875e951ca3ce2, 2019-09-12 14:55:31 -0700, RJ Skerry-Ryan, 490, 329, 819, LINK), (8f0a90b711480c12716d1a3b1094cc8b34939f2d, 2018-05-02 17:57:27 -0700, RJ Ryan, 196, 110, 306, LINK)"
1076,1,8,0,8,"(44629a261d2b30b5aa78b13907ccdb736b303962, 2016-02-13 14:26:08 -0800, Vijay Vasudevan, 8, 0, 8, LINK)"
10766,1,42,0,42,"(7687debbf63e31375d960d663373da8d469f2d2e, 2017-07-14 16:46:49 -0700, Joshua V. Dillon, 42, 0, 42, LINK)"
10823,1,4,3,7,"(c1184705b1f5d2662f02b13700062a3a3d828e19, 2017-06-28 23:42:44 +0530, Tapan Prakash, 4, 3, 7, LINK)"
10835,1,26,1,27,"(ea79ba41be89d76180305b14d26d5c2f256d4c08, 2017-06-28 02:04:03 +0530, Anish Shah, 26, 1, 27, LINK)"
1084,1,1,1,2,"(c98c91b53074fa7697303e95e7e1e8b8941c59e9, 2016-02-13 13:38:55 -0800, Vijay Vasudevan, 1, 1, 2, LINK)"
10857,1,208,70,278,"(5ee38042d2bd7368ab671846a3ed507e6ae8d23e, 2017-09-21 17:00:01 -0700, Yuxin Wu, 208, 70, 278, LINK)"
109,3,67,5,72,"(977cb12055ca3b7f7ba47af249967c42c64b3743, 2019-09-06 11:02:31 -0700, Nagy Mostafa, 15, 2, 17, LINK), (5009581c19cf6a8f9908c48ba9004bdc66628c06, 2019-09-06 11:02:31 -0700, Nagy Mostafa, 51, 2, 53, LINK), (fc87d9110c44896427ef8c0bc08a96ef59f0e995, 2017-07-04 07:05:02 +0100, Luke Iwanski, 1, 1, 2, LINK)"
1097,1,31,2,33,"(b2bf45a0b91403fa00c0b35480e69d26eb8ce58d, 2016-07-11 10:55:21 -0800, Shanqing Cai, 31, 2, 33, LINK)"
11,3,72,16,88,"(1c156f643c9e5cdf5b349f43111b0cd1391ef468, 2017-02-20 21:11:19 +0100, Hans Pabst, 21, 15, 36, LINK), (bc923f66566b56b141a864b851a2d8ee8cfa9894, 2016-11-07 20:25:02 +0000, Luke Iwanski, 49, 0, 49, LINK), (bdb44703e9bd7f60798f0f812bd1705dba4a9532, 2015-11-27 20:35:54 -0800, Illia Polosukhin, 2, 1, 3, LINK)"
110,4,104,55,159,"(25ac1897608ea97258b71d04acf3e72b6952e076, 2019-08-30 17:38:36 -0700, Uday Bondhugula, 22, 10, 32, LINK), (f558cdaccba7f5079ebde1e11aaad733503f7857, 2019-08-30 17:38:36 -0700, Uday Bondhugula, 22, 10, 32, LINK), (6ebb3be47881f63cafa60e257811f29191d4fc1a, 2016-06-28 20:24:27 +0200, Jan Wilken Dörrie, 4, 2, 6, LINK), (d16868d4bd4c7730b9d0b02f97ee9ea46b77f057, 2016-02-25 10:10:16 -0800, Illia Polosukhin, 56, 33, 89, LINK)"
11005,2,48,48,96,"(f0923262ed4d89f2a201f6e7ca02e5d118c1b4d3, 2017-07-18 12:38:51 -0700, Alan Yee, 8, 8, 16, REGEX), (8695d596385e754159af5a1f0ae0676163bc73bb, 2017-06-27 13:40:33 -0700, Amit Patankar, 40, 40, 80, REGEX)"
11016,1,86,13,99,"(9b11f458196f6f0528c9974238497a6c8b6da547, 2017-06-29 11:10:56 -0700, Derek Murray, 86, 13, 99, LINK)"
11017,1,299,52,351,"(41bc76d28b8b301c546cc5624abd37fd8b97b64c, 2017-07-05 18:17:18 -0700, Shanqing Cai, 299, 52, 351, LINK)"
1102,2,90,0,90,"(bf08a419e5855c57665e7bc21dc7d4df374dc89c, 2016-02-15 16:50:56 -0800, Vijay Vasudevan, 45, 0, 45, LINK), (0ee27e38afb2682dc7a320397c5d29f43ea7f354, 2016-02-15 16:50:56 -0800, Vijay Vasudevan, 45, 0, 45, LINK)"
11077,2,14,0,14,"(ed678b04017b0951267b3e882a6d4953b4de7c04, 2017-07-18 09:30:16 -0700, Eugene Brevdo, 7, 0, 7, LINK), (a3d3ce160368efe4b0b3f7f8df23cc8423680364, 2017-07-18 09:30:16 -0700, Eugene Brevdo, 7, 0, 7, LINK)"
11091,1,23,4,27,"(e121535a7d04cfc7c7dbb09d8694c01eb29da26f, 2017-07-10 12:47:38 -0700, Alexandre Passos, 23, 4, 27, LINK)"
111,3,123,24,147,"(a4aa30b61dc5d033f6e2ecd7400e7d522c44bec9, 2019-09-13 22:11:23 -0700, Uday Bondhugula, 35, 2, 37, LINK), (f5de230422b696c2049a223432fa0bad4eeca97a, 2019-09-13 22:11:23 -0700, Uday Bondhugula, 85, 22, 107, LINK), (af5e87dedad1a88e0a4d962dbc5c9c18f79480ec, 2017-08-07 22:42:56 +0100, Luke Iwanski, 3, 0, 3, LINK)"
11132,1,98,9,107,"(66604b0355b32961f9a532792be2e008cc22221f, 2017-07-05 21:31:39 -0700, Asim Shankar, 98, 9, 107, LINK)"
11152,1,3,0,3,"(129b39e916cf6e3076f8a03b1d6277f5f7ecd166, 2017-07-05 17:20:41 +0200, Julian Viereck, 3, 0, 3, LINK)"
112,2,300,76,376,"(2ad042991c032bf38ea96b34814d44816fc7f78b, 2019-09-05 23:12:01 -0700, Uday Bondhugula, 139, 38, 177, LINK), (efe9bc678c241e22ec7bebf3edc674d3e28678ae, 2019-09-05 23:12:01 -0700, Uday Bondhugula, 161, 38, 199, LINK)"
11223,1,772,206,978,"(b1f9e2c89eb007cb4b9483d08dcace1e45e84164, 2017-07-11 09:51:54 -0700, RJ Ryan, 772, 206, 978, LINK)"
1123,2,54,14,68,"(3f1d5d5670e42ea4b01795c787e847dc799b9e54, 2016-02-17 13:46:29 -0800, Derek Murray, 27, 7, 34, LINK), (42f06d870014dec70769cbdd8697821c92880be9, 2016-02-17 13:46:29 -0800, Derek Murray, 27, 7, 34, LINK)"
11252,1,45,5,50,"(a24f96a3f70e0cc0792410673f55c4a898dea604, 2017-07-13 15:44:41 -0700, Jonathan Hseu, 45, 5, 50, LINK)"
1135,2,54,14,68,"(3f1d5d5670e42ea4b01795c787e847dc799b9e54, 2016-02-17 13:46:29 -0800, Derek Murray, 27, 7, 34, LINK), (42f06d870014dec70769cbdd8697821c92880be9, 2016-02-17 13:46:29 -0800, Derek Murray, 27, 7, 34, LINK)"
11372,1,57,4,61,"(1de8cce6643bb75edd1441fa01ffb6a0e5258c5f, 2017-07-11 12:57:41 -0700, A. Unique TensorFlower, 57, 4, 61, LINK)"
11396,1,57,4,61,"(1de8cce6643bb75edd1441fa01ffb6a0e5258c5f, 2017-07-11 12:57:41 -0700, A. Unique TensorFlower, 57, 4, 61, LINK)"
114,1,977,371,1348,"(153be4d261a066a9f31b929077bf58793278e558, 2017-07-31 17:27:31 +0100, Luke Iwanski, 47, 2, 49, LINK)"
11422,1,19,11,30,"(cbe1ef05fff2d4fbd0ecc8f3a2c3a3a0f0dc312d, 2017-07-11 14:26:30 -0700, Mark Daoust, 19, 11, 30, LINK)"
1145,1,33,14,47,"(e19437c09af0ba8eb83b282ffd4b76a2444f01d3, 2016-06-30 08:53:19 -0800, Shanqing Cai, 33, 14, 47, LINK)"
1146,2,4,4,8,"(477354072837c4f869e173dcd0c0464fd3fa802b, 2016-02-17 11:26:12 -0800, Vijay Vasudevan, 2, 2, 4, LINK), (19d632338f983e02dd0268b931e9cced03b74805, 2016-02-17 11:26:12 -0800, Vijay Vasudevan, 2, 2, 4, LINK)"
11462,1,40,37,77,"(201fa224e178b76ece4723c433a17df10005341c, 2017-07-13 14:58:13 -0700, A. Unique TensorFlower, 40, 37, 77, LINK)"
1147,2,2,2,4,"(798fb10a81c493a5e19e624dab71963dbd928691, 2016-02-17 17:10:19 -0800, Vijay Vasudevan, 1, 1, 2, LINK), (0c6ad48701fb5d81fedfc67d41dcf2b3c91200cf, 2016-02-17 17:10:19 -0800, Vijay Vasudevan, 1, 1, 2, LINK)"
11484,1,18,1,19,"(ee8d9f353a29c3b0df8447e94c11f1a61ee75583, 2017-07-14 16:23:15 -0700, Vijay Vasudevan, 18, 1, 19, LINK)"
115,2,45,28,73,"(7ff3a1de3bbe21ae2e3b45d7719a231c03d2c9b6, 2019-09-01 11:32:52 -0700, Mehdi Amini, 18, 13, 31, LINK), (1e94b99d2522a1759f47748e24558742fdecae64, 2019-09-01 11:32:52 -0700, Mehdi Amini, 27, 15, 42, LINK)"
11501,1,78,63,141,"(0ffefe178f71ddb595471ddfc43edb8d702155ca, 2017-08-09 08:59:07 -0700, Yong Tang, 78, 63, 141, LINK)"
11540,2,14,0,14,"(ed678b04017b0951267b3e882a6d4953b4de7c04, 2017-07-18 09:30:16 -0700, Eugene Brevdo, 7, 0, 7, LINK), (a3d3ce160368efe4b0b3f7f8df23cc8423680364, 2017-07-18 09:30:16 -0700, Eugene Brevdo, 7, 0, 7, LINK)"
11554,1,344,53,397,"(9389c25983e025daff330fc4126d6a525ce32c77, 2017-11-05 10:20:10 -0800, Yong Tang, 344, 53, 397, REGEX)"
116,2,14,26,40,"(476635ebafa0013d96e36a4b7bf2a52108f8c1a0, 2019-09-03 11:12:25 -0700, Alex Torres, 7, 13, 20, LINK), (b09e5b90533baf5e569e88776ec5dccc512e3e8b, 2019-09-03 11:12:25 -0700, Alex Torres, 7, 13, 20, LINK)"
11602,1,1,0,1,"(a98da3d667f3be86db49cbe0586c8fbb19023090, 2018-01-11 11:47:34 -0800, Asim Shankar, 1, 0, 1, LINK)"
1162,1,229,37,266,"(bce6216610d57f8f4b1e9e79836737df109c4e42, 2016-02-24 16:27:54 -0800, Vincent Vanhoucke, 229, 37, 266, LINK)"
11650,1,201,20,221,"(cb3314159fe102419289d394246d7ac9c2a422c1, 2017-08-22 11:10:29 -0700, Eugene Brevdo, 201, 20, 221, LINK)"
11666,2,116,16,132,"(672c96cefcd1bc490f86cb81ff0e335ffcd1886b, 2017-07-21 13:13:27 -0700, Eugene Brevdo, 58, 8, 66, LINK), (307a2fc2adc2c6b717bb9713f81289f6bbb91b07, 2017-07-21 13:13:27 -0700, Eugene Brevdo, 58, 8, 66, LINK)"
11673,2,16,13,29,"(3953afc536c362574a454c1bd6e7047f161ee79f, 2017-11-22 12:16:40 +0530, Shreyash sharma, 7, 12, 19, LINK), (a52fc6278299fb6d647609f2b49c0c4cb087b646, 2017-09-07 16:53:50 -0700, Yong Tang, 9, 1, 10, REGEX)"
117,3,17,9,26,"(6e88084432e08f5afeda33d76d61493ac89953fd, 2019-09-03 11:27:00 -0700, River Riddle, 1, 1, 2, LINK), (a32d6a644f3f90c4f87a8d5abea4ffd83e29429f, 2019-09-03 11:27:00 -0700, River Riddle, 4, 1, 5, LINK), (bc45f6930e49432aa29ca2ba53dc23e7d338b57d, 2017-07-06 11:58:46 +0100, John Lawson, 12, 7, 19, LINK)"
1171,1,7,0,7,"(09d236384513e205d1a46a59e3a768ffc91c3d47, 2016-06-30 23:30:41 +0800, Wenjian Huang, 7, 0, 7, LINK)"
11715,2,110,0,110,"(16c9d227ea6d65c7443c0363e85cae43d9fea6e4, 2017-08-08 14:47:59 -0700, Derek Murray, 55, 0, 55, LINK), (865b92da01582081576728504bedf932b367b26c, 2017-08-08 14:47:59 -0700, Derek Murray, 55, 0, 55, LINK)"
11735,1,20,3,23,"(694892d4c0fba6bd4322e943f8b1483b36f1ae99, 2018-05-29 05:05:08 +0200, Yun Peng, 20, 3, 23, LINK)"
118,2,35,16,51,"(d28ca29e52f7635f24470d696c4b61ec26661fa0, 2016-02-28 17:22:54 -0800, Illia Polosukhin, 11, 9, 20, LINK), (e576ca6eb5ef5aaff670785530b842feb3d81316, 2016-02-28 16:46:52 -0800, Illia Polosukhin, 24, 7, 31, LINK)"
11804,1,0,2,2,"(dfbacef32d1fdafe71caad4c99ce8c4b648e6397, 2018-04-09 15:45:48 +0000, Ilya Polenov, 0, 2, 2, LINK)"
11821,1,55,42,97,"(ea53262ee056f89a340a758308cb609212afa1e7, 2017-08-21 15:57:55 -0700, A. Unique TensorFlower, 55, 42, 97, LINK)"
11841,1,17,5,22,"(9a1b56c46c01ba045e95fa8eadabb988e8a8793c, 2019-10-17 15:15:56 -0700, Reed Wanderman-Milne, 17, 5, 22, LINK)"
11890,1,1162,371,1533,"(3cc5fc0886ab0a68aedd1700a4bbd58b915ab8ac, 2017-08-01 07:59:31 -0700, Chris Leary, 232, 2, 234, LINK)"
11923,1,2,3,5,"(6c62fa93ad22594c65e1b3f7aecce79da660f5e9, 2017-12-23 18:39:49 -0800, Andy Craze, 2, 3, 5, LINK)"
1198,1,4,0,4,"(484a80ce99998b59cf9f606a7c2a9ad1c14ea29a, 2016-03-08 10:35:18 -0800, A. Unique TensorFlower, 4, 0, 4, LINK)"
12,1,43,30,73,"(bcb537d10d22364f72acbb1ded7e12d23d8bb958, 2017-02-06 21:03:13 -0800, Anand Venkat, 43, 30, 73, LINK)"
120,4,20,2,22,"(e46c8323be5f4a9033e3e061473a3ff794422804, 2019-09-04 19:16:32 -0700, Nicolas Vasilache, 3, 0, 3, LINK), (72e261bae4f48eb513cee6f7ffea5ecd0c90458b, 2019-09-04 19:16:32 -0700, Nicolas Vasilache, 3, 0, 3, LINK), (eb06eb2fa1f75320ec538b82958d3908c249e36a, 2016-03-05 15:21:58 -0600, terrytangyuan, 2, 2, 4, LINK), (b0cddab4d103fc0170f22736f73ff40deaedc126, 2016-03-05 14:57:51 -0600, terrytangyuan, 12, 0, 12, LINK)"
12018,1,67,11,78,"(0e222435d28eaf0efb8a30493d98cace3d4f02bf, 2017-09-19 15:33:10 -0700, Yong Tang, 67, 11, 78, REGEX)"
12059,2,57,26,83,"(35c44ab67d6e5d9b24f3f154c92e7aa3edfee957, 2017-09-26 18:00:16 -0700, Shanqing Cai, 23, 23, 46, LINK), (ecb544ae124ab6c62941d0b1906f3e8b1a073108, 2017-08-07 08:25:36 -0700, Shanqing Cai, 34, 3, 37, LINK)"
12083,1,21,17,38,"(ed2473c776e04eca3019561a57c3447a3b062321, 2017-08-09 08:57:44 -0700, Yong Tang, 21, 17, 38, REGEX)"
121,2,231,99,330,"(4ae88ff1efdeeb252b8bf417ed3cf03ab722499b, 2019-09-17 11:49:14 -0700, Uday Bondhugula, 101, 48, 149, LINK), (5d81613258e3f76b02246ce772a17359dc069bdf, 2019-09-17 11:49:14 -0700, Uday Bondhugula, 130, 51, 181, LINK)"
12110,1,10,13,23,"(ada51982f60746c2c2147117c5f2e0c972725143, 2017-08-09 21:07:30 -0700, Andrew Harp, 10, 13, 23, LINK)"
12113,1,77,11,88,"(af47270e4722596d67c04e480bbf6149e8a7cd38, 2017-08-09 04:18:39 +0000, Yong Tang, 77, 11, 88, REGEX)"
12117,1,1,1,2,"(34ff4822c40f97cdb1b8dfc9f149c28e39fb0087, 2017-08-10 17:35:23 +0200, Yun Peng, 1, 1, 2, LINK)"
12141,1,2,2,4,"(021d3e476e47971bda2ad39699dc7d69f3a79eb9, 2017-08-09 13:48:54 +0000, Yong Tang, 2, 2, 4, REGEX)"
12169,1,12,0,12,"(92111fdd1a9baa113264149413105f700f9ee310, 2017-08-10 10:55:28 -0700, Yong Tang, 12, 0, 12, REGEX)"
12181,1,7,1,8,"(2133b83376a3439924a0bb9bac7b4a8b716a6fc0, 2017-08-17 12:51:02 -0700, Yifei Feng, 7, 1, 8, LINK)"
12185,1,1,1,2,"(8b75375e0c256bf173442ff2bddecb572692b78e, 2017-08-14 10:49:17 -0700, Yifei Feng, 1, 1, 2, LINK)"
122,2,231,99,330,"(4ae88ff1efdeeb252b8bf417ed3cf03ab722499b, 2019-09-17 11:49:14 -0700, Uday Bondhugula, 101, 48, 149, LINK), (5d81613258e3f76b02246ce772a17359dc069bdf, 2019-09-17 11:49:14 -0700, Uday Bondhugula, 130, 51, 181, LINK)"
12210,1,1970,141,2111,"(565a9d3509299383ef7ae6815760fc42237e4cb6, 2017-08-17 17:26:00 -0700, Vijay Vasudevan, 1, 1, 2, LINK)"
12224,1,8,0,8,"(9e6183e4acbb1b795069947faf778a47709d2029, 2017-08-15 11:18:41 -0700, Yong Tang, 8, 0, 8, REGEX)"
12232,1,25,9,34,"(53aef8a3a5920e53f7da3ea2140374546d1bf708, 2017-08-17 09:51:41 -0700, Yong Tang, 25, 9, 34, LINK)"
12249,1,21,1,22,"(93a652ef5b635ffbd678d3992767c4862bffeb15, 2017-12-11 12:00:02 -0600, Yong Tang, 21, 1, 22, REGEX)"
123,3,6812,2387,9199,"(512f92db4e27a2871d94ffccaf9d01e7389b497c, 2019-09-07 09:59:47 -0700, Uday Bondhugula, 48, 21, 69, LINK), (5029d9de811e8f9f3e8a0c894fb3a51c3dd9b89d, 2019-09-07 09:59:47 -0700, Uday Bondhugula, 48, 21, 69, LINK), (ab96f41fb4c4f17e96fd6177aa589c19df580456, 2017-08-11 01:35:21 +0100, Luke Iwanski, 286, 285, 571, LINK)"
12366,1,1,1,2,"(c10c81943c3e829cd58ec8d5cc547ced82f850ce, 2017-08-17 20:05:00 -0700, Derek Murray, 1, 1, 2, LINK)"
12372,1,2077,153,2230,"(64e54423bbffa4161ba2d85dc913e1973ae52cc6, 2017-08-18 13:41:48 -0700, Derek Murray, 108, 13, 121, LINK)"
12396,1,2017,140,2157,"(d001b58de9d0d99ef34637b9a9bed5763875f655, 2017-08-18 11:41:47 -0700, Derek Murray, 48, 0, 48, LINK)"
124,2,1434,1346,2780,"(b21ebf776d282879f43c4f51f2176a04b4698170, 2019-09-14 13:23:18 -0700, Uday Bondhugula, 717, 673, 1390, LINK), (283ede3ea8a12b67b0fbf56c48bc7dcfaf2aaed6, 2019-09-14 13:23:18 -0700, Uday Bondhugula, 717, 673, 1390, LINK)"
12401,1,4,3,7,"(0120939de92fa60c01569ea3ed33f785e6026450, 2017-09-26 07:16:54 -0700, Jett Jones, 4, 3, 7, LINK)"
12403,1,1,1,2,"(b4302ee705036e9f7ef156fee6f2a3880909bbc1, 2017-09-04 16:42:38 +0000, Yong Tang, 1, 1, 2, REGEX)"
12414,1,4,4,8,"(301a6c41cbb111fae89657a49775920aa70525fd, 2017-11-14 12:13:19 -0800, Derek Murray, 4, 4, 8, LINK)"
12416,1,1,1,2,"(ab2ee557c4d8584fefeeda620dfbec2e4c72c227, 2017-08-23 23:04:25 -0700, Yong Tang, 1, 1, 2, REGEX)"
12431,1,81,49,130,"(0e69f536c13d6db7e8276ee7ffe249a82d89f246, 2017-09-07 21:36:09 -0400, Artsiom Chapialiou, 81, 49, 130, LINK)"
12436,1,2,1,3,"(9ba48146942219a2d97e9a2110f88f20d62c4cb6, 2017-09-17 11:11:33 -0700, Yong Tang, 2, 1, 3, REGEX)"
12444,1,2,2,4,"(dc1b93aedc4ffd6e545226f7861bb64c2eb880ff, 2017-08-21 12:05:00 -0700, Yong Tang, 2, 2, 4, REGEX)"
12514,1,25,1,26,"(1614536c1312eeba8356bb1e24a8bb51ce7e16c7, 2018-05-16 13:22:53 -0700, Brian Patton, 25, 1, 26, LINK)"
12525,1,1,1,2,"(739b760d5e2e718f31cdd023f015d62e4da9aabc, 2017-08-25 11:17:16 -0700, Yong Tang, 1, 1, 2, LINK)"
12528,1,16,13,29,"(e64993b5d0075cdc7162d51c37a8a5ae0f5fb007, 2017-08-23 20:18:07 -0700, Yong Tang, 16, 13, 29, REGEX)"
126,2,26,8,34,"(4951f6fd7d09649987548a2d76e816ccde3d6b7a, 2019-09-13 18:18:21 -0700, Uday Bondhugula, 9, 2, 11, LINK), (bf463b2ca6aef94b6d48abdf34b899185bef6ea2, 2019-09-13 18:18:21 -0700, Uday Bondhugula, 17, 6, 23, LINK)"
12641,1,131,11,142,"(b1f5f433959406c7aad634c05e85ccd62fd06e87, 2018-02-07 16:46:31 -0800, Yong Tang, 131, 11, 142, REGEX)"
12663,1,2,0,2,"(731fc1ecaac8a527ac606ff595f313ab9ebbb7fa, 2018-08-08 14:34:16 -0700, rasmi, 2, 0, 2, LINK)"
1270,1,16,4,20,"(f417134a5a41a9fc4ab0161c9215633f3c4c0156, 2016-02-26 13:16:46 -0800, Manjunath Kudlur, 16, 4, 20, LINK)"
12715,1,115,0,115,"(a4fe92514fab8d75d6acf5f593cf7e7c8cea919f, 2017-09-01 15:56:58 -0700, A. Unique TensorFlower, 115, 0, 115, LINK)"
12735,2,9521,2556,12077,"(e55574f28257bdacd744dcdba86c839e661b1b2a, 2017-09-15 19:38:25 -0700, drpngx, 6502, 1910, 8412, LINK), (1e96d54d9f928c4ea4bf0564ef9900f6bd03acd5, 2017-09-12 00:47:55 -0700, gunan, 13, 13, 26, LINK)"
12736,1,6,0,6,"(7ac7aa868406a5d9b03e4101509ac80e011b91c7, 2017-12-06 09:03:26 -0800, Mark Daoust, 6, 0, 6, LINK)"
1274,1,9,8,17,"(23753679279336f425484185a03fc3747fc79361, 2016-02-24 15:34:12 -0800, Daniel Golden, 9, 8, 17, LINK)"
12755,1,72,4,76,"(0b0d3c12ace80381f4a44365d30275a9a262609b, 2017-09-26 17:00:14 -0700, Yong Tang, 72, 4, 76, REGEX)"
12797,2,561,607,1168,"(244b8d6b0767c0fb63e58e56f58d03bd97c27822, 2017-09-29 16:44:17 -0400, Andrew Myers, 554, 605, 1159, LINK), (8403a195522b5d7e707c36316ec8d8fd05f33183, 2017-09-07 15:02:21 -0400, Andrew Myers, 7, 2, 9, LINK)"
128,1,16,16,32,"(f3111525c97a25adef40854a588fd5590e7f6eb1, 2016-01-26 21:14:49 -0800, Dongjoon Hyun, 16, 16, 32, LINK)"
12856,1,255,0,255,"(d27db78cd0168f10b308f7508c11dfaa3c6707e9, 2017-09-07 20:23:33 -0700, A. Unique TensorFlower, 255, 0, 255, LINK)"
12969,2,9635,2651,12286,"(e55574f28257bdacd744dcdba86c839e661b1b2a, 2017-09-15 19:38:25 -0700, drpngx, 6502, 1910, 8412, LINK), (c8a6131e9f40cc8b5db96e3098a7680e16b7d289, 2017-09-13 09:26:41 -0700, Mark Daoust, 127, 108, 235, LINK)"
12998,1,2,4,6,"(928965b5e4b0557154da3339ad15041e430e444f, 2017-09-13 13:16:42 -0700, A. Unique TensorFlower, 2, 4, 6, LINK)"
130,4,818,28,846,"(ab6565f0c31580b2eeee024db23aabd2b44d6923, 2019-09-21 10:18:00 -0700, Denis Khalikov, 356, 13, 369, LINK), (5e6af2eef30782373514fa7879e663e38220ca90, 2019-09-21 10:18:00 -0700, Denis Khalikov, 428, 13, 441, LINK), (f54a858924b03fc2d11d8c1250e596d34d300b9b, 2016-05-20 11:51:19 -0800, Eugene Brevdo, 1, 2, 3, LINK), (a9a488de5754936a7e67245033f0d6b5fe7b4c88, 2016-03-09 10:26:20 -0800, Illia Polosukhin, 33, 0, 33, LINK)"
13013,1,207,211,418,"(94b3d7fd8ac71f8475b2d53e78f89cf68ff05819, 2017-09-20 14:23:41 -0700, Andrew Harp, 207, 211, 418, LINK)"
13038,1,35,5,40,"(189b2b47a18a1302b9f272e423798db4234cbbc1, 2017-09-14 15:41:00 -0700, A. Unique TensorFlower, 35, 5, 40, LINK)"
13065,1,4,1,5,"(55cf7a70883ce5de1f5826394e9408e06a0fca61, 2017-09-26 13:02:25 -0700, Derek Murray, 4, 1, 5, LINK)"
1307,1,6,0,6,"(ea2bda904d52695374dd2ae9f5f160692ad6ef09, 2016-06-06 16:31:29 -0700, Derek Murray, 6, 0, 6, LINK)"
131,1,1,1,2,"(8312f3eff85ce927c00f7fe4ec1c2fa26da52746, 2016-03-08 14:08:36 -0600, Yuan Terry Tang, 1, 1, 2, LINK)"
1310,1,3,126,129,"(77887d9f79d0573ceb6254cd322fdbe79f106978, 2016-03-01 07:28:05 -0800, Derek Murray, 3, 126, 129, LINK)"
13101,1,85,12,97,"(be2b6e1908fba684831f1768c512a703a4468cfe, 2018-05-14 18:04:31 -0700, Derek Murray, 85, 12, 97, LINK)"
13129,1,4,0,4,"(846454faae5a66fa430b03c82f571440919070f3, 2017-09-20 15:33:28 +0100, Andrei Nigmatulin, 4, 0, 4, LINK)"
13133,1,2,0,2,"(6271467df2f0bf7c776f888bed3c6722502efc51, 2018-03-17 01:58:09 +0900, Jakub Kolodziejczyk, 2, 0, 2, LINK)"
13137,1,5710,982,6692,"(e0501bc4d0293f4c2a42d56cf0caff1b9a8b4e4c, 2017-09-22 20:30:07 -0700, Yong Tang, 15, 3, 18, REGEX)"
13161,1,6,0,6,"(46d6620e4b7f71b420c58df90e7ceb89609ac85a, 2018-01-11 10:47:14 -0800, Derek Murray, 6, 0, 6, LINK)"
13190,1,4221,1667,5888,"(d016cb020583b1ecbc260c1492e347c2731b1c29, 2017-10-04 00:07:16 -0700, Suharsh Sivakumar, 119, 12, 131, LINK)"
132,2,72,20,92,"(eefe6882e1a553c299f1afdfd16bf411dcfc011f, 2019-09-14 13:21:00 -0700, Uday Bondhugula, 15, 10, 25, LINK), (3229426e01438a387ce62ab28e3aaddd77bca268, 2019-09-14 13:21:00 -0700, Uday Bondhugula, 57, 10, 67, LINK)"
13202,1,50,0,50,"(0f508d4de379e800ad7f990de08959bbd6fcabb5, 2018-03-15 12:33:10 -0700, Derek Murray, 50, 0, 50, LINK)"
13211,1,62,8,70,"(4ec3b601216a9727ebb78a764d34b487286629af, 2018-04-15 19:23:53 -0700, Yong Tang, 62, 8, 70, REGEX)"
13258,1,2,3,5,"(85e4dc47ea8d68bdd98f0982ba57ceb694115742, 2018-04-26 09:56:00 -0700, Yanping Huang, 2, 3, 5, LINK)"
1328,1,3,3,6,"(845fb7ab77fae53b849894925c7d13c1b8918675, 2016-06-06 14:35:55 -0700, Geoffrey Irving, 3, 3, 6, LINK)"
1329,1,20,1,21,"(d782317f55a1fc4944cb321c5c8132a7514acadc, 2016-03-22 16:28:38 -0700, Geoffrey Irving, 20, 1, 21, LINK)"
13293,1,2,0,2,"(1398d4bec48618bc497b7be7cfd655d5d80c4efd, 2017-09-26 01:12:37 +0000, Yong Tang, 2, 0, 2, REGEX)"
133,2,328,230,558,"(b4cd2efdfdd8807b79fd3bdadf9440d8088a27e1, 2019-09-14 12:10:18 -0700, Uday Bondhugula, 151, 113, 264, LINK), (4a6216db4eec681fe02fbe7dc0fa1ed21feb59bf, 2019-09-14 12:10:18 -0700, Uday Bondhugula, 177, 117, 294, LINK)"
1334,1,2,0,2,"(a886c9e74a00038d12866c60b3c2e5efcc4ee8e4, 2016-02-29 11:01:15 -0800, Vijay Vasudevan, 2, 0, 2, LINK)"
13350,1,4103,1656,5759,"(d6e963b82b3fd6ed331206ec89de83cc7bdb5b91, 2017-10-03 15:23:43 -0700, Asim Shankar, 1, 1, 2, LINK)"
13355,1,55,14,69,"(d6b616925657bc44de9bd6a5ddf3437e9c7ba88b, 2017-10-12 09:56:28 -0700, Eugene Brevdo, 55, 14, 69, LINK)"
13357,3,13,9,22,"(86635c165ef3255150d907beabaecd46e6e57840, 2017-09-28 08:31:53 -0700, Peter Hawkins, 1, 1, 2, LINK), (f2231b147539dcca41003b14508c72e722b044ef, 2017-09-28 08:31:53 -0700, Peter Hawkins, 1, 1, 2, LINK), (8a154ead1e7089873746a8b282c5f4be22b65626, 2017-09-28 08:31:53 -0700, Peter Hawkins, 11, 7, 18, LINK)"
13377,2,2,2,4,"(7b943ac26fca5e7bd2973da8e73e4a1d75aaba2d, 2017-10-02 19:05:33 +0200, Vladimir Moskva, 1, 1, 2, LINK), (bf1114170f2294467b3e96d8a723823c4b5fec94, 2017-10-02 19:05:33 +0200, Vladimir Moskva, 1, 1, 2, LINK)"
134,2,524,4,528,"(ead6e53b608b620fc31a516d7a972430ebb98bb6, 2019-09-21 16:14:07 -0700, Manuel Freiberger, 184, 2, 186, LINK), (bff26c618f6ab61e6ec2782148f9b5aeebd5d23e, 2019-09-21 16:14:07 -0700, Manuel Freiberger, 340, 2, 342, LINK)"
1341,1,15,3,18,"(868aa1e04a7574e74b93fc693c8cfcd62a5037eb, 2016-03-02 16:50:33 -0800, Jianmin Chen, 15, 3, 18, LINK)"
1343,1,14,0,14,"(80ddfbf11f63cf5d55ad16f4bc871cdd18ced3da, 2016-03-02 13:33:49 -0800, Derek Murray, 14, 0, 14, LINK)"
13431,1,59,8,67,"(9b027db459ff771c246a266ac3ec40cfbb4a63ce, 2017-10-02 16:27:21 -0700, Derek Murray, 59, 8, 67, LINK)"
13448,1,2,0,2,"(a19d80dc3e8a343a65223c52066341a114de56f1, 2017-10-03 13:00:52 -0700, Derek Murray, 2, 0, 2, LINK)"
13476,2,4392,1661,6053,"(70fc9bf9b668adebe20ef6d1f7a0e182d7d02cc4, 2017-10-04 13:33:07 -0700, Asim Shankar, 145, 3, 148, LINK), (083bd5dde5e6845a6f5e3b83ea2e074d7b28d61f, 2017-10-04 13:33:07 -0700, Asim Shankar, 145, 3, 148, LINK)"
135,1,1,1,2,"(5b3bc418f86d1310bdbdb2bb4de32a58aa5cbf37, 2019-09-15 09:05:54 -0700, Uday Bondhugula, 1, 1, 2, LINK)"
13526,1,7,1,8,"(251a1e70dc04b10fb25e8013d1ad1f27d5eda30b, 2017-10-06 10:27:49 -0700, Derek Murray, 7, 1, 8, LINK)"
13536,1,217,147,364,"(18f89c81d288f191abd56501ec6f86fe29265bdd, 2017-10-17 08:48:29 -0700, Eugene Brevdo, 217, 147, 364, LINK)"
13558,1,1,1,2,"(3629fc4e98254c37e614ac3f77fa250b75c70f8d, 2017-12-29 03:38:27 +0200, codrut3, 1, 1, 2, LINK)"
13590,1,57,43,100,"(ba9422a8adba18fc97cc1923002b7db8ca63dcfe, 2018-06-12 11:12:53 -0700, Brennan Saeta, 57, 43, 100, LINK)"
136,4,392,443,835,"(c257bb76daee44131fef4a1e755808c5809ac9c4, 2019-09-21 10:08:32 -0700, Uday Bondhugula, 84, 128, 212, LINK), (5f9c12ffc3046c80c4141ac6afff7c45a46d4a90, 2019-09-21 10:08:32 -0700, Uday Bondhugula, 117, 128, 245, LINK), (2c858368c8c4b7e82c8d134786026a62a72d2676, 2017-12-18 18:22:03 -0500, Randy West, 9, 2, 11, LINK), (5e5453099ad4a720172b352e8436e961d9d4235e, 2017-08-09 18:07:58 +0100, Luke Iwanski, 182, 185, 367, LINK)"
1360,1,15,3,18,"(868aa1e04a7574e74b93fc693c8cfcd62a5037eb, 2016-03-02 16:50:33 -0800, Jianmin Chen, 15, 3, 18, LINK)"
1362,1,8,5,13,"(175fc9a99bde9c15ac05b6c73ec05d151162f0f9, 2016-03-03 18:23:08 -0800, Vijay Vasudevan, 8, 5, 13, LINK)"
1363,2,6,6,12,"(f16ee4b4c1cc2054bb6a640632806f11ff720e3f, 2016-03-03 10:20:31 -0800, Vijay Vasudevan, 1, 5, 6, LINK), (7395855e6397eb15c3ce7fd91619eef6d292ae6c, 2016-03-03 10:08:49 -0800, Vijay Vasudevan, 5, 1, 6, LINK)"
13643,1,59,0,59,"(7679a2ec746bec36191087feaf9ec8371180669c, 2017-10-13 15:22:19 -0700, Reed Wanderman-Milne, 59, 0, 59, LINK)"
13686,1,1,1,2,"(2d3d5c23a99b92968e9265cb7d872fe4dbf0e7ca, 2017-12-04 12:12:29 -0800, A. Unique TensorFlower, 1, 1, 2, LINK)"
13696,2,177,109,286,"(5b4c8dceb4f694d8eab93fc094a1af76533fa0a1, 2017-10-14 19:25:05 -0700, Michael Case, 63, 32, 95, LINK), (2f3812501d3ac10165acfcae228e52f6f3358f7e, 2017-10-13 13:59:23 -0700, Derek Murray, 2, 0, 2, LINK)"
137,2,680,28,708,"(1746c7b2a1d63916704a1266d685e5c6220726b4, 2019-09-16 15:39:16 -0700, Denis Khalikov, 261, 14, 275, LINK), (504212761d4bbcb6fdd11b3aeb9c43c56873bcba, 2019-09-16 15:39:16 -0700, Denis Khalikov, 419, 14, 433, LINK)"
13711,1,1,0,1,"(94159844e0bab1dc39fe694a3226e6d93b546848, 2017-12-18 17:09:37 -0800, Ted Ying, 1, 0, 1, LINK)"
13733,1,17,7,24,"(1b0ca6d1dfea0f328737a026135669783f840c1e, 2017-10-15 19:00:25 -0700, Yong Tang, 17, 7, 24, REGEX)"
13764,1,3,0,3,"(db10718b38b2884cb5ed46d33c135c079f649d16, 2017-11-03 20:09:38 -0700, Vish Ishaya Abrams, 3, 0, 3, LINK)"
1378,2,366,122,488,"(cbba0465d73b06e5be123415cdbd12e61b6b1343, 2016-03-14 13:23:59 -0800, Manjunath Kudlur, 38, 2, 40, LINK), (e774fa829a1d74ab2d410cefc62cbd47e20b0317, 2016-03-11 11:30:21 -0800, Manjunath Kudlur, 328, 120, 448, LINK)"
138,2,4,4,8,"(d5754ed1fdf8fda2f3428a54716c6e876d9bfaaf, 2019-09-17 00:38:28 -0700, Mehdi Amini, 2, 2, 4, LINK), (4cc85f3cc5bba7603dfa784400e6cd4e1d0045f0, 2019-09-17 00:38:28 -0700, Mehdi Amini, 2, 2, 4, LINK)"
13827,1,5,0,5,"(c43d777b56a17832f7de288d0fe966bf537ffeb7, 2017-11-09 01:49:31 -0500, Ouwen Huang, 5, 0, 5, LINK)"
13872,2,64,22,86,"(c9de8dfda76e0dbd6d1e6c0bb97fcb3a7cb192af, 2017-11-09 23:29:56 -0800, Asim Shankar, 32, 11, 43, LINK), (f6931a687874190bb6f5cbc927da2bdc97a18b38, 2017-11-09 23:29:56 -0800, Asim Shankar, 32, 11, 43, LINK)"
139,2,95,32,127,"(cebed8b575b93629e884a6cf8cd45666e289fc2e, 2019-09-18 11:25:33 -0700, Uday Bondhugula, 40, 16, 56, LINK), (331c663bd2735699267abcc850897aeaea8433eb, 2019-09-18 11:25:33 -0700, Uday Bondhugula, 55, 16, 71, LINK)"
1392,1,1,1,2,"(6083920703767eb2d4f75e17ada7a81efea14e5f, 2016-03-06 00:30:39 +0000, Cameron Chen, 1, 1, 2, LINK)"
13930,1,1,0,1,"(e6a242b4e9f85bee3ba59b57a0d93368163b8cb0, 2017-11-01 12:26:50 -0700, Yifei Feng, 1, 0, 1, LINK)"
13975,1,891,438,1329,"(d77b99809c2ef0b35723fd13e648b9e7652d32cf, 2017-11-01 12:27:53 -0700, Yong Tang, 1, 1, 2, REGEX)"
13980,1,27,19,46,"(32d82226827272b458f551078352c26005bb1b46, 2018-11-16 14:15:26 -0800, Zhenyu Tan, 27, 19, 46, LINK)"
1399,1,2,0,2,"(78c5ac2894b9a28924211d717e9153edcd5ab160, 2016-03-08 13:59:07 +0800, Wenjian Huang, 2, 0, 2, LINK)"
14004,2,2,0,2,"(c47abd8cf3f142f23fdd325c09b59b73fae5792a, 2017-11-04 12:45:52 -0700, Derek Murray, 1, 0, 1, LINK), (46a577febccf874b4b8bb8d42be0a3fb069e380d, 2017-10-27 16:25:49 -0700, Derek Murray, 1, 0, 1, LINK)"
1409,1,17,1,18,"(29f90aa2f98a95787acac39488a9b08aec7b7b30, 2016-03-07 09:25:01 -0800, Derek Murray, 17, 1, 18, LINK)"
14101,1,56,0,56,"(482ed8eb666d8bc1e5c3f47e5c1e61cc19e0fdb1, 2018-05-07 17:21:39 -0700, Skye Wanderman-Milne, 56, 0, 56, LINK)"
14143,1,46,11,57,"(af8a5507937108a41781ba117fa16edd3b1091b5, 2017-12-05 16:58:24 -0800, Derek Murray, 46, 11, 57, LINK)"
14164,3,299,77,376,"(7fdcbc508c6d94a785111bc9468b221335345ce7, 2017-11-07 16:50:18 -0800, Allen Lavoie, 148, 38, 186, LINK), (c8530b907a686b92c94d13f854dc504fa10901db, 2017-11-07 16:50:18 -0800, Allen Lavoie, 148, 38, 186, LINK), (3ded5b3c875634fb7ebfee986bba69ab4299214c, 2017-11-02 12:46:10 -0700, A. Unique TensorFlower, 3, 1, 4, LINK)"
1419,2,332,122,454,"(550df413158b32645ca5df4dcaabc67f1a48964d, 2017-05-03 14:34:24 +1200, Arno Leist, 4, 2, 6, LINK), (e774fa829a1d74ab2d410cefc62cbd47e20b0317, 2016-03-11 11:30:21 -0800, Manjunath Kudlur, 328, 120, 448, LINK)"
14191,1,33,19,52,"(2d0a506db7cd089fd9b7c59a6ed0b05ab65149f0, 2017-11-09 09:15:37 -0800, Yong Tang, 33, 19, 52, LINK)"
142,1,39,28,67,"(eaa846c8828d91c7f5e3ff0b9d93ac42256725b7, 2019-09-22 10:14:11 -0700, Uday Bondhugula, 39, 28, 67, LINK)"
14243,2,35522,14156,49678,"(4e69e02241067129379f73dd4fefe57f0a12bdc9, 2017-11-07 11:35:23 -0800, Martin Wicke, 35474, 14134, 49608, LINK), (e641c402f60aabaca029393355626a54a99809a4, 2017-11-06 15:33:03 -0800, Jingyue Wu, 48, 22, 70, LINK)"
1427,1,19,4,23,"(febfec7256026a38bda30c78c2768b32e64c9a2c, 2016-03-08 11:08:47 -0800, Geoffrey Irving, 19, 4, 23, LINK)"
14292,1,4,0,4,"(e52706d1696faa2ab926c2d91a0d85ec99dac314, 2018-04-25 14:25:30 -0700, Younghee Kwon, 4, 0, 4, LINK)"
143,1,5,5,10,"(0dfd4bea2e403ae1dffe338ce5ab80ec870cc5eb, 2019-09-21 11:38:41 -0700, brett koonce, 5, 5, 10, LINK)"
14380,1,1,5,6,"(14fa431da0b7fd69ccf7bf4a60172a5745c1773c, 2018-01-09 05:27:43 -0800, Ilya Biryukov, 1, 5, 6, LINK)"
144,2,4,4,8,"(6a98fc70a2241f3348b4494714422ea11d30d1c0, 2019-09-22 09:08:06 -0700, Denis Khalikov, 2, 2, 4, LINK), (41d9520c91263dcca734db4e455414a762c83987, 2019-09-22 09:08:06 -0700, Denis Khalikov, 2, 2, 4, LINK)"
14400,1,8,0,8,"(c25cd200ddb2728aec1302f655ff220b08d60007, 2017-11-09 19:23:07 +0900, MyungJoo Ham, 8, 0, 8, LINK)"
14454,2,16,8,24,"(9d8994ad0f8ba11911ab08d6d755abec40cfb84f, 2018-02-09 14:37:24 -0800, Gunhan Gulsoy, 8, 4, 12, LINK), (7e23850c2145ed565c668d6ba327dbcf064d4ed8, 2018-02-09 14:37:24 -0800, Gunhan Gulsoy, 8, 4, 12, LINK)"
145,1,68,66,134,"(f49b4d729562f979dd0bbee873598f7546074f50, 2019-09-25 11:57:13 -0700, Kazuaki Ishizaki, 68, 66, 134, LINK)"
14509,1,548,1,549,"(ba1c53a5f2bb106e16ec7503dbd4d0db9ecc9799, 2018-04-15 19:22:39 -0700, Yong Tang, 548, 1, 549, REGEX)"
14512,1,39,0,39,"(ee8b13791a921964cad1fc699e72ff1f738b704f, 2018-01-25 09:42:55 -0800, Yong Tang, 39, 0, 39, REGEX)"
1454,2,160,80,240,"(b59b69f42def11333ebc4eb84bcb72f1975b849b, 2016-03-20 16:47:20 -0800, Derek Murray, 23, 35, 58, LINK), (f6f77accbb9c978b5d3562922425bffd01690f79, 2016-03-11 10:20:54 -0800, Derek Murray, 137, 45, 182, LINK)"
14542,1,1,1,2,"(3e53570d3bf518ec2b6cfeed4b5fd57d11370289, 2017-11-18 02:34:19 +0800, CSJY, 1, 1, 2, LINK)"
14583,1,148,5,153,"(9c2e04411ec1dbcf7aaf604dbc218489928bb2cc, 2018-04-11 18:26:12 -0700, Yong Tang, 148, 5, 153, REGEX)"
146,2,1025,0,1025,"(182ba062ba2a999ab9cdaa13bd8bd38158b37676, 2019-09-26 23:49:51 -0700, Deven Desai, 499, 0, 499, LINK), (a879014c5637ae6ce45045c8f20a4887318eae97, 2019-09-26 23:49:51 -0700, Deven Desai, 526, 0, 526, LINK)"
14601,1,4,4,8,"(3a131265528582b99efa202a957f73cac6d5e23b, 2018-02-02 12:31:09 -0800, Yong Tang, 4, 4, 8, REGEX)"
14646,1,32,1,33,"(40d1b257636a0b510dba59aff0af54e42d602313, 2017-12-27 16:44:17 -0600, Yong Tang, 32, 1, 33, REGEX)"
14657,1,181,37,218,"(3a3b7530ebc9a6bfbfff8ed50bc7622a78b5b36b, 2017-12-28 16:38:35 -0800, Yuxin Wu, 181, 37, 218, LINK)"
14711,1,0,3,3,"(e2a2747dc85154516b08ee49885cfaf00ad2c3c5, 2017-12-05 23:28:03 -0800, Brennan Saeta, 0, 3, 3, LINK)"
14712,1,3,4,7,"(28340a4b12e286fe14bb7ac08aebe325c3e150b4, 2018-05-24 23:21:46 -0700, ted chang, 3, 4, 7, LINK)"
14739,1,18,0,18,"(ba87a8030aa30f24c354cf705e79734658bb0a8b, 2017-11-28 12:17:52 -0800, Asim Shankar, 18, 0, 18, LINK)"
1475,1,1,1,2,"(1cf9e29ec5f849eecb8d9700198585660a0814a1, 2016-03-13 11:17:14 -0800, Yaroslav Bulatov, 1, 1, 2, LINK)"
14776,1,22,1,23,"(355fb5e14b325a1d106c4046f478da4bda350205, 2018-03-05 13:47:30 -0800, Yifei Feng, 22, 1, 23, LINK)"
14805,2,4,4,8,"(cddf8d82dec9fff526f5c064add725b7f35f95fa, 2018-01-02 15:48:53 -0800, Amit Patankar, 2, 2, 4, LINK), (148f157bb89d33db123c9519e94c2781ca3488c9, 2017-11-27 17:41:24 -0800, A. Unique TensorFlower, 2, 2, 4, LINK)"
14806,1,1,1,2,"(2ab7e9dad284bd15d69779ee0bcf8a2c894c2a2a, 2017-11-28 21:22:20 -0800, Asim Shankar, 1, 1, 2, LINK)"
14871,1,7,0,7,"(397e0ec2cc1bcde3d73b4e884de01e3fb54e0207, 2017-11-24 17:36:01 -0800, Yong Tang, 7, 0, 7, REGEX)"
14891,1,112,25,137,"(78a4873cfa4562cf071492636f03e13fcb188bd8, 2017-11-29 11:18:38 -0800, Asim Shankar, 112, 25, 137, LINK)"
149,2,2793,1283,4076,"(e1c1ab64391ba88dee29f202c1fd86818f65573f, 2019-09-27 07:44:52 -0700, Kazuaki Ishizaki, 9, 9, 18, LINK), (f9d3e9d03c69bfac77a2fe1ad80f7c5aa517e0f0, 2015-12-06 14:53:28 -0800, Vijay Vasudevan, 2784, 1274, 4058, LINK)"
14916,1,4,0,4,"(7f642e5afd7ddaad5215958ce3f22523ccb08a9c, 2017-11-27 11:28:59 -0800, Yong Tang, 4, 0, 4, REGEX)"
14932,1,2,2,4,"(21a9efc4cddbce661073544db31a63639686310a, 2017-11-28 05:28:49 -0800, Yong Tang, 2, 2, 4, REGEX)"
14959,1,86,15,101,"(4cc4d5329122f0f97c3804e6f8d27ed4b5874028, 2017-11-30 11:14:36 -0800, Yong Tang, 86, 15, 101, REGEX)"
14985,1,155,108,263,"(5f0d3395d4c61000cf0cfb3dc681177147be938d, 2018-01-03 15:10:58 -0800, A. Unique TensorFlower, 155, 108, 263, LINK)"
15019,1,46,11,57,"(af8a5507937108a41781ba117fa16edd3b1091b5, 2017-12-05 16:58:24 -0800, Derek Murray, 46, 11, 57, LINK)"
15034,1,48,42,90,"(6afe900f543e0005ce69b3152330f1b7b16cb286, 2018-02-01 00:02:25 +0100, yegord, 48, 42, 90, LINK)"
15066,1,4,4,8,"(440d84579a86964fca80af5c0d8715824a8e660d, 2017-12-03 18:38:18 -0800, Yong Tang, 4, 4, 8, REGEX)"
15105,1,2,1,3,"(cdc36a3b1f7d227984bb5e415b555ed334737f82, 2017-12-07 11:42:26 -0800, Shanqing Cai, 2, 1, 3, LINK)"
15129,2,10,10,20,"(1751e3c8de7a3e2a69dd22a6062aec7d2c7709ef, 2020-03-19 16:56:51 +0100, Alexander Grund, 5, 5, 10, LINK), (5c90d76d41605c895370e0bc475429dc62d51bd2, 2020-03-19 16:56:51 +0100, Alexander Grund, 5, 5, 10, LINK)"
15137,1,11,6,17,"(d9a71ad0e5723e6e97741d60be106a6658cde4e4, 2017-12-05 17:36:42 -0800, Austin Anderson, 11, 6, 17, LINK)"
15152,1,30,0,30,"(60af864e46c207d136dd241c0705210ca5a4dbc7, 2017-12-06 11:34:32 -0800, Derek Murray, 30, 0, 30, LINK)"
15162,1,41,0,41,"(53f86b3cca9b8a515a3b45627587db2df475f05e, 2017-12-06 19:49:22 -0800, Derek Murray, 41, 0, 41, LINK)"
15188,1,1,1,2,"(bcae10f5f4f60c48f793b3a928eb9d3c7aa3eb2f, 2017-12-08 03:07:34 +0200, Adam Zahran, 1, 1, 2, LINK)"
15196,1,9,2,11,"(d4c33cfc944cbcac7a31811ba8f86448d8cc2e23, 2017-12-08 20:48:23 -0800, Anush Elangovan, 9, 2, 11, LINK)"
1522,1,8,8,16,"(d0a3000c9232f8b1d51ab050d0e46d897a33955c, 2016-03-16 17:34:18 +1100, ronrest, 8, 8, 16, LINK)"
15258,1,4,0,4,"(715b40154e27475328fb7e2f60c01ccd84b835db, 2017-12-17 11:12:11 +1000, Mike Knapp, 4, 0, 4, LINK)"
15262,1,9,1,10,"(ae0b6e6ed7179412434c4f484a13b1ecb42af610, 2017-12-14 10:09:01 -0800, Alexandre Passos, 9, 1, 10, LINK)"
15278,1,6,0,6,"(c8d0b125f62a3b8785494f53d013809f8e7c8c29, 2018-03-19 17:50:05 -0700, Martin Wicke, 6, 0, 6, LINK)"
15325,1,2,2,4,"(3425ae40aa54f16776bfcfe3be9c42bdb426cc20, 2017-12-13 11:27:29 -0800, Austin Anderson, 2, 2, 4, LINK)"
15326,1,18,4,22,"(c8afd2bf8816e03505214e3a562dfd941abe6112, 2018-01-03 01:46:38 -0800, A. Unique TensorFlower, 18, 4, 22, LINK)"
15338,1,45,38,83,"(baf490ba79acaacb458078370e4bad1c3fd17563, 2018-01-31 23:05:26 -0800, Sanjoy Das, 45, 38, 83, LINK)"
15345,1,1,1,2,"(df9189cc4671facfecd3e8249c9e8b01b11c0df5, 2017-12-13 12:41:38 -0800, Austin Anderson, 1, 1, 2, LINK)"
15374,1,5,0,5,"(17c0e1118b4f063d9bbfb3faf24befc69bc5f6c4, 2018-01-31 19:28:01 -0800, Yong Tang, 5, 0, 5, REGEX)"
15380,1,1,1,2,"(edc0be5f7ff5452c41cd0b968d751177ed8d8d13, 2018-01-24 06:40:44 +0900, MyungJoo Ham, 1, 1, 2, LINK)"
15429,1,129,0,129,"(fe2b9a2bc69b3599415c7fb258d4b5b9c33e8965, 2017-12-26 13:21:20 -0600, Yong Tang, 129, 0, 129, REGEX)"
15487,1,5,2,7,"(73cf824a24e46766a1674c7879d8c48bd0728083, 2018-01-26 00:31:56 -0500, Armando Fandango, 5, 2, 7, LINK)"
15521,1,4,2,6,"(fc252eb976c98c95a625ea6e6a0486334d3c5b6e, 2018-01-11 15:50:40 -0800, A. Unique TensorFlower, 4, 2, 6, LINK)"
15529,1,21,2,23,"(e2b93e6c45fc9e0745ec4b70a7ba0d1b86f42c94, 2018-01-24 17:22:27 -0800, Yong Tang, 21, 2, 23, REGEX)"
15564,1,178,11,189,"(f410ffc1699e864e84857089183db0d952ada7fe, 2018-07-26 15:44:39 +0200, Andreas Madsen, 178, 11, 189, LINK)"
15581,1,5,1,6,"(0f68a22758b4333ace28e857ef927354e6aeac09, 2018-01-10 15:16:01 -0800, Austin Anderson, 5, 1, 6, LINK)"
15588,1,32,31,63,"(ba30ba07b213687d0014a2149963780a26c59e64, 2018-05-17 18:17:39 +0100, Mark Ryan, 32, 31, 63, LINK)"
15589,1,4,0,4,"(a8041609f182db130953e123d7be4823ea13d05e, 2018-01-02 18:19:12 -0800, A. Unique TensorFlower, 4, 0, 4, LINK)"
156,2,833,9,842,"(f0400013337c708ebd9e33592879be83680d45f7, 2019-10-08 16:42:38 -0700, Denis Khalikov, 379, 6, 385, LINK), (e7e7393caea75db531c10bd04e983b976eca0f34, 2019-10-08 16:42:38 -0700, Denis Khalikov, 454, 3, 457, LINK)"
15611,1,14,2,16,"(2e2715baa84720f786b38d1f9cb6887399020d6f, 2017-12-28 13:57:18 -0800, Yifei Feng, 14, 2, 16, LINK)"
15619,1,26,3,29,"(4a7bbb54f2841b9c871ac0dc0099ca690d9e1af2, 2018-01-11 09:33:23 -0800, Yong Tang, 26, 3, 29, REGEX)"
15655,1,8,0,8,"(5baa43999877aeb7ec070374e579b291b1efe0cf, 2018-03-27 15:01:51 -0700, Yong Tang, 8, 0, 8, REGEX)"
1569,1,1,1,2,"(0c599d7f6cc246f08a5abed185f790d9ae2265b2, 2016-03-21 07:39:47 -0800, Manjunath Kudlur, 1, 1, 2, LINK)"
15737,1,37,1,38,"(35dface2e1aadbd4bd3b83e00618fda24c89f7d4, 2018-01-10 15:03:47 -0800, Rui Zhao, 37, 1, 38, LINK)"
1574,1,17,1,18,"(5f10181420cf991d05b668e054239768d892eea9, 2017-05-12 03:45:53 -0700, Mark Daoust, 17, 1, 18, LINK)"
15752,1,134,74,208,"(93f2998add91f9c7a53b1fcd13ab6d43e4397297, 2018-01-05 17:53:39 -0800, Allen Lavoie, 134, 74, 208, LINK)"
15758,1,0,17,17,"(aea9333d5bee349f1daff0c551a38b8bf73beffa, 2018-02-05 16:04:06 -0800, Yifei Feng, 0, 17, 17, LINK)"
15766,1,28,9,37,"(89cd0cd81ae829610fcbf4437597451ae5a59fe6, 2018-01-02 16:31:45 -0800, Igor Ganichev, 28, 9, 37, LINK)"
15767,1,1,1,2,"(f78fd433118830482dddbf6055751898a19265de, 2018-06-13 17:28:23 +0800, jiefangxuanyan, 1, 1, 2, LINK)"
15777,1,883,0,883,"(297ae45a079eedbf4fd32105d7c7ed95b072a0fa, 2018-01-23 09:51:19 -0800, Justine Tunney, 883, 0, 883, LINK)"
1582,1,112,124,236,"(3a5108d94fdd01b57a22f473ef68bac2732b5f22, 2016-03-26 21:22:53 -0800, Pete Warden, 112, 124, 236, LINK)"
15838,2,80,56,136,"(f7f7036d1cdc5716aff976fae0ea4d1b9a931b56, 2018-02-07 16:48:21 -0800, Yong Tang, 40, 28, 68, REGEX), (7c53bc7fbec18e8c6157832d89737bcc881ecfed, 2018-01-23 10:01:18 -0800, Yong Tang, 40, 28, 68, REGEX)"
15868,1,16,0,16,"(ec76f0e3ac324cbf992b3143972584de0b486be0, 2018-01-17 07:11:54 -0800, loki der quaeler, 16, 0, 16, LINK)"
1587,2,51,13,64,"(7aa85eefdfa43eeb0df8690d3fb9512690cf11c7, 2016-08-17 16:42:51 -0800, Justine Tunney, 8, 7, 15, LINK), (c5dfa2e4231dd5acd2ffb5f54d22e907edadf61e, 2016-08-11 11:17:40 -0800, Justine Tunney, 43, 6, 49, LINK)"
15882,1,27,1,28,"(1f26c65254268730b7409f517d1ed1b554d01e50, 2018-01-29 10:22:10 -0800, Shanqing Cai, 27, 1, 28, LINK)"
15891,1,46,9,55,"(f8f921c828fb2c97da7c7b80c01390ccec90ae40, 2018-02-05 13:03:53 -0800, Alexandre Passos, 46, 9, 55, LINK)"
15905,1,25,1,26,"(a77096897f1a8068ca8f57ffb6e3d9e28508cc27, 2018-01-07 06:57:15 -0800, Yong Tang, 25, 1, 26, REGEX)"
15933,1,9,5,14,"(3ecdd29cc2e7349f75b5b62bf55bb183bafa3875, 2018-02-20 11:12:53 -0800, Mark Daoust, 9, 5, 14, LINK)"
1595,1,1,1,2,"(4da6ca28e2a2685872a2d01cc2a0ceb699f01606, 2016-03-24 09:13:48 -0700, Derek Murray, 1, 1, 2, LINK)"
15951,1,2,0,2,"(3dc58f798660b98a0198b33edefb6f9f2aa7d827, 2018-01-10 13:06:33 -0800, Brian Patton, 2, 0, 2, LINK)"
15956,1,8,0,8,"(a5a95752e4bf697e0c3c73d26b3f3fad94e88f32, 2018-01-11 16:31:02 -0800, A. Unique TensorFlower, 8, 0, 8, LINK)"
15968,1,8,8,16,"(291497cd60de3b9bd629545898f29afa62d00874, 2018-02-02 03:32:36 +0900, Jin-Hwan CHO, 8, 8, 16, LINK)"
15994,1,16,0,16,"(b64da9c1c9f1a3a488526020648855127c03e742, 2018-02-20 11:13:55 -0800, Mark Daoust, 16, 0, 16, LINK)"
160,2,23,0,23,"(b75bf5c919ce43a313e207e8316c9968da5d5323, 2019-09-30 16:42:46 -0700, Denis Khalikov, 9, 0, 9, LINK), (a94839a4f94fe586c7ec24ad988c1e53f6e515ac, 2019-09-30 16:42:46 -0700, Denis Khalikov, 14, 0, 14, LINK)"
161,1,5,6,11,"(0644fe5ca188745fcc8dc2fbbf9b59f35b2fc4f4, 2019-09-29 15:52:52 -0700, Uday Bondhugula, 5, 6, 11, LINK)"
16100,1,1,1,2,"(4b6abfd95254910d01e886123cd24c29f722e8d7, 2018-01-22 21:27:14 +0100, Julian Wolff, 1, 1, 2, LINK)"
16106,1,36,19,55,"(f7b60fd704ced02f250b2dd0da436cf0ad9c9a8c, 2018-01-24 14:02:14 -0800, Alexandre Passos, 36, 19, 55, LINK)"
16149,1,37,4,41,"(5b97fda3612ccfc6f4c477e624e13a40f5e1ddad, 2018-01-23 10:02:08 -0800, Yong Tang, 37, 4, 41, REGEX)"
16152,1,1,1,2,"(1744b8c0519cec31764d205b813bd4fd6028cbf9, 2018-05-10 09:07:44 -0700, Yong Tang, 1, 1, 2, REGEX)"
16160,2,32,18,50,"(9b03bcd74d117a2a6ee270af438a3a28e7123111, 2018-01-19 10:36:05 -0800, Alexandre Passos, 19, 4, 23, LINK), (0830ceefcdbd2e5f57e676f72a4abaf8d351bc28, 2018-01-16 13:00:13 -0800, Alexandre Passos, 13, 14, 27, LINK)"
16163,1,613,17,630,"(be862d5b91e9b9044f4e028dcdae0b6ad283e8b4, 2018-02-20 14:11:35 -0800, Derek Murray, 613, 17, 630, LINK)"
16238,1,1,1,2,"(4383f3d002ddb0712a7aac3303cde6e599de65eb, 2018-01-25 21:30:45 -0800, Joel Shor, 1, 1, 2, LINK)"
16287,1,1,2,3,"(ec92f62e039055fa1fbc844ecde57017e8dd3311, 2018-01-31 19:00:33 -0800, Colin Raffel, 1, 2, 3, LINK)"
163,2,205,284,489,"(858ceb6d9be23f57ea4bfda0df8fb46003ad53bf, 2019-10-04 06:19:25 -0700, Deven Desai, 109, 145, 254, LINK), (55adaaed46efefb0665654a3e3fabb63d7245fd5, 2019-10-04 06:19:25 -0700, Deven Desai, 96, 139, 235, LINK)"
16314,1,1,1,2,"(75a849fafbe69a036eb7f5f79b91413641784560, 2018-01-23 14:50:26 -0500, Anthony Platanios, 1, 1, 2, LINK)"
16350,1,1,1,2,"(970efe54114f5064b35ad94e938c83977e771bc2, 2018-01-31 18:58:24 -0800, Mark Daoust, 1, 1, 2, REGEX)"
16451,1,6,2,8,"(4078ecd4e107cb61da8e4a3ce0293bbb8d9dbb62, 2018-01-26 10:11:50 -0800, Yong Tang, 6, 2, 8, REGEX)"
16479,1,11,11,22,"(f68404bdd10a4b6ef2a50439efac4614de024636, 2018-01-27 15:01:31 -0800, Yong Tang, 11, 11, 22, REGEX)"
16481,1,64,6,70,"(77e6a452188e83ae4498cc3ae23e20e60061b367, 2018-02-01 11:50:23 -0800, Derek Murray, 64, 6, 70, LINK)"
16499,1,27,0,27,"(b9af4308064dc560c4501523a5508de553000fb0, 2018-01-27 19:48:35 +0000, Yong Tang, 27, 0, 27, REGEX)"
16534,1,6,3,9,"(a7c225c89e4169492f0eef57c913463b976dd44e, 2018-02-07 16:24:34 +0000, Yong Tang, 6, 3, 9, REGEX)"
16553,1,21,8,29,"(9a9a90e9f170045e752805b390064c25fcc69573, 2018-04-12 13:01:05 -0700, Yong Tang, 21, 8, 29, REGEX)"
16585,1,2,2,4,"(b0d432dcc8c52177ebbaeb3a74d488f0af702f21, 2018-02-02 03:03:31 +0100, lissyx, 2, 2, 4, LINK)"
16590,1,32,4,36,"(5e6e691ba320fba71aec0a426ff6e5608ddcad1d, 2018-02-09 09:25:10 -0800, Allen Lavoie, 32, 4, 36, LINK)"
16606,3,92,54,146,"(259525189f41eaa1c08e0baa0dbac8d2cf3a15ef, 2018-03-22 00:11:33 +0200, Joel Shor, 46, 4, 50, LINK), (9ef37abc6f3da1d3d1699293f1afb52494125161, 2018-03-20 20:28:36 -0700, Gunhan Gulsoy, 5, 45, 50, LINK), (198bf16225b3224e9af6bafd9f1b4c1433557281, 2018-03-20 13:18:13 +0200, joel-shor, 41, 5, 46, LINK)"
16660,1,14,8,22,"(64acb73e0a970a8f177854a4286979acd40903d6, 2018-08-13 17:39:45 -0700, Asim Shankar, 14, 8, 22, LINK)"
167,2,44,42,86,"(bed413034e3f4f482397bf5db724e78aaa6a8841, 2019-10-04 08:57:28 -0700, Nicolas Vasilache, 22, 21, 43, LINK), (42f6fb01afa13eee5e556dbcd54a6d1238beb971, 2019-10-04 08:57:28 -0700, Nicolas Vasilache, 22, 21, 43, LINK)"
16703,1,6,4,10,"(d0904cbe01c88332acb4faa8bede21adb5fa1de7, 2018-02-05 12:40:51 -0800, Asim Shankar, 6, 4, 10, LINK)"
16735,1,2,2,4,"(bd0d204700df1a1a245b0593a11efd8ede139311, 2018-02-04 20:01:28 -0800, Yong Tang, 2, 2, 4, REGEX)"
168,2,24,1,25,"(6546946d5e8f14b7d43e96acde90a9dc73caba8f, 2019-10-10 16:25:11 -0700, A. Unique TensorFlower, 6, 0, 6, LINK), (51a9eb030c8dee92f1ff2669378bec19c4418788, 2019-10-10 16:25:11 -0700, Alex Zinenko, 18, 1, 19, LINK)"
16829,1,8,3,11,"(96564330fb0508a50a0515be11c9202c64b0f5b7, 2018-02-12 16:24:45 -0800, Igor Saprykin, 8, 3, 11, LINK)"
16913,1,6,6,12,"(80e100b4fb98f47e8e843762651530741c1d66bb, 2018-02-21 12:31:27 -0800, Asim Shankar, 6, 6, 12, LINK)"
16976,1,2,0,2,"(febed14f36eef0d3800d891b18717df36f786852, 2018-02-14 18:38:44 -0800, Guangda Lai, 2, 0, 2, LINK)"
17,2,976,271,1247,"(6cad9c885ebd8cfbba156cda93b8a9ebff9d92cb, 2019-04-15 16:32:00 -0700, Jacques Pienaar, 8, 5, 13, LINK), (d0d975f8c3330b5402263b2356b038bc8af919a2, 2016-10-05 18:02:01 +0100, Derek Murray, 968, 266, 1234, LINK)"
170,2,38,28,66,"(8d5d080baba1aeb6eebe98b629234e557d52b9b6, 2019-10-08 15:01:35 -0700, Uday Bondhugula, 2, 2, 4, LINK), (079dca0faf865c266d0242858dfae3953d92dc88, 2019-10-08 15:01:35 -0700, Uday Bondhugula, 36, 26, 62, LINK)"
17014,2,41,10,51,"(7d3e3fd76a002cd1dd78cb7f11bab760fb5abecb, 2018-04-26 16:24:51 -0700, Malcolm Reynolds, 33, 9, 42, LINK), (ff013946362e7d80c53b82b64a7f5b462808ff8f, 2018-04-24 11:26:26 -0700, Malcolm Reynolds, 8, 1, 9, LINK)"
17020,3,3,3,6,"(5b67901f225e3b6c65e7df0927f4047fc915cbb7, 2018-05-17 22:14:52 -0700, Amit Patankar, 1, 1, 2, LINK), (5f794e9f84686794f50c18f67e41edf179c61828, 2018-02-15 17:05:41 -0800, Reed Wanderman-Milne, 1, 1, 2, LINK), (f5c581f0f4649898ed00650fe98c7ef344e0f240, 2018-02-15 17:05:41 -0800, Reed Wanderman-Milne, 1, 1, 2, LINK)"
17022,1,1,0,1,"(312e34e318ee37a5e08af6afaef6a187ca33612e, 2019-02-13 11:32:51 +0100, Michael Käufl, 1, 0, 1, LINK)"
17090,2,190,44,234,"(260f5b8fe144cd369fde755739806449a2901252, 2018-02-26 15:42:52 -0800, Bixia Zheng, 95, 22, 117, LINK), (175730d3791618a496a5c66d7d6fef9c7768cf34, 2018-02-26 15:42:52 -0800, Bixia Zheng, 95, 22, 117, LINK)"
171,2,14,14,28,"(c1358ebff0bf54f36be52036571a50ff3df27f15, 2019-10-08 17:19:03 -0700, Deven Desai, 1, 1, 2, LINK), (5b64b9712e5e36369b9f51884ecd83485f1ebc06, 2019-10-08 17:19:03 -0700, Deven Desai, 13, 13, 26, LINK)"
17130,1,20,2,22,"(624a2e47329fefa1f17373954ac541b0e42a9fca, 2018-02-20 13:36:15 -0800, Asim Shankar, 20, 2, 22, LINK)"
17195,1,105,3,108,"(7d095f1bccc9d923fe64420e552268d220160488, 2018-02-22 07:21:39 -0800, KB Sriram, 105, 3, 108, LINK)"
172,2,26,26,52,"(d35ac634bd32759196a11e06838fd30a3b396d36, 2019-10-09 20:32:12 -0700, Kazuaki Ishizaki, 18, 18, 36, LINK), (20b96c22f86435629f0e91a87a0adbe81c501656, 2019-10-09 20:32:12 -0700, Kazuaki Ishizaki, 8, 8, 16, LINK)"
17210,1,110,51,161,"(37f6d224d69edd532197d615ace872933be5d74b, 2018-03-07 23:22:47 -0800, Yong Tang, 110, 51, 161, REGEX)"
1723,1,21,0,21,"(9f0f274859ab8ec7afaf4fec3c174d02515a8a1f, 2016-03-31 12:16:10 -0800, Manjunath Kudlur, 21, 0, 21, LINK)"
17284,1,199,35,234,"(f6bda409206dc642d7a6f02842e76b0be7234491, 2018-02-27 19:11:43 -0800, Derek Murray, 199, 35, 234, LINK)"
17360,1,23,39,62,"(5279cf29cea96b3ec50df506bb51d8ffabdabac9, 2018-03-05 14:45:28 -0800, A. Unique TensorFlower, 23, 39, 62, LINK)"
174,2,952,175,1127,"(57d9aab1c9be6b143a9a4ee462d594f2b259a8ef, 2019-10-30 14:41:26 -0700, Denis Khalikov, 564, 98, 662, LINK), (e7df2c27d8f2956b7ecd18824642bcc555f4da29, 2019-10-30 14:41:26 -0700, Denis Khalikov, 388, 77, 465, LINK)"
17423,2,5398,1931,7329,"(8b5212011c7b67b7f8c2ea1b641aa0a7151c82d0, 2018-04-06 14:24:42 -0700, Rasmus Munk Larsen, 5394, 1928, 7322, LINK), (ccad14e8281b244edffb09dc757b1997497dc27c, 2018-04-05 11:36:43 -0700, Suharsh Sivakumar, 4, 3, 7, LINK)"
17431,1,8,1,9,"(1128294d84c3810332aadea2bee27ef0d116bee4, 2018-03-14 18:14:42 -0700, Felix Abecassis, 8, 1, 9, LINK)"
1748,1,323,130,453,"(c34a0d7ea6b557588a7a0c9f9c4e60d59f593af7, 2016-05-12 15:26:42 -0800, Vijay Vasudevan, 323, 130, 453, LINK)"
17533,1,7,2,9,"(a925ef7bf111e203157128dc64dc046c60e6b8e0, 2018-03-13 13:44:59 -0700, Yong Tang, 7, 2, 9, REGEX)"
17554,1,3,2,5,"(9768b6ceaad2e4266be900ef14e6fab217e5a59e, 2018-03-15 13:52:43 -0400, Krish Ravindranath, 3, 2, 5, LINK)"
17566,1,8,1,9,"(1128294d84c3810332aadea2bee27ef0d116bee4, 2018-03-14 18:14:42 -0700, Felix Abecassis, 8, 1, 9, LINK)"
176,2,138,138,276,"(0b6dcfc3a3a9cc407de565c46795980911e7a586, 2019-10-09 15:06:54 -0700, Kazuaki Ishizaki, 69, 69, 138, LINK), (a19dd2d71d982d99f4c593f8f9b730cc8116290a, 2019-10-09 15:06:54 -0700, Kazuaki Ishizaki, 69, 69, 138, LINK)"
1760,1,1,1,2,"(657f1d987aca211e775acbccf719e67864a0be70, 2016-04-03 21:55:24 -0700, Dmytro Lituiev, 1, 1, 2, LINK)"
17633,1,1,1,2,"(4b0bb6d5d01c0b2aa89df11b45ff8d728d4c2059, 2018-03-12 22:48:49 -0500, Siby Jose Plathottam, 1, 1, 2, LINK)"
17641,1,12,0,12,"(049dfd5e070cfa84c82eea71c6c746a70cba4a3f, 2018-04-10 10:34:32 -0700, Yong Tang, 12, 0, 12, REGEX)"
17695,1,7,1,8,"(10be1f2377bf7aad1a4cfa306277c53e44493a57, 2018-03-13 22:13:38 -0700, Yong Tang, 7, 1, 8, REGEX)"
177,2,213,211,424,"(8071a512ff3c0386a9fcc4bfc144e8bb4537aad1, 2019-10-20 00:11:03 -0700, Kazuaki Ishizaki, 106, 105, 211, LINK), (b93d6cb82748678f5d9f5e466fdfe023f11872e9, 2019-10-20 00:11:03 -0700, Kazuaki Ishizaki, 107, 106, 213, LINK)"
17720,2,30,4,34,"(6655570f12dba22fe752796471635e109e682056, 2018-03-14 18:39:25 -0700, Derek Murray, 15, 2, 17, LINK), (041cf60da44f4c423c8f1ef603ce74b3377eb2d3, 2018-03-14 18:39:25 -0700, Derek Murray, 15, 2, 17, LINK)"
17784,1,20,0,20,"(aa57960b545ca25223568e366d99b0a4be7a03da, 2018-05-07 11:49:08 -0700, Alexandre Passos, 20, 0, 20, LINK)"
17792,1,48,1,49,"(a78c5033e005f76b83df4fd97d0074fcc990f603, 2018-03-19 13:38:23 -0700, Akshay Agrawal, 48, 1, 49, LINK)"
17801,1,15,5,20,"(3eb314bbcdc6e850eefc21c7ecbd91e28bd04a70, 2018-07-09 15:39:12 -0700, A. Unique TensorFlower, 15, 5, 20, LINK)"
17802,1,121,189,310,"(88334807a5beb8b61a967d21e534ed238e7916c0, 2018-03-19 20:21:45 -0700, Alexandre Passos, 121, 189, 310, LINK)"
17835,1,1,1,2,"(b1cb65ab5218c13eb9d0f55b7f169cd676e032f3, 2018-03-19 10:29:45 -0700, Fanjin Zeng, 1, 1, 2, LINK)"
17850,1,2,0,2,"(ae9ecfb68428e92089b7b3cc788fabc4dd3aa5e4, 2018-08-31 17:00:35 -0700, Gunhan Gulsoy, 2, 0, 2, LINK)"
1786,1,3,17,20,"(bef9bd4ea76a9f463c24ff64a8161787c1b29323, 2016-04-20 05:31:49 +0200, Dr. Kashif Rasul, 3, 17, 20, LINK)"
17882,1,6,1,7,"(c2013e7151b480d75b5d51417e06935faa6b53d5, 2018-04-09 07:11:32 -0700, Shanqing Cai, 6, 1, 7, LINK)"
17932,1,27,2,29,"(2219b88a3d5154b9158a1902b061cad6cae2d0a8, 2018-03-23 14:00:39 -0700, A. Unique TensorFlower, 27, 2, 29, LINK)"
1797,1,103,29,132,"(79d872ef79a9a9f57dfcd82e3068b1d8bd9fe392, 2016-06-15 12:34:02 -0800, Lukasz Kaiser, 103, 29, 132, LINK)"
1799,1,299,11,310,"(19bca790350ac7f0d1b1d29f5d56581b883e8c3a, 2016-04-11 23:03:47 -0700, Sam Abrahams, 299, 11, 310, LINK)"
18,1,73,9,82,"(a8edd7c822fcb9420eb2ea74a57eeeb6c17a425f, 2017-03-09 16:42:17 -0800, Alexander Heinecke, 73, 9, 82, LINK)"
18041,1,61,66,127,"(931a3054d2c13c3438fc58978b3463a0bd268aee, 2018-07-23 15:05:15 -0700, A. Unique TensorFlower, 61, 66, 127, LINK)"
18084,1,2,0,2,"(de9256f61a9d71a30b175e46116fc5d87063ceaa, 2018-05-04 08:19:03 -0500, William D. Irons, 2, 0, 2, LINK)"
18099,1,38,1,39,"(65669c0e12ba7aaa43a34db3798b8ac8fd97ba3e, 2018-03-30 10:41:48 -0700, Yong Tang, 38, 1, 39, REGEX)"
1816,1,15,6,21,"(91969ae68e30eef368698094a7f574a3bcfdf315, 2016-04-08 06:04:37 -0800, Derek Murray, 15, 6, 21, LINK)"
18180,1,32,21,53,"(46df4a1afd50f69966e63245e7758cc0d5656c4e, 2018-04-02 12:01:32 -0700, Asim Shankar, 32, 21, 53, LINK)"
18188,1,1,1,2,"(d5fc41a8ca69d37696c7c324e19a3a724b70192b, 2018-04-05 16:49:29 -0700, Yong Tang, 1, 1, 2, REGEX)"
18193,3,158,87,245,"(421d1c077053e6e38e4c9cee99641edcd4d9ca1e, 2018-04-11 18:20:19 -0700, Yifei Feng, 63, 43, 106, LINK), (58029d1d0b13dbe91db12cb130303bfaaf566d8a, 2018-04-11 18:20:19 -0700, Yifei Feng, 63, 43, 106, LINK), (e606e9133e96caf00d60e2ac0eb3f308fd0a4758, 2018-04-09 12:09:34 -0700, Yifei Feng, 32, 1, 33, LINK)"
18205,1,1,1,2,"(d5fc41a8ca69d37696c7c324e19a3a724b70192b, 2018-04-05 16:49:29 -0700, Yong Tang, 1, 1, 2, REGEX)"
18260,2,5509,1947,7456,"(8b5212011c7b67b7f8c2ea1b641aa0a7151c82d0, 2018-04-06 14:24:42 -0700, Rasmus Munk Larsen, 5394, 1928, 7322, LINK), (eef7771ddb9fc0de5e8c9aeabcaa186ff78ec105, 2018-04-06 09:26:26 -0700, Derek Murray, 115, 19, 134, LINK)"
18287,1,18,7,25,"(1b67ccbe8006eacffd268553abd01310e8b187d6, 2018-05-10 14:27:40 -0700, Francois Chollet, 18, 7, 25, LINK)"
183,2,581,0,581,"(e3aa3340db6db1280b146e5cb7c2ae016ce9a3f6, 2019-10-17 12:25:14 -0700, Denis Khalikov, 175, 0, 175, LINK), (fb78a04d3e28ed9e5163433dfa4e5f62b59a05cd, 2019-10-17 12:25:14 -0700, Denis Khalikov, 406, 0, 406, LINK)"
18300,1,93,13,106,"(9b18bd70b5739d646b21b7d45de0e5c96b8cc2a1, 2018-04-09 14:26:55 -0700, Skye Wanderman-Milne, 93, 13, 106, LINK)"
18363,1,1,0,1,"(26b2814096bf6d9dd0af91a37a0706e17450b9ec, 2018-04-26 20:21:18 +0000, Yong Tang, 1, 0, 1, REGEX)"
18384,1,155,0,155,"(075fbb59d767ae2868c369799d553a953ffb4dad, 2018-04-18 13:49:18 -0700, Yong Tang, 155, 0, 155, REGEX)"
184,2,31,2,33,"(e4d0086f779a3664ea4b8a13d5197c6e00f763cc, 2019-10-11 18:35:02 -0700, Eric Schweitz, 12, 1, 13, LINK), (4597c9cba2825f394a8ccbfb62c6c809cf1fe152, 2019-10-11 18:35:02 -0700, Eric Schweitz, 19, 1, 20, LINK)"
18460,1,14,2,16,"(f185600509b46414f05dec70df080c7a3d62c58c, 2018-04-17 16:44:21 -0700, Yong Tang, 14, 2, 16, REGEX)"
18474,1,13,6,19,"(0c2ca00e1082ab2692af68af183083e41393f6c4, 2018-04-13 11:38:43 -0700, Yong Tang, 13, 6, 19, REGEX)"
18529,1,5,2,7,"(0b92d7b655e51e107393f9bd4022175fdbc16f1d, 2018-04-15 18:42:45 +0000, Yong Tang, 5, 2, 7, REGEX)"
18586,1,24,0,24,"(c6aa3a0624ef7e1ff95cc07dde20c74105c4a584, 2018-04-28 12:04:45 -0700, Yong Tang, 24, 0, 24, REGEX)"
1859,1,1,1,2,"(c07d1f3defaabde52070c9aca0dc51f2c7d55104, 2016-04-11 15:49:21 -0700, lahwran, 1, 1, 2, LINK)"
18598,1,4,0,4,"(6fe887e5e495cff6eba35ea9c1e08c6044aa90ed, 2018-04-17 16:10:27 +0000, Yong Tang, 4, 0, 4, REGEX)"
18642,2,52,2,54,"(a722cdf7a62a3ee82ca6ee1b3d33f3d03dba49ee, 2018-04-18 15:04:21 -0700, Francois Chollet, 26, 1, 27, LINK), (5c1e253344c0a9d90b27eeef6dd5fcf76b74bba5, 2018-04-18 15:04:21 -0700, Francois Chollet, 26, 1, 27, LINK)"
18648,1,57,2,59,"(0775f684c51b6b2f24d58c116cc2073d53659e3c, 2018-05-14 14:58:17 -0700, Alexandre Passos, 57, 2, 59, LINK)"
18652,1,9,5,14,"(aef000ed3c2863a5cc7ccb5bf1fb46116e7f4f02, 2018-07-24 11:10:46 -0700, Gunhan Gulsoy, 9, 5, 14, LINK)"
18658,1,47,12,59,"(8e86dcd1c59bb3f1dc978fcb5398dd3f2f51d9ad, 2018-06-17 18:10:58 -0400, Dan J, 47, 12, 59, LINK)"
18692,1,1,3,4,"(1a2eb108a3e513a4f4609b9d421277bc222e5eb0, 2018-04-19 15:03:05 +0000, Yong Tang, 1, 3, 4, REGEX)"
187,1,1032,1172,2204,"(e7cc0256bb5679686f3b752eb62e338154868aef, 2019-10-15 11:40:12 -0700, Sana Damani, 1032, 1172, 2204, LINK)"
18712,1,2,1,3,"(2a956c9b8f9950405b481ccc0e05636873ecc9ae, 2018-04-20 02:40:37 +0000, Yong Tang, 2, 1, 3, REGEX)"
18769,1,11,1,12,"(f2be10a6d278f9a4546fa9cded94074959e67302, 2019-05-07 17:49:48 -0700, Allen Lavoie, 11, 1, 12, LINK)"
18827,1,844,199,1043,"(43b6f6c0ebb032c17ed5382150ba989761e036b7, 2018-10-15 13:57:27 -0700, Jiri Simsa, 844, 199, 1043, LINK)"
18861,1,73,63,136,"(5de9b8463ee214a02aa71815c837b49c6ea2f93c, 2018-05-14 14:56:36 -0700, Asim Shankar, 73, 63, 136, LINK)"
1888,3,268,165,433,"(5a96e4e672109b29951d2f65fcf46b00d85e025a, 2016-09-02 19:32:03 -0800, Vijay Vasudevan, 18, 5, 23, LINK), (3e8c4fd7403659ec32b9fec90a78831043aa0786, 2016-08-30 19:04:28 -0800, Vijay Vasudevan, 177, 148, 325, LINK), (fa042c7063b922f8048630de7084b2a28e59827c, 2016-08-25 14:46:35 -0800, Vijay Vasudevan, 73, 12, 85, LINK)"
18887,1,21,3,24,"(69c74f1e74eb5da964638533d594475ee9e54a66, 2018-05-14 11:35:40 -0700, Yong Tang, 21, 3, 24, REGEX)"
189,4,352,89,441,"(26416a3b897cbef811969723cff6d8a83e028630, 2019-10-18 14:09:42 -0700, Nicolas Vasilache, 19, 16, 35, LINK), (ee6bd3abbad311e062ae38e7e3aef6ba41fba252, 2019-10-18 14:09:42 -0700, Nicolas Vasilache, 52, 41, 93, LINK), (63c44f6d9f2fc0f2deb40a71d90ad13e97b1d0d9, 2019-10-18 13:48:26 -0700, Nicolas Vasilache, 150, 17, 167, LINK), (ce689839765bf1d5730384c3878b707aa8133202, 2019-10-18 13:48:26 -0700, Nicolas Vasilache, 131, 15, 146, LINK)"
18919,1,91,42,133,"(1aa40a1ce7869b6557049bcc623dad452a69ef6c, 2018-05-11 10:51:24 -0700, Suharsh Sivakumar, 91, 42, 133, LINK)"
18925,1,50,53,103,"(c1ea01275b93e2d1f96ad1bdacc6aacf6fe231d7, 2018-05-17 15:28:09 -0700, Akshay Modi, 50, 53, 103, LINK)"
18960,1,1,1,2,"(f4162b7eafcb9c27292a9544b1a29f2fc7f54be6, 2018-05-17 10:02:06 -0700, Alexandre Passos, 1, 1, 2, LINK)"
19,1,0,4,4,"(d1229d9d4fe04f68fb13de97442c3597be3d2263, 2017-03-09 16:45:31 -0800, Alexander Heinecke, 0, 4, 4, LINK)"
19014,1,14,12,26,"(01a70dc43d32eb5add5f1cb5de2d6c98ed88dd83, 2018-05-04 11:17:17 -0700, Suharsh Sivakumar, 14, 12, 26, LINK)"
19022,1,9,15,24,"(d8bda536c5080e761bcb24ab6984c26da875f52c, 2018-05-07 23:17:02 +0200, Yong Tang, 9, 15, 24, REGEX)"
19062,1,4,0,4,"(729caa48a34683cd38bb14c48bb63e8cddc88d60, 2018-08-10 10:56:50 -0700, Mustafa Ispir, 4, 0, 4, LINK)"
19069,2,463,43,506,"(fa5c52e31f30e8cb88a5452e3b4aefc786fb8852, 2018-05-23 16:10:30 -0700, Priya Gupta, 430, 40, 470, LINK), (f17620153c47370f30a84b99eaba82bef8cd7d8e, 2018-05-15 13:20:01 -0700, Priya Gupta, 33, 3, 36, LINK)"
19077,1,1090,0,1090,"(82cea6c11f8e3368f6b22a8833e958ccf38493b9, 2018-05-14 18:30:49 -0700, Rachel Lim, 1090, 0, 1090, LINK)"
19083,1,73,63,136,"(5de9b8463ee214a02aa71815c837b49c6ea2f93c, 2018-05-14 14:56:36 -0700, Asim Shankar, 73, 63, 136, LINK)"
191,2,1136,1645,2781,"(dee72675d9137041f8090a2adc86f3db2dd45f67, 2019-10-16 12:08:55 -0700, Sana Damani, 1129, 1645, 2774, LINK), (2a8278ebe2f156d7d19f896e41c9c32c0333806b, 2019-10-16 12:08:55 -0700, Sana Damani, 7, 0, 7, LINK)"
1914,1,323,130,453,"(c34a0d7ea6b557588a7a0c9f9c4e60d59f593af7, 2016-05-12 15:26:42 -0800, Vijay Vasudevan, 323, 130, 453, LINK)"
19175,1,1,3,4,"(c317afd07eb11abe416080cdced9ec00198dbbb0, 2018-05-09 08:55:19 -0700, Yong Tang, 1, 3, 4, REGEX)"
1919,1,2,0,2,"(b874e2ccfda77c964bfb0a41a8dc339e320b185c, 2016-04-13 18:27:27 -0800, Yaroslav Bulatov, 2, 0, 2, LINK)"
192,2,2,2,4,"(f87ff5b0f58c93b5c6108b2abc1642764bccc236, 2019-10-17 09:58:58 -0700, Mehdi Amini, 1, 1, 2, LINK), (47101cda0aeb8f573b5b61b97bf333ec8433d552, 2019-10-17 09:58:58 -0700, Mehdi Amini, 1, 1, 2, LINK)"
19203,1,5,1,6,"(f506183dd148d97e3378eb994b2ac9c948ef0ada, 2018-05-17 16:06:21 -0700, Craig Citro, 5, 1, 6, LINK)"
19208,2,89,3,92,"(620bcf01283abc434b1971106863269168cb8a5a, 2018-05-17 14:32:47 -0700, Allen Lavoie, 29, 0, 29, LINK), (56b46370ba08c76200711f4a8d25194af1235fd5, 2018-05-10 18:28:24 -0700, Allen Lavoie, 60, 3, 63, LINK)"
19219,1,34,0,34,"(2869a86c56b163318cfb47126f3c7f56db0b642c, 2018-05-14 22:04:50 -0700, Mustafa Ispir, 34, 0, 34, LINK)"
19223,1,1,1,2,"(39ba73897cd3a5e14d3e78624f0b5942479f533a, 2018-05-14 11:09:30 -0700, Yong Tang, 1, 1, 2, REGEX)"
1924,3,9562,2545,12107,"(e55574f28257bdacd744dcdba86c839e661b1b2a, 2017-09-15 19:38:25 -0700, drpngx, 6502, 1910, 8412, LINK), (3438981ca7b659e57fb1e15152a1f9fd99b5d6bc, 2017-09-12 11:56:28 -0700, David G. Andersen, 27, 0, 27, LINK), (5405394ecbc92baf9c45e612185ab42b1dcd0a30, 2016-05-12 19:25:40 -0800, Manjunath Kudlur, 27, 2, 29, LINK)"
19250,1,454,29,483,"(7b78417a00e6805557d530c1f1fcc8b2a44d6e2e, 2018-05-23 10:43:28 -0700, Allen Lavoie, 454, 29, 483, LINK)"
19260,2,190,76,266,"(9bcbfc1636d98e99d821c1a5292a5fe70663ccdb, 2018-06-27 17:30:52 -0700, RJ Ryan, 95, 38, 133, LINK), (07f61ee48784c8765006ea6ce6abd467cfe47a9e, 2018-06-27 17:30:52 -0700, RJ Ryan, 95, 38, 133, LINK)"
19274,1,4,1,5,"(cea293f00cd8710e439937b048745c14ac52b3ff, 2018-05-15 22:40:27 +0000, Yong Tang, 4, 1, 5, REGEX)"
19289,1,13,6,19,"(34d58ca2de7a67be382fb1c7b7ca4868f6695ee3, 2018-05-15 13:57:39 -0700, Allen Lavoie, 13, 6, 19, LINK)"
19292,1,29,1,30,"(be41e845b581fd7d0c3d356173329dc0fc8e1caa, 2018-06-20 16:50:43 -0700, Pavithra Vijay, 29, 1, 30, LINK)"
19299,1,11,8,19,"(4d91734ca1e400a7fef012e75d2590377583261c, 2018-05-15 13:30:13 -0700, Alexandre Passos, 11, 8, 19, LINK)"
19318,1,19,2,21,"(440e3850bd197332876f391e79cf06c723d69885, 2018-06-04 09:44:20 -0700, Yong Tang, 19, 2, 21, REGEX)"
19323,1,3,0,3,"(025192b30c7abf125aba1691d5c7e9e048c644ed, 2018-05-17 07:10:01 -0700, Derek Murray, 3, 0, 3, LINK)"
19337,1,16,27,43,"(ce11f0b65d3e4d0bf2b03f5956cb34cb3d96ad89, 2018-05-16 15:47:58 -0700, Geoffrey Irving, 16, 27, 43, LINK)"
19360,1,54,22,76,"(88ba64b668044c5cb776fa27c8429e2c0e64e665, 2018-07-24 21:07:41 -0700, Geoffrey Irving, 54, 22, 76, LINK)"
19496,1,14,7,21,"(2c75dbfd2d37a3c06d34cc4b12682a63a75503f7, 2018-05-29 18:10:27 -0700, Jiri Simsa, 14, 7, 21, LINK)"
19498,1,1,1,2,"(52d5a9457cbefd5afd89b5a7867fcea2944676f3, 2018-05-23 20:54:45 +0000, Yong Tang, 1, 1, 2, REGEX)"
19499,1,134,3,137,"(70674b950ab48f913ed1c99e48c4162287595d46, 2018-05-29 10:34:20 -0700, Allen Lavoie, 134, 3, 137, LINK)"
19551,1,60,16,76,"(d0b51d7d9d50dd73c46ba2f2daaa9d26cc0666d0, 2018-08-17 11:57:27 -0700, Anjali Sridhar, 60, 16, 76, LINK)"
19588,2,180,12,192,"(6d1beebffd216c5cb2eda8a8ba3a59d605ed8fe1, 2018-06-26 15:30:08 -0700, Rohan Jain, 90, 6, 96, LINK), (a9f857758e43e9151459b290b386ad3e03633bb0, 2018-06-26 15:30:08 -0700, Rohan Jain, 90, 6, 96, LINK)"
19594,1,41,40,81,"(a951093889128db4acf4ed80a286ebb2de813241, 2018-05-31 07:56:56 -0700, Skye Wanderman-Milne, 41, 40, 81, LINK)"
19607,2,129,30,159,"(03e10b0b485fca75ebd476201fa49c7f3b86bfa3, 2018-08-09 17:01:57 -0700, A. Unique TensorFlower, 79, 11, 90, LINK), (4963bcf071dea91bb1fca38d1c281d9d76a7dfa3, 2018-08-01 13:34:55 -0700, A. Unique TensorFlower, 50, 19, 69, LINK)"
1961,2,48,2,50,"(fb301a9848cb94c405c38c7ef995f9ae7a1504f4, 2016-04-15 06:38:25 -0800, Derek Murray, 24, 1, 25, LINK), (ddb59d7a983f44f3b926542ca535cb66f0582693, 2016-04-15 06:38:25 -0800, Derek Murray, 24, 1, 25, LINK)"
19642,1,38,1,39,"(030088358322c883086817a732f1cbe9dd84bb49, 2019-02-04 17:19:22 -0800, Jared Duke, 38, 1, 39, LINK)"
19657,2,30,1,31,"(15ee5980a5873fd4c975d835e813b9377cb79f7d, 2018-06-12 07:42:40 -0700, Asim Shankar, 14, 0, 14, LINK), (2bf2799ee80791107d4fe587ff9b6c7cf6c8b418, 2018-06-07 16:49:27 -0700, Asim Shankar, 16, 1, 17, LINK)"
19671,1,81,18,99,"(abdbe6ee3d81d22d70e0181cea2a3bb261f7c09f, 2019-01-04 16:31:04 -0800, Gaurav Jain, 81, 18, 99, LINK)"
19735,1,1,0,1,"(f4f92acbcd0994299882260fe4f4896385e6bff9, 2018-06-11 14:59:42 -0700, Suharsh Sivakumar, 1, 0, 1, LINK)"
198,2,140,6,146,"(55b19ed22ee236f740390c48b5eb5da025077cfd, 2019-10-24 18:40:38 -0700, Denis Khalikov, 41, 3, 44, LINK), (be96aca40be973ef672a3239ff5a9083ed11b48f, 2019-10-24 18:40:38 -0700, Denis Khalikov, 99, 3, 102, LINK)"
19858,1,11,1,12,"(cb2da309d3ae973158d15c337c011131eab9eb4f, 2018-06-14 00:31:07 +0200, Vincent, 11, 1, 12, LINK)"
19910,1,31,0,31,"(b1aa509588abdf97bd45f51fbce85169fba51b3b, 2018-06-17 20:32:54 +0000, Yong Tang, 31, 0, 31, REGEX)"
19924,1,11,0,11,"(4b5f4a540fad9142288012591799c39fd590242b, 2018-06-13 17:07:13 +0200, Emanuele Ballarin, 11, 0, 11, LINK)"
19935,1,1,1,2,"(422158776bcd9ffbde485610fdd3af498a2d5669, 2018-09-17 09:43:24 -0700, Gunhan Gulsoy, 1, 1, 2, LINK)"
19945,2,31,9,40,"(7b76deb752afb8c80789a7b7d93a333ce2056ca4, 2019-02-08 16:45:21 -0500, Jongwook Choi, 1, 0, 1, LINK), (4e652775bb5bd315d709394316112f3ac06b4ab1, 2018-07-16 14:47:45 -0700, Alexandre Passos, 30, 9, 39, LINK)"
2,24,43254,8628,51882,"(e8e849c202b2cb72a067a954e00c9659a4bde21f, 2021-01-26 09:03:57 -0800, Fergus Henderson, 124, 0, 124, LINK), (746817af146e65e1e7ebca3a893cb217a4bec938, 2021-01-05 13:37:31 -0800, Advait Jain, 13, 8, 21, LINK), (627a032dc2c9f5e18b4264ed5717a97b7f981df0, 2020-12-11 13:15:36 -0800, Fergus Henderson, 56, 51, 107, LINK), (2d529fbf9de3678ec85bdaebf6ff321b49288522, 2020-05-07 16:31:22 -0400, Andrew Cavanaugh, 123, 0, 123, LINK), (9dadbb283d04d8df54fad48e9faee7a51b769098, 2020-03-26 16:26:08 -0700, Jingyue Wu, 167, 23, 190, LINK), (2396abddcf6a51d5b1a59530150df03816e99ade, 2020-01-31 17:22:32 +0900, Frédéric Rechtenstein, 33, 5, 38, LINK), (55bb36ff211d5c9807255dff7b0899068c5df082, 2019-09-09 14:52:58 -0700, Anudhyan Boral, 34, 9, 43, LINK), (522ddb018c86d57785ff0d39c8565bed69183e0f, 2019-08-01 17:11:49 +0100, Anthony Barbier, 12, 13, 25, LINK), (8ca02e0fd561ea570b4c596259579cf89fe370bb, 2019-07-31 11:10:17 -0700, Denis Khalikov, 178, 1, 179, LINK), (4ca0e2c71a954ac97ac9aaffdf0e9e8b6469e50a, 2019-07-31 11:10:17 -0700, Denis Khalikov, 263, 1, 264, LINK), (6982da07f34a6cf8dd94ae55903cf895782e6449, 2019-06-17 18:16:57 -0700, Frank Chen, 1, 1, 2, LINK), (2303b8eeeb9637f1f7b721e80f23209ff70643c0, 2018-10-30 17:43:06 -0700, Uday Bondhugula, 299, 23, 322, LINK), (fb910a6dfbbcc53c48fc5d953c92ad55613d7653, 2018-10-25 22:04:35 -0700, Chris Lattner, 48, 12, 60, LINK), (b32297eaa1976ed74e52c3eea698dcf1c8ff4392, 2019-02-21 14:51:06 -0800, A. Unique TensorFlower, 11, 5, 16, LINK), (643488bac46bb70db5f98819d596036db7cac309, 2019-01-12 22:20:49 -0800, 1e100, 419, 5, 424, LINK), (712bbc5d7babd523951445f361f0e339061cd259, 2018-04-20 11:24:53 -0700, Akshay Modi, 389, 135, 524, LINK), (7946a0b1d9998cc54cb952d538668883d3fd8181, 2018-02-03 22:02:53 -0800, Jonathan Hseu, 0, 4, 4, LINK), (0662ba4a230055ca379fbde5526e7435a762f0b1, 2018-02-03 22:02:53 -0800, Jonathan Hseu, 0, 4, 4, LINK), (c8535f36d127a2b2c80241d49546326db5d9a1fd, 2017-09-18 11:14:20 -0700, Joel Hestness, 2869, 1, 2870, LINK), (cf7c008ab150ac8e5edb3ed053d38b2919699796, 2017-06-28 11:07:44 -0700, Yifei Feng, 35256, 8213, 43469, LINK), (3faa4d2d9672fb6f8ba8f80a0df45dabeb5a3382, 2017-06-26 10:16:32 -0700, A. Unique TensorFlower, 2, 0, 2, LINK), (dd40e9840da886c2a8b296146c709907c0dd3d85, 2017-04-19 16:11:23 -0700, Jun Shi, 2775, 8, 2783, LINK), (052e207e4f1076ac6b7464c01a67ecf4f986766d, 2017-03-30 11:35:17 -0800, Eugene Brevdo, 29, 71, 100, LINK), (5e2cef7155fea04469578e48123ec6925e998c2f, 2017-03-27 08:47:18 -0800, Alexandre Passos, 153, 35, 188, LINK)"
20013,1,12,1,13,"(7462a25a2aed29f63ed3a047aec4ff363d8b6aad, 2018-07-02 09:44:57 -0500, William D. Irons, 12, 1, 13, LINK)"
20014,1,65,35,100,"(6d1603622b1c3b25de0a8d342714fed271308a47, 2018-06-16 12:23:23 -0700, Brennan Saeta, 65, 35, 100, LINK)"
20021,1,94,42,136,"(4d8a66c5b29428b709f4f54b566a44902ea8173e, 2018-06-15 16:26:35 -0700, Asim Shankar, 94, 42, 136, LINK)"
20160,1,299,32,331,"(901d82d736988e8dbc47385cfde1d97cdc69ba26, 2018-06-28 14:23:38 -0700, Shanqing Cai, 299, 32, 331, LINK)"
20170,1,19,16,35,"(d932155363d6ded97dda38ce799168d27566978b, 2018-06-21 22:05:47 -0700, Yong Tang, 19, 16, 35, REGEX)"
20199,1,67,55,122,"(bf64fc285e88d36bb82f80757c4a1afd722347e0, 2018-08-14 15:35:12 +0000, Yong Tang, 67, 55, 122, REGEX)"
20200,1,1,1,2,"(5dae09703ef63956071c4e753b5d29cb03b668e9, 2018-06-21 20:34:29 +0000, Yong Tang, 1, 1, 2, REGEX)"
2021,1,119,80,199,"(14ac2235699509f512b44b71160239c153ab413d, 2016-05-26 15:20:44 -0700, David Z. Chen, 119, 80, 199, LINK)"
20231,1,4,2,6,"(7df94b6013941b18704601198e594350c219a3b6, 2018-06-27 20:34:42 -0700, Yong Tang, 4, 2, 6, REGEX)"
20233,1,1,1,2,"(19bceac39caa4c629f4c1c29765f42c61a0bad76, 2018-06-23 19:26:41 +0000, Yong Tang, 1, 1, 2, REGEX)"
20243,1,1,1,2,"(d2e3711f2931dd26c8716f5a229e2cb14781afde, 2018-06-23 17:03:38 +0000, Yong Tang, 1, 1, 2, REGEX)"
20258,1,2,2,4,"(1c05652f9503dc42f3be52be130a8668301efb1d, 2018-06-24 17:12:42 +0000, Yong Tang, 2, 2, 4, REGEX)"
20265,1,77,1,78,"(a6cca570d5155f83123f2f34c8e2493d8b80d045, 2018-06-29 13:07:21 -0700, Derek Murray, 77, 1, 78, LINK)"
20270,2,2,2,4,"(caa3cf804b212fe6908e389b423f10e8c17d7537, 2018-06-26 15:05:30 -0700, Asim Shankar, 1, 1, 2, LINK), (4529bcf62a275a50a59020e637f13a93ba4f7e6c, 2018-06-26 15:05:30 -0700, Asim Shankar, 1, 1, 2, LINK)"
20276,1,1,1,2,"(a46ade7ed085493a81c9cde7d3d2480f4c5e74ac, 2018-06-25 15:43:10 +0000, Yong Tang, 1, 1, 2, REGEX)"
2034,1,4,0,4,"(be092f47e0072645116a64496f7fa654ed708624, 2016-04-30 14:34:54 -0500, Stephen Roller, 4, 0, 4, LINK)"
20347,1,69,1,70,"(92f13f24d95360806c31983877f556834d155cbb, 2018-07-02 15:06:53 -0700, Asim Shankar, 69, 1, 70, LINK)"
204,2,14,2,16,"(c942bcec6c28964700bf0223ee660efbf2583eb2, 2019-11-07 10:26:51 -0800, Uday Bondhugula, 4, 1, 5, LINK), (13ed2e4500da132e6174832e5d8f26b00e356c93, 2019-11-07 10:26:51 -0800, Uday Bondhugula, 10, 1, 11, LINK)"
2040,1,50,17,67,"(32fa42a98eb751ee05827535ac47535312b7fa76, 2016-05-24 13:05:45 -0400, Kristina, 50, 17, 67, LINK)"
20428,1,1,1,2,"(f7d27bc67e5d89e5f4bb6d6a0a198c28fa8af46f, 2018-08-30 17:17:23 +0900, Sangjung Woo, 1, 1, 2, LINK)"
20451,2,129,30,159,"(03e10b0b485fca75ebd476201fa49c7f3b86bfa3, 2018-08-09 17:01:57 -0700, A. Unique TensorFlower, 79, 11, 90, LINK), (4963bcf071dea91bb1fca38d1c281d9d76a7dfa3, 2018-08-01 13:34:55 -0700, A. Unique TensorFlower, 50, 19, 69, LINK)"
20453,1,3,0,3,"(9281603eeb149942952e3d8b35c2a121bbaa045e, 2018-07-01 15:08:07 +0200, Paul Woitaschek, 3, 0, 3, LINK)"
2051,1,3,0,3,"(52500e395d526ac932a6de46ecec1ad45082f43c, 2016-04-21 10:06:38 -0800, Yaroslav Bulatov, 3, 0, 3, LINK)"
20516,1,6,3,9,"(f46627f9ed9cd41b5a1ad9cebbdd4c240846c4e0, 2018-07-03 11:29:31 -0700, Allen Lavoie, 6, 3, 9, LINK)"
20551,1,1,0,1,"(911b141ac83ad5cd8ca1c4541b934c185c9c46ec, 2018-07-05 03:13:46 +0000, Yong Tang, 1, 0, 1, REGEX)"
20626,1,107,58,165,"(6e26dde0d193a8d21909b7b6c32953fae375093e, 2018-08-22 15:56:21 -0700, Shivani Agrawal, 107, 58, 165, LINK)"
2063,2,34,9,43,"(c38157c7cccf4c06e4d0d3f1f72ed490798dcfe5, 2016-04-27 15:57:37 -0700, Illia Polosukhin, 31, 6, 37, LINK), (1e53ba6142fbc750c6d36cf320ad69a91bc25eb8, 2016-04-25 16:53:43 -0700, Illia Polosukhin, 3, 3, 6, LINK)"
20630,1,2,2,4,"(cdf896dcb7cd2b37016893a49861afc073973021, 2018-07-10 16:47:06 -0700, Asim Shankar, 2, 2, 4, LINK)"
2066,1,13,12,25,"(41a79f6bcc46cf7030e7125470f769707d687ff5, 2016-04-27 11:38:35 -0700, zhengxq, 13, 12, 25, REGEX)"
20701,1,29,5,34,"(fd04b76337f9f65c5a2ce35a4f7336a25511435b, 2018-07-16 10:15:40 -0700, Akshay Modi, 29, 5, 34, LINK)"
20722,1,1,1,2,"(954c5a95783740cf4b65f6f806dd1fb2e07d3f62, 2018-07-12 03:29:08 +0000, Yong Tang, 1, 1, 2, REGEX)"
20751,1,9,1,10,"(2bd9b11055c2ca5120a1ab94c3d6d94ee63c6215, 2018-07-13 06:00:25 +0000, Yong Tang, 9, 1, 10, REGEX)"
2076,1,237,43,280,"(6e492242317c6940f0d7fd8948b14c9d38245cbc, 2017-01-20 18:13:43 -0800, Viacheslav Kovalevskyi, 237, 43, 280, LINK)"
2077,1,88,15,103,"(a522cb3b03657b1b373ff09c9205d931adb06589, 2016-06-10 21:05:22 -0800, Yuan Yu, 88, 15, 103, LINK)"
20776,1,2,1,3,"(a398d1c1a47ad58ab642dc70d1d281f5b77b07de, 2018-07-14 23:22:31 +0000, Yong Tang, 2, 1, 3, REGEX)"
208,2,952,175,1127,"(57d9aab1c9be6b143a9a4ee462d594f2b259a8ef, 2019-10-30 14:41:26 -0700, Denis Khalikov, 564, 98, 662, LINK), (e7df2c27d8f2956b7ecd18824642bcc555f4da29, 2019-10-30 14:41:26 -0700, Denis Khalikov, 388, 77, 465, LINK)"
20828,1,0,18,18,"(462c89516787db45e5c70bc3c4b893a3df02e6ef, 2018-08-31 15:46:45 -0700, Jared Duke, 0, 18, 18, LINK)"
2083,2,111,81,192,"(69d67717f7b3da135b8904822838823658da183f, 2016-09-17 01:17:20 +0200, Kirill Bobyrev, 89, 62, 151, LINK), (35a93495f17dcd852117646e860983f2c9ee6784, 2016-04-29 08:15:47 +0800, Wenjian Huang, 22, 19, 41, LINK)"
20869,1,16,0,16,"(da12c366bd55cd797e433f78034d3848736ebe6f, 2018-07-19 08:09:45 -0700, A. Unique TensorFlower, 16, 0, 16, LINK)"
20913,1,107,86,193,"(d034768fa9454208c7c7c24666b70ef66f5c1f46, 2018-09-06 11:22:20 -0700, Mark Daoust, 107, 86, 193, LINK)"
20914,1,24,1,25,"(8f130ff5b021efb94946ed9deb1341890763fd3f, 2018-07-19 15:58:10 -0700, A. Unique TensorFlower, 24, 1, 25, LINK)"
20926,1,26,0,26,"(b462815ccc279c79a5592a0a2d4492718da02c5d, 2018-07-18 08:31:46 -0700, KB Sriram, 26, 0, 26, LINK)"
20930,1,616,124,740,"(88419b996b1f1ea980e70e9f99f71c6f3bb3412d, 2019-08-02 14:29:59 -0700, Jiri Simsa, 616, 124, 740, LINK)"
20983,1,71,37,108,"(29831cdce5beb9082940c140aaab735888626dfd, 2018-07-21 17:49:05 -0700, Shaba Abhiram, 71, 37, 108, LINK)"
2099,1,51,16,67,"(379df09118ddfdbad19375d6d853254312ccf1ae, 2016-06-30 14:00:39 -0800, A. Unique TensorFlower, 51, 16, 67, LINK)"
21,1,46,21,67,"(fcf71a20453823c5a1a8f9d2b038868f952c5e66, 2017-03-16 16:08:30 -0700, Alexander Heinecke, 46, 21, 67, LINK)"
21041,1,64,41,105,"(f045accebe1b26c7dbd7312e350bc751648e7042, 2018-08-03 15:25:56 -0700, Yu-Cheng Ling, 64, 41, 105, LINK)"
21136,1,97,14,111,"(0cffe2dba0c2000a8c719c2ed499a3ee72d6a2b6, 2018-08-17 04:07:15 -0700, A. Unique TensorFlower, 97, 14, 111, LINK)"
21164,1,4,1,5,"(ce9e5b035b32ef02cd7d10f6ffdd27cc2a75664d, 2018-09-01 01:40:41 +0000, Yong Tang, 4, 1, 5, REGEX)"
21180,1,431,305,736,"(77fabbeabb5b9061d8c606050c1ea79aec990c03, 2018-08-14 11:22:19 -0700, Priya Gupta, 431, 305, 736, LINK)"
21237,1,44,2,46,"(e9c0dcd7345d37a1b0580b742d59fb664f829f00, 2018-07-31 11:04:37 -0700, Xuechen Li, 44, 2, 46, LINK)"
21277,1,5,0,5,"(8cd2d6fe9389e93a4182ae9287f2f8325913fe6c, 2018-08-01 14:31:15 -0700, Derek Murray, 5, 0, 5, LINK)"
2133,1,0,13,13,"(93031628fe79698201d54ef24a409112c5541694, 2016-04-28 09:02:51 -0800, Martin Wicke, 0, 13, 13, LINK)"
2134,2,45,22,67,"(cb92c9b87392a373f66d2b662ff6e50d4b57551c, 2020-04-14 20:50:12 +0000, Yong Tang, 16, 11, 27, REGEX), (3303168ed6d2e93e46d7ca7fc908aa5084d3f299, 2017-09-18 06:18:53 -0700, Yong Tang, 29, 11, 40, REGEX)"
21344,1,5,3,8,"(97e28831cb3a86d8cf6644b0767df96e818725fa, 2018-08-03 10:09:40 -0700, Asim Shankar, 5, 3, 8, LINK)"
21380,1,1,1,2,"(fd7c6bd68d9c333b457b3692eef102088fbb5874, 2018-08-04 20:31:10 +0000, Yong Tang, 1, 1, 2, REGEX)"
21384,1,7,9,16,"(923f1078e9798014b8e9d925b7d473f6e90e5745, 2018-08-04 19:42:08 +0100, Aurelien Geron, 7, 9, 16, LINK)"
21405,1,189,19,208,"(c966b5eed60a570f2121cb84ddb4ece84c413719, 2018-10-05 15:08:18 -0700, A. Unique TensorFlower, 189, 19, 208, LINK)"
21412,1,431,305,736,"(77fabbeabb5b9061d8c606050c1ea79aec990c03, 2018-08-14 11:22:19 -0700, Priya Gupta, 431, 305, 736, LINK)"
21434,1,1,1,2,"(799db6e589380179c7ef07ba35ddda0e0a636fb3, 2018-08-07 12:32:19 +0000, Yong Tang, 1, 1, 2, REGEX)"
21435,1,2,2,4,"(55656e37f1d5f111faf59b3b94229178c49eab56, 2018-08-07 12:47:42 +0000, Yong Tang, 2, 2, 4, REGEX)"
215,2,706,24,730,"(0c854ec542f9d7fc6bc89b457bf5fda168d92be9, 2019-11-08 11:05:32 -0800, Denis Khalikov, 296, 12, 308, LINK), (126a5ba3b7aa7c0dde9b0df45eb2c41723655027, 2019-11-08 11:05:32 -0800, Denis Khalikov, 410, 12, 422, LINK)"
21525,1,2,2,4,"(6674929c07330bbbe06be03bfd4f8a011cecefc7, 2018-08-10 04:21:54 +0000, Yong Tang, 2, 2, 4, REGEX)"
2154,1,18,4,22,"(67fdaa461c8d0234cc4a8f39d63074fa9bfeef50, 2016-08-25 13:38:16 -0800, Derek Murray, 18, 4, 22, LINK)"
21549,1,15,4,19,"(2c01024d36490ce4c98b80a8d1d6bc706fdc1a3d, 2019-03-10 01:22:15 +0000, Yong Tang, 15, 4, 19, REGEX)"
2159,1,8,7,15,"(2c3c49bb6a1a2f3a9ebcf0b9f48cf8988197f718, 2016-04-29 10:12:27 -0800, A. Unique TensorFlower, 8, 7, 15, LINK)"
2163,2,375,92,467,"(1ed0e764c8ca84d45823f2fd172dc8d40f89e3e2, 2016-05-03 15:32:45 -0800, Geoffrey Irving, 256, 87, 343, LINK), (7233ae61b0e6deb896dd432764e9c0efae340791, 2016-05-02 12:06:47 -0800, Geoffrey Irving, 119, 5, 124, LINK)"
2166,1,24,5,29,"(46538d2b1fd63a2433633b860823535e79861c96, 2016-05-05 10:46:02 -0800, Sherry Moore, 24, 5, 29, REGEX)"
21696,1,5,5,10,"(8c3457521f719736a7ac109bf7debbedd7fe4584, 2018-08-19 20:48:25 +0000, Yong Tang, 5, 5, 10, REGEX)"
21719,1,1,1,2,"(76c4853b50f201b4a809ac66746c798e049b294c, 2018-09-30 20:03:29 -0700, Gunhan Gulsoy, 1, 1, 2, LINK)"
21735,1,9,0,9,"(c7458c97a5f752a2ae79da4cba04ced0dbcb76df, 2018-09-14 10:26:11 -0700, Martin Wicke, 9, 0, 9, LINK)"
21756,1,5,5,10,"(a3ef08178f406cc3e7e4e18434b452e5059f725e, 2018-08-31 17:21:22 -0700, Alexandre Passos, 5, 5, 10, LINK)"
21762,2,8,8,16,"(0d4cb43a540f08cb73c00fac662c961e4154ac32, 2018-09-14 17:29:46 -0700, James Qin, 4, 4, 8, LINK), (cf7373be08a5d745b52d95f2d62e2ccc919ad748, 2018-09-01 00:36:45 +0530, coder3101, 4, 4, 8, LINK)"
21817,1,26,2,28,"(6995d2b9be0e398f11a17348eb5b4745aee0af0d, 2018-09-12 08:42:02 -0700, Jared Duke, 26, 2, 28, LINK)"
21833,1,4,1,5,"(476f65230982842fdd7fabe2ed8d80ee719c20dc, 2018-08-27 13:29:52 -0500, William D. Irons, 4, 1, 5, LINK)"
2188,1,156,14,170,"(f5a282fc259255a90022d927aa02c24a2ea1f119, 2016-05-23 10:24:10 -0800, Shanqing Cai, 156, 14, 170, LINK)"
21898,1,3,1,4,"(46288142246f2d5130e7c3ba5787f616d53e53a9, 2018-11-30 19:42:36 -0500, Joe Quadrino, 3, 1, 4, LINK)"
21909,1,0,622,622,"(ad27440a79c30a53f9fd2a3171a2c2da6ff37820, 2018-09-25 15:04:25 -0700, Alexey Radul, 0, 622, 622, LINK)"
21932,1,2,0,2,"(b4f262cb402bdbdae994be6f87a7735ccfb8ef4f, 2018-10-19 13:32:19 -0700, Jared Duke, 2, 0, 2, LINK)"
21964,1,6,0,6,"(2b9d7d2227061329ddce9c453b4cae58d24ebc90, 2018-11-28 02:40:59 +0000, Yong Tang, 6, 0, 6, REGEX)"
21999,1,1,1,2,"(c67ded664a20f27b4e90020bf76a097b462182b1, 2018-09-01 06:26:02 +0000, Yong Tang, 1, 1, 2, REGEX)"
22013,1,16,2,18,"(85f4f6b7ced7afab7e77e65c2b21448cfbf2d6f2, 2018-10-12 13:11:06 -0700, Eugene Brevdo, 16, 2, 18, LINK)"
22030,1,145,73,218,"(d3458112ad5a1612ec6c77f7de4a0e0ec801e882, 2018-09-13 14:18:16 -0700, Rachel Lim, 145, 73, 218, LINK)"
22042,1,38,9,47,"(a1b64cf2a6a995ffaaf384cf8643221f1c27db48, 2018-09-19 10:49:11 -0700, Alexandre Passos, 38, 9, 47, LINK)"
22048,1,13,2,15,"(6d25ff7a641772ccbe508d5df200aeddc101c028, 2018-09-07 13:18:43 -0700, Alexandre Passos, 13, 2, 15, LINK)"
22054,1,7,0,7,"(3445242ac138d4d5aa9b346e17cd47ebf23770a5, 2018-09-07 23:39:53 +0000, Yong Tang, 7, 0, 7, REGEX)"
22071,2,18,0,18,"(bb7509d4af3b8412dd5da2d01dc0ecbcecd5e5e0, 2019-08-26 20:16:52 -0700, Yuxin Wu, 1, 0, 1, LINK), (3ca6a66a4cc624e9bbac73f3fe30e39feaf4c2c7, 2019-07-10 14:32:42 -0400, Qingqing Cao, 17, 0, 17, LINK)"
22110,1,1,1,2,"(2007f9752e116c46cb82c08a54f5c5e711a7c59d, 2018-09-07 03:44:47 +0000, Yong Tang, 1, 1, 2, REGEX)"
22115,1,3,0,3,"(e3654a3cb4e26c26409aeeb9e127e3addcb14cee, 2018-09-06 19:20:11 +0000, Yong Tang, 3, 0, 3, REGEX)"
22123,1,46,41,87,"(fc44600e5c3ccf1de1e3d4792a00d3578311d3f6, 2018-11-12 08:41:34 -0800, A. Unique TensorFlower, 46, 41, 87, LINK)"
22130,1,3,2,5,"(a12b8c4afdca3ac2945d62b3b83ca2599ab360f9, 2018-09-16 18:39:50 -0400, Keno Fischer, 3, 2, 5, LINK)"
22167,1,4,0,4,"(ca1636667dbfc7eeb35545f150916751742b5cd2, 2018-11-06 14:30:50 -0800, Pulkit Bhuwalka, 4, 0, 4, LINK)"
22186,1,1,2,3,"(90876942a3f4403ebae7d1c9223c241e006eeaaa, 2018-09-12 15:18:20 -0700, A. Unique TensorFlower, 1, 2, 3, LINK)"
22274,1,9,0,9,"(5d51afdfec8c6a96d48457d4678e2835100577a6, 2018-09-18 13:17:07 +0800, Bairen Yi, 9, 0, 9, LINK)"
22295,1,1,2,3,"(297fafbe9464372e1641c0f376f47569a23aeffa, 2018-09-17 00:41:07 +0000, Yong Tang, 1, 2, 3, REGEX)"
223,1,2,2,4,"(fa12ec1184bf74db49f95b13ddbcdd4eceb392ba, 2019-11-05 17:41:29 -0800, Roberto Rosmaninho, 2, 2, 4, LINK)"
22310,1,1,1,2,"(2cb119b81fd08a1e680a2b44ff68c0a8c76eb017, 2018-09-18 10:40:54 +0800, Koan-Sin Tan, 1, 1, 2, LINK)"
2233,1,1860,19,1879,"(6ba4995be6372d1ca5e01eae649c1d8750b65857, 2016-06-03 13:33:40 -0800, Derek Murray, 1860, 19, 1879, LINK)"
22372,1,3,1,4,"(ec6407526c28353c9a0aca5c471681e7d8d4f981, 2018-09-20 14:14:02 +0000, Yong Tang, 3, 1, 4, REGEX)"
22383,1,62,11,73,"(2e21bcf118a549a65c9a6d036fa06eba0f2346e2, 2018-11-15 11:21:10 -0800, A. Unique TensorFlower, 62, 11, 73, LINK)"
22390,2,48,0,48,"(da61525e1eca27c73c83547df973602e2b35a943, 2018-12-03 09:45:27 -0800, A. Unique TensorFlower, 1, 0, 1, LINK), (77e2686a2958eb76e0164828d5d536b86c72464b, 2018-09-27 06:19:58 -0700, A. Unique TensorFlower, 47, 0, 47, LINK)"
2243,1,2,0,2,"(5beae0639fac19ccc19a1399982b2c2e92fe31f1, 2016-05-06 10:45:44 +0200, Kashif Rasul, 2, 0, 2, LINK)"
22452,1,4,1,5,"(92942b794c387c56a1ee21e6103be0814e4b0c95, 2018-10-24 17:37:15 -0700, Mark Daoust, 4, 1, 5, LINK)"
22470,1,2,1,3,"(c475edf9513d6bceae992775869fb9dd0b2c848a, 2018-09-24 05:43:36 +0000, Yong Tang, 2, 1, 3, REGEX)"
2248,1,6,2,8,"(548b3a416b54e5c07c762ff269178c30c1e60241, 2016-12-15 23:19:29 +0100, Yun Peng, 6, 2, 8, LINK)"
22499,1,1,1,2,"(bd2524f16f3722cce2360ec5f7122c6b6f1ead49, 2018-09-26 13:23:14 +0800, Koan-Sin Tan, 1, 1, 2, LINK)"
225,1,422,20,442,"(ce2c67ceb1011a591f33d8a31d72f054b665efbe, 2019-12-18 09:59:37 -0800, Uday Bondhugula, 422, 20, 442, LINK)"
2255,1,62,51,113,"(3a98d5ad30165f4f96be4993fe563d9b2eaf6b10, 2016-05-29 21:29:40 +0100, Igor Babuschkin, 62, 51, 113, LINK)"
22611,1,1,1,2,"(97d515273a1e86a861cdfb338671a42b3b1126a7, 2018-10-02 07:34:40 -0700, Peter Hawkins, 1, 1, 2, LINK)"
227,1,4,4,8,"(e5cc12f923f223cb7b8e976fbd8e5c400275af93, 2019-11-18 21:51:48 -0800, Manuel Freiberger, 4, 4, 8, LINK)"
22706,1,1,1,2,"(83ff640fa5026b8bd3cb9c2ceff9e99e8e03823a, 2018-10-04 18:46:53 -0700, Justin Lebar, 1, 1, 2, LINK)"
22741,1,3,3,6,"(94ab1a9e82fb7630b1aae44984d73968508dc917, 2018-10-16 14:44:33 -0700, Gunhan Gulsoy, 3, 3, 6, LINK)"
22750,2,70,59,129,"(76e7804409ccd76c7ce08e66eb739544cd5cda68, 2018-10-18 15:59:30 -0700, Tayo Oguntebi, 56, 45, 101, LINK), (1845bf763b4c1c54425d9bb8b1554db79759f567, 2018-10-17 13:03:04 -0700, Tayo Oguntebi, 14, 14, 28, LINK)"
22761,1,1,1,2,"(2502702e23e448dcef0fdd13d7e3049f6b5c9726, 2018-10-11 10:41:52 -0700, A. Unique TensorFlower, 1, 1, 2, LINK)"
22762,2,21,28,49,"(b41761c499a5081870b9da4a8ae73adc45df269a, 2018-10-14 11:28:53 +0800, Jason Zaman, 20, 26, 46, LINK), (c11b5458f81c143a0de6905d32cacd893ad2bcd7, 2018-10-14 13:46:59 +0800, Jason Zaman, 1, 2, 3, LINK)"
22793,1,14,12,26,"(775188c321335b1053fd1fb174efd607e5173d59, 2018-10-09 20:51:30 +0000, Yong Tang, 14, 12, 26, REGEX)"
228,2,28,2,30,"(e5928fc7d579c126ff7fd75e7178efde033af8a1, 2019-11-09 12:14:39 -0800, Manuel Freiberger, 14, 1, 15, LINK), (04de1c46b77b78930a4be6fd9ffac5a490234b53, 2019-11-09 12:14:39 -0800, Manuel Freiberger, 14, 1, 15, LINK)"
22819,1,238,84,322,"(3437098ba5b111817ef6ac5906d86934168704b7, 2018-10-12 15:26:01 -0700, Gunhan Gulsoy, 238, 84, 322, LINK)"
22853,1,29,4,33,"(aba365a8e13ca6a4cf4fccb60226995433849302, 2018-10-15 09:27:23 -0700, Allen Lavoie, 29, 4, 33, LINK)"
2289,1,38,4,42,"(a8c3de3bddf01b4b80c986b3bb81d2a1658be3c8, 2016-06-15 12:28:54 -0800, Derek Murray, 38, 4, 42, LINK)"
229,1,12,0,12,"(c902682b0ee21c7b91228df2bfe252ee14bc26ae, 2019-11-09 21:30:42 -0800, Mehdi Amini, 12, 0, 12, LINK)"
22925,1,44,40,84,"(8c072a519e2beed483adb361a9be934a47bee366, 2018-10-23 00:45:32 -0700, A. Unique TensorFlower, 44, 40, 84, LINK)"
2295,1,45,36,81,"(a33ebe0bfc0c6d0c617d48a71f6f5136be881041, 2016-07-18 13:56:52 -0800, Geoffrey Irving, 45, 36, 81, LINK)"
2296,1,26,17,43,"(4a80e9f59f2ac4b042537901f9396ac59febc851, 2017-02-03 23:41:12 +0500, Rizwan Asif, 26, 17, 43, LINK)"
230,1,2,2,4,"(9403dfbb776109a74178764e5a3107b9623ea0e0, 2019-11-18 11:25:52 -0800, A. Unique TensorFlower, 2, 2, 4, LINK)"
23057,1,2,2,4,"(146003df2407dba66fedbf0e3a26327f272cae14, 2018-11-08 09:34:08 -0800, Mark Daoust, 2, 2, 4, LINK)"
23059,1,110,52,162,"(c975cefc3d9516e1e7b8799ac86b908fd9a1dcdc, 2018-11-05 22:30:46 -0800, Mark Daoust, 110, 52, 162, LINK)"
23114,1,40,1,41,"(c5b1ad0ea01634d0fb6bf6ba59ce014f1e66b6d9, 2018-10-25 22:20:40 +0000, Yong Tang, 40, 1, 41, REGEX)"
2315,1,7,3,10,"(1e5e9bed84e44b152a373cd3a6a2bb16e464bd87, 2016-05-12 16:50:38 -0800, Geoffrey Irving, 7, 3, 10, LINK)"
2317,1,2,0,2,"(824719194d6741c7b790f72caae2e4a6c7b39c9c, 2016-05-20 09:31:45 -0800, Martin Wicke, 2, 0, 2, LINK)"
23195,1,80,61,141,"(95de98b58a35aaac2804716a70979e68596f3dae, 2018-10-30 18:28:02 -0700, Shivani Agrawal, 80, 61, 141, LINK)"
232,2,2,0,2,"(a29f106161bee066cee1bce3e3c4f3c5a5fc4293, 2019-11-15 09:05:35 -0800, Nicolas Vasilache, 1, 0, 1, LINK), (946bd11412d641682d17b68e9437b888e4ec5619, 2019-11-15 09:05:35 -0800, Nicolas Vasilache, 1, 0, 1, LINK)"
23236,1,6,9,15,"(ce5b0e6c239e8f80f05aa0874f84afd9cfc08538, 2018-11-05 14:58:45 -0800, Alexandre Passos, 6, 9, 15, LINK)"
2326,2,96,24,120,"(31f9379a537f13504c866c7551e7f8c01a523c67, 2016-06-08 09:10:40 -0800, Derek Murray, 48, 12, 60, LINK), (f8451732c383cd7a4b4514b81e90ac2f2270db58, 2016-06-08 09:10:40 -0800, Derek Murray, 48, 12, 60, LINK)"
2332,1,38,7,45,"(4dd5fef8700bc62f6881e870b9ff57b92c3b0384, 2016-05-24 17:04:44 -0700, David Z. Chen, 38, 7, 45, LINK)"
23334,1,114,68,182,"(c1399d6459f989740dcbce96582fb380716c0f1f, 2018-11-14 11:56:12 -0800, Derek Murray, 114, 68, 182, LINK)"
23440,1,10,1,11,"(4e81d6cc877ba4a56196bbdd8d4e09ab7f7b8412, 2018-11-05 11:09:46 -0800, Pete Warden, 10, 1, 11, LINK)"
23449,1,38,15,53,"(816426f66a9b3edbbdf4203684f7753b2974866d, 2018-11-08 09:37:50 -0800, Jared Duke, 38, 15, 53, LINK)"
23452,1,1,1,2,"(61a1032a6920c948671c6b6d698dda8605af079c, 2018-11-03 21:28:20 +0000, Yong Tang, 1, 1, 2, REGEX)"
23561,2,6,1,7,"(ddba76d1f27f383bfc05c5ecea03a8ebea2f87d8, 2020-08-08 18:02:41 -0700, Mihai Maruseac, 2, 0, 2, LINK), (0dc200d8da26a9a42281df160168fe905c6126d0, 2019-02-01 09:29:50 -0800, Gunhan Gulsoy, 4, 1, 5, LINK)"
23599,1,20,25,45,"(b9a794155197dd30aabaa703da87db06b9b7dc3d, 2019-02-21 08:49:26 -0800, A. Unique TensorFlower, 20, 25, 45, LINK)"
23654,1,6,2,8,"(7d96d6fbd3cdbe215c9dce78f8227ef273b5d37a, 2018-11-10 20:28:31 +0000, Yong Tang, 6, 2, 8, REGEX)"
23655,2,19,0,19,"(025aa34d77b0ba1c9035cfa7b3c7f98bcccb1435, 2019-03-12 17:36:14 -0700, Nick Hamatake, 15, 0, 15, LINK), (7e090f6a5412fd5f22b5b75ca7ae7844c3d025e9, 2019-01-15 16:34:32 -0800, Nick Hamatake, 4, 0, 4, LINK)"
2366,1,28,8,36,"(e016791ddedb5bfb288361d61a0f56e70302ed20, 2016-05-16 13:00:32 -0800, Derek Murray, 28, 8, 36, LINK)"
23695,1,7,0,7,"(dcc76a5c4945406455213b05fb8c084b5a8b9b6d, 2018-11-20 10:35:18 -0600, William D. Irons, 7, 0, 7, LINK)"
237,1,73,0,73,"(a6ceaa8440ed03800f8a2a73a09dbf68d2913105, 2019-11-19 10:15:36 -0800, Diego Caballero, 73, 0, 73, LINK)"
2371,2,2,0,2,"(66cda380161420269c2d586dab8f10b6f91834f2, 2016-05-16 15:27:24 -0800, Manjunath Kudlur, 1, 0, 1, LINK), (78bc7caa1d42770dbb8996789984da465fdb0d46, 2016-05-16 15:27:24 -0800, Manjunath Kudlur, 1, 0, 1, LINK)"
23731,1,2,57,59,"(fbd5472f477c277aa1e4044d4f7e29b4ae958542, 2018-11-27 18:02:07 -0800, Pavithra Vijay, 2, 57, 59, LINK)"
23748,1,152,38,190,"(74195b50fb5e1f22eb95ffd1646b4b0ceca2ea9b, 2020-02-06 11:35:45 -0800, Mark Daoust, 152, 38, 190, LINK)"
23794,1,9,5,14,"(f93cdcb3cd1dac7769ac393dbcbab801a304480b, 2018-11-20 15:53:51 -0800, Akshay Modi, 9, 5, 14, LINK)"
238,1,35,4,39,"(ef0b2bb992fdc6a4cc1b372df62da988671318c2, 2019-11-18 12:36:16 -0800, Denis Khalikov, 35, 4, 39, LINK)"
2385,1,48,14,62,"(dd3b812879671d633ddbb644a48f6fc44faae0bc, 2016-05-17 21:47:26 -0800, Derek Murray, 48, 14, 62, LINK)"
23853,5,457,168,625,"(49887c3a02acb191eaa3d642135a7037c8e4f993, 2019-03-12 18:19:23 -0700, Guangda Lai, 23, 23, 46, LINK), (574db93f256879e4182760b2661f2c398f48372e, 2019-01-16 17:08:25 -0800, Guangda Lai, 314, 48, 362, LINK), (1ff3592ee23d146a9f715fe6a8ff1dc2d3d41bfd, 2019-01-11 14:38:07 -0800, Guangda Lai, 55, 44, 99, LINK), (e51fa30400b3a469b03111b25344bc47bdff96bd, 2019-01-11 14:38:07 -0800, Guangda Lai, 55, 44, 99, LINK), (4fbbeea283de57deb681699a93694871a297d286, 2018-11-26 22:11:19 -0800, Asim Shankar, 10, 9, 19, LINK)"
23878,1,62,4,66,"(36304bc4ceb6140e470420b65ce470092fc47ab2, 2018-12-17 14:25:40 -0800, Scott Zhu, 62, 4, 66, LINK)"
2388,1,18,4,22,"(67fdaa461c8d0234cc4a8f39d63074fa9bfeef50, 2016-08-25 13:38:16 -0800, Derek Murray, 18, 4, 22, LINK)"
23926,1,1,0,1,"(95f218770fe2dfd577625d803756fb9c9459bd6c, 2018-11-28 12:27:46 -0800, Andrew Selle, 1, 0, 1, LINK)"
23933,1,216,343,559,"(790390598cad7c4e456b60400a0d0d5454e75716, 2018-11-30 03:34:29 +0000, Bairen Yi, 216, 343, 559, LINK)"
23987,1,12,0,12,"(6d3d0de39f3eaecdbf7fbdb52a7a02b2539efeeb, 2018-11-27 11:18:09 +0800, qiezi, 12, 0, 12, LINK)"
24,1,2,1,3,"(1308255efa0ad373aa306839d0acd4fb199f62ca, 2017-03-21 12:21:53 -0700, Anand Venkat, 2, 1, 3, LINK)"
24072,1,3,4,7,"(8584f21392772170b007ee3b3fbfed17fe19e32f, 2018-12-01 20:58:09 +0000, Yong Tang, 3, 4, 7, REGEX)"
2420,1,1,1,2,"(ac92bfebd177e7caaaaf1f3b8cd18af28ff945b6, 2016-06-10 08:47:06 -0700, Andrew Royer, 1, 1, 2, LINK)"
2425,1,82,63,145,"(acac487ac4ebaa6edb3e3f866d41cbd12546a107, 2016-05-25 13:39:41 -0800, Derek Murray, 82, 63, 145, LINK)"
2426,1,41,26,67,"(cce41d3fa372e0207b59bb592cb22acc8fe0c3bb, 2016-05-19 07:45:10 -0800, Manjunath Kudlur, 41, 26, 67, LINK)"
24397,1,1,1,2,"(e74388ec6d1e8aeadd7aaa787544f319175dd2a6, 2019-01-16 17:15:17 +0000, Yong Tang, 1, 1, 2, REGEX)"
244,1,1,0,1,"(9432026e892d1f5b80d616d20042c4aa0332dd4c, 2019-11-26 11:37:46 -0800, David Truby, 1, 0, 1, LINK)"
24414,1,24,2,26,"(1a26797203e62390623756fd67e69e7665b69389, 2019-03-31 09:46:48 -0700, Penporn Koanantakool, 24, 2, 26, LINK)"
24457,1,4,4,8,"(15d49deb3c5d4048718af19a2e0e0279e8f204d5, 2019-01-01 00:16:30 +0000, Yong Tang, 4, 4, 8, REGEX)"
2447,2,414,10,424,"(0d0f37aef1f87c4c31c12ce876864022f624cd4c, 2016-06-14 22:47:37 -0800, Derek Murray, 207, 5, 212, LINK), (cc40cd3b0a8b83f5ee071b7ee32c17b56815a89c, 2016-06-14 22:47:37 -0800, Derek Murray, 207, 5, 212, LINK)"
24475,1,85,12,97,"(a025c7a21ca6718fe55b1f21707bea4b6acb836c, 2018-12-21 12:59:01 -0800, Jared Duke, 85, 12, 97, LINK)"
24547,1,2,0,2,"(e3ae0538377cda88f5411c89e39bf48a33aa1fa7, 2018-12-24 22:36:17 +0000, Yong Tang, 2, 0, 2, REGEX)"
24578,1,1,1,2,"(1ae58b7732b5b5c390bdec5499497a87222d6fcd, 2018-12-26 20:07:56 +0000, Yong Tang, 1, 1, 2, REGEX)"
24598,1,10,3,13,"(961e9f4505dff0c5a91d12b1f4e476b3cf2d295d, 2018-12-27 15:58:57 -0800, Alexandre Passos, 10, 3, 13, LINK)"
246,1,29,1,30,"(a39495412138cc16400b6bc35baafc721307ba6d, 2019-11-19 21:04:45 -0800, Eric Schweitz, 29, 1, 30, LINK)"
24601,1,1,1,2,"(a1e5738523dad2a0b8942bb97639f038d8961cdc, 2018-12-28 14:09:30 +0000, Yong Tang, 1, 1, 2, REGEX)"
24622,1,1,1,2,"(9fb415c6eac3cd245de736e7ebc54094416c1013, 2018-12-30 01:07:37 +0000, Yong Tang, 1, 1, 2, REGEX)"
24627,1,1,1,2,"(53e677de105c2edbfdc2d86ceb31d06765b08512, 2018-12-30 10:07:06 +0000, Yong Tang, 1, 1, 2, REGEX)"
24632,1,387,147,534,"(826027dbd4277a2636fc2935ed245700fd01e7cd, 2019-02-22 13:39:19 -0800, Nick Felt, 387, 147, 534, LINK)"
2464,1,1,1,2,"(9eb50f1c7f8b167ae603ebc3eba92761be105fb1, 2016-05-23 12:21:37 -0800, Geoffrey Irving, 1, 1, 2, LINK)"
2467,1,212,96,308,"(9d6b7680cfcc5b784401d17fef997f0c089038b1, 2016-06-14 08:41:51 -0800, A. Unique TensorFlower, 212, 96, 308, LINK)"
24679,2,35,0,35,"(453ebe01a3a1cc6382ec90539fc98e4554dece87, 2019-01-06 07:00:16 +0000, Yong Tang, 13, 0, 13, REGEX), (3e85e82fd5cd6b3100967cae899c2229636c2e95, 2019-01-06 06:56:02 +0000, Yong Tang, 22, 0, 22, REGEX)"
247,1,2,2,4,"(74fabb4350756ce8ab53144eb9ebb8b2e2e70c0f, 2019-11-18 16:58:32 -0800, Tian Jin, 2, 2, 4, LINK)"
24701,1,3,3,6,"(107b7c4de6727ad02a0b4fc24aa1ac17bd697776, 2019-01-08 11:37:37 -0500, Dan Moldovan, 3, 3, 6, LINK)"
2473,1,40,13,53,"(a6901e988401328be0d7756ccd53c2b7c3d19a34, 2016-05-26 07:17:29 -0800, Derek Murray, 40, 13, 53, LINK)"
2474,1,42,4,46,"(aec225cbc1d6c2dd9ee51e09996a38c868e9e2dd, 2016-05-23 13:57:58 -0800, Derek Murray, 42, 4, 46, LINK)"
24756,1,2,2,4,"(9e0e9e255fb9210ed2da50dffba156f1d5617b8b, 2019-01-09 02:03:37 +0000, Yong Tang, 2, 2, 4, REGEX)"
24759,2,272,534,806,"(14c78f9675a29190460d6cd5e10ce38e3be84fad, 2019-02-02 13:05:11 -0800, Dan Moldovan, 250, 524, 774, LINK), (461b0857ae2e0a3129324ffc0264732110e007b0, 2019-01-25 10:40:30 -0800, Dan Moldovan, 22, 10, 32, LINK)"
2487,1,404,96,500,"(54cf1600b98127d5076def3c567cda1e087c1761, 2016-06-06 16:31:38 -0800, Illia Polosukhin, 404, 96, 500, LINK)"
250,1,6,6,12,"(fd9697d81d3977b312763ce8a4949bc20d7b2f50, 2019-12-04 04:58:12 -0800, Kazuaki Ishizaki, 6, 6, 12, LINK)"
25067,2,14,2,16,"(91e69ff612670437ccbf7c6a63545af2a7b5c5e5, 2019-01-22 16:12:11 -0800, James Keeling, 7, 1, 8, LINK), (b084482d79d28bb79f26c9b86f7ba654fcf25238, 2019-01-22 16:12:11 -0800, James Keeling, 7, 1, 8, LINK)"
2508,1,68,5,73,"(e8948a2d9d4e8d69d6fd925ca3824fca26e14fee, 2016-05-26 09:16:41 -0800, Vijay Vasudevan, 68, 5, 73, LINK)"
251,1,458,241,699,"(48200148281358406eef4e0874a526775e7671f1, 2019-12-04 07:17:01 -0800, Julian Gross, 458, 241, 699, LINK)"
25127,1,2,1,3,"(939f9651a7c6e1c8e8dd02380909fce22fa34a66, 2019-01-22 15:43:50 +0100, Mark Ryan, 2, 1, 3, LINK)"
25159,1,38,9,47,"(e42a66b26372845ea41aea6c12bc3e4f09f1efc5, 2019-02-22 14:05:33 -0800, Dan Moldovan, 38, 9, 47, LINK)"
25234,1,2,1,3,"(2597b96b727fb951b642a79b64f097151a575362, 2019-01-28 18:57:17 -0800, Allen Lavoie, 2, 1, 3, LINK)"
25262,1,6,2,8,"(823b694639a3f49b6adbf9e73a08c529d583878e, 2019-01-29 01:42:32 -0800, James Keeling, 6, 2, 8, LINK)"
25278,1,38,1,39,"(030088358322c883086817a732f1cbe9dd84bb49, 2019-02-04 17:19:22 -0800, Jared Duke, 38, 1, 39, LINK)"
25281,1,250,524,774,"(14c78f9675a29190460d6cd5e10ce38e3be84fad, 2019-02-02 13:05:11 -0800, Dan Moldovan, 250, 524, 774, LINK)"
253,1,17,2,19,"(1629894b12112dee3523dd7afe4a55394c4a7d3a, 2019-12-06 05:59:06 -0800, Uday Bondhugula, 17, 2, 19, LINK)"
2533,1,18,20,38,"(5309675019fe80c39a019057f4f034a2faed4cd7, 2016-06-03 01:02:23 -0700, Jan Prach, 18, 20, 38, LINK)"
25382,1,25,0,25,"(745028b1fba059062128647ea6dfa8cd8021dfea, 2019-02-15 14:56:52 -0800, Alexandre Passos, 25, 0, 25, LINK)"
2540,1,11,1,12,"(098a63e078715af11f61f769e7afc501c77fc104, 2016-06-02 09:12:39 -0800, Geoffrey Irving, 11, 1, 12, LINK)"
25426,1,29,5,34,"(3ae3c3c9d43f870d6340cec529de03175e914595, 2019-07-12 21:16:32 -0700, Eugene Brevdo, 29, 5, 34, LINK)"
25463,1,52,7,59,"(a252fe83f4dc29c0614983046825ec75a3529cb9, 2019-02-06 20:32:43 -0800, Craig Citro, 52, 7, 59, LINK)"
255,2,586,586,1172,"(6de3ae79f0328049dd1bc36995bc7595a296085a, 2019-12-11 07:16:47 -0800, Alexander Belyaev, 0, 586, 586, LINK), (bc89328060add08ec36d912cf885a27448baed4d, 2019-12-11 01:02:39 -0800, Marcel Koester, 586, 0, 586, LINK)"
25524,1,387,147,534,"(826027dbd4277a2636fc2935ed245700fd01e7cd, 2019-02-22 13:39:19 -0800, Nick Felt, 387, 147, 534, LINK)"
25666,1,0,2,2,"(09d1dd9377a9daae3c5f14ed437d5af32b292deb, 2019-02-25 16:41:57 -0800, Alexandre Passos, 0, 2, 2, LINK)"
25674,2,14,8,22,"(5d41621226ccdd81cb10e1bc1bc7a7383ca2e930, 2019-02-12 17:02:26 -0800, Niranjan Hasabnis, 7, 3, 10, REGEX), (03baa8e8462aaf1211afca506b582eb35ae2fd7e, 2019-02-12 17:02:26 -0800, Niranjan Hasabnis, 7, 5, 12, REGEX)"
257,1,129,137,266,"(7a3601875dd0378a672de27e4f16895c16e3f04d, 2019-11-22 07:52:02 -0800, Jean-Michel Gorius, 129, 137, 266, LINK)"
25707,2,413,148,561,"(059ea3ba68db861e40d750eba688281011d2735f, 2019-02-27 20:47:27 -0800, William Chargin, 26, 1, 27, LINK), (826027dbd4277a2636fc2935ed245700fd01e7cd, 2019-02-22 13:39:19 -0800, Nick Felt, 387, 147, 534, LINK)"
2575,1,40,0,40,"(f134f05ff95bbcb6ab205b67ceff1743126d9465, 2016-06-01 15:04:34 -0800, Derek Murray, 40, 0, 40, LINK)"
25786,1,20,3,23,"(4acd35007ab2887dad240bff8f0e188a681c48d6, 2019-02-15 13:03:11 -0800, Allen Lavoie, 20, 3, 23, LINK)"
25835,1,2,0,2,"(b4f95454cf535b173291acab516cddf47b17a10d, 2019-02-18 21:34:11 +0000, Yong Tang, 2, 0, 2, REGEX)"
2586,1,123,47,170,"(bf8084b71006123575c6416d69efdd00c13fe41c, 2016-06-09 10:34:14 -0800, Yuan Yu, 123, 47, 170, LINK)"
25882,1,193,4,197,"(d87710ed89e01cf479d2b6ba619a879c32ad77d9, 2019-03-21 14:35:57 -0700, A. Unique TensorFlower, 193, 4, 197, LINK)"
259,1,5,3,8,"(2cfa79f98497cd7d9ce9d26de38ec046323d1d31, 2019-12-03 06:09:21 -0800, Diego Caballero, 5, 3, 8, LINK)"
2591,1,1,1,2,"(79174afa30046ecdc437b531812f2cb41a32695e, 2016-06-01 16:50:14 -0700, Orion Reblitz-Richardson, 1, 1, 2, LINK)"
25976,1,76,55,131,"(fa8b0ef354b99c3fde12efd8d865ffeef173e47f, 2019-02-27 10:00:29 -0800, Nick Felt, 76, 55, 131, LINK)"
2598,1,11,0,11,"(e5c136b0d01a6aaa22321afaade7fba31c2f4452, 2016-06-07 16:20:11 -0800, Yuan Yu, 11, 0, 11, LINK)"
25985,1,17,2,19,"(83df61b4d4ad11f3b8cf05ee98d29e6fb5e25506, 2019-03-09 08:42:22 -0800, Scott Zhu, 17, 2, 19, LINK)"
26026,1,19,3,22,"(d51261962b3ada9f3024916d9f8cbf74aae4a8c3, 2019-02-28 11:48:25 -0800, Scott Zhu, 19, 3, 22, LINK)"
26048,1,23,1,24,"(710b322a8be78b8aff6b148575fcfe5301f42b64, 2019-03-05 09:04:41 -0800, Alexandre Passos, 23, 1, 24, LINK)"
2605,1,465,5,470,"(6b1b429da364b5f78adc1a3f3360c60dff2c2f41, 2016-06-03 09:45:51 -0800, A. Unique TensorFlower, 465, 5, 470, LINK)"
2606,1,289,218,507,"(f9b6d55ffd630082efd088fca927f7d991fdf3fa, 2016-11-02 15:31:56 -0800, Illia Polosukhin, 289, 218, 507, LINK)"
26099,1,8,1,9,"(a311216a9f028eec9e6b0d2ef175f5d46dff19b7, 2019-04-22 21:24:42 -0700, Anna R, 8, 1, 9, LINK)"
261,1,517,97,614,"(21e8f2476eb1e50d70bc65bc81a587364a41abe2, 2019-12-05 13:12:50 -0800, nmostafa, 517, 97, 614, LINK)"
26143,1,15,0,15,"(764fdc6fb1a9ac377440e1b537ff8a6b7e9f2063, 2019-04-01 14:24:58 -0700, A. Unique TensorFlower, 15, 0, 15, LINK)"
2619,3,113,67,180,"(c7df235027fc07ea3a2a6c04ff2f69cd86afae57, 2016-06-15 12:43:58 -0800, David G. Andersen, 53, 7, 60, LINK), (075189747e9fc90976f84ed835452f955767a33a, 2016-06-14 19:03:52 -0800, A. Unique TensorFlower, 7, 53, 60, LINK), (2ef218d722f316339ed10be2d9a3375b4a4d9f78, 2016-06-14 17:12:10 -0800, David G. Andersen, 53, 7, 60, LINK)"
262,1,4,4,8,"(144cc5e670583379ee5689db4da35d1f253eb529, 2019-12-02 09:12:48 -0800, brett koonce, 4, 4, 8, LINK)"
263,1,54,0,54,"(b6a81c1a078449e6f5a1e961f023d609a8c35cf8, 2019-12-10 07:01:17 -0800, Mehdi Amini, 54, 0, 54, LINK)"
26311,1,20,1,21,"(a3786f5d589a3b10f6152558dfb6f19070a6f30d, 2019-03-04 10:47:54 -0800, Allen Lavoie, 20, 1, 21, LINK)"
26394,1,5,2,7,"(8dc2d0eedac7760deb65254a8ef89878743299d7, 2019-03-12 01:41:05 -0700, A. Unique TensorFlower, 5, 2, 7, LINK)"
2645,1,123,47,170,"(bf8084b71006123575c6416d69efdd00c13fe41c, 2016-06-09 10:34:14 -0800, Yuan Yu, 123, 47, 170, LINK)"
265,1,26,25,51,"(d4119f4af71f52f353278d7f80d31ee424fa622c, 2019-11-25 17:53:20 -0800, Andrew Anderson, 26, 25, 51, LINK)"
26502,1,119,155,274,"(88ca0db75e6daf66c6fb21609ee4100126f1b727, 2019-04-19 23:43:26 -0700, Anna R, 119, 155, 274, LINK)"
26581,2,1173,600,1773,"(e62dc433fcce833313b4174e20fc24c418593d27, 2019-06-01 16:53:19 -0700, Scott Zhu, 1102, 596, 1698, LINK), (0667725ba4e010c06fcf5e2a388eb8c2f3f6efe1, 2019-05-15 15:35:01 -0700, Scott Zhu, 71, 4, 75, LINK)"
26590,1,17,12,29,"(8fcf86ec70a2a91e33f222d2be85675f0b773581, 2019-03-12 11:38:22 -0700, Scott Zhu, 17, 12, 29, LINK)"
26591,2,69,5,74,"(4f086f4c0fc5547bf91d0036ccecf33d69c1303a, 2019-03-15 15:47:51 -0700, Allen Lavoie, 45, 2, 47, LINK), (9a9ddff941400cea361ffaa2fb9e73fa007d2f72, 2019-03-12 10:28:55 -0700, Allen Lavoie, 24, 3, 27, LINK)"
266,2,93,21,114,"(5247c0d46c9a0613b7573880bbd7eabd6c693b87, 2019-12-02 07:58:38 -0800, Denis Khalikov, 2, 2, 4, LINK), (fd26a93ee1799c78975a02c7bba58b3e52357fb3, 2016-01-06 14:09:18 -0800, Geoffrey Irving, 91, 19, 110, LINK)"
2660,1,10,6,16,"(271041324f1cff584d20021196a9da0493e130c9, 2016-06-07 13:01:52 -0800, Vijay Vasudevan, 10, 6, 16, LINK)"
26602,1,100,78,178,"(4e4943edc3d2409bffb5776f99b941987d6eda82, 2019-04-10 01:43:29 -0700, Vojtech Bardiovsky, 100, 78, 178, LINK)"
26639,1,2,0,2,"(f7ee1bff1d90aa0ac0a5e16a71c3c60f7ad96fdb, 2020-07-18 23:31:59 -0700, A. Unique TensorFlower, 2, 0, 2, LINK)"
26659,1,252,7,259,"(6e559b96c8146ce15c7c03f66e515e31a6b0aa00, 2019-04-12 17:56:13 -0700, Gaurav Jain, 252, 7, 259, LINK)"
26665,1,173,20,193,"(a236ae23782c04a057d17a8ad845500c7f15c432, 2019-03-14 16:19:17 -0700, Pavithra Vijay, 173, 20, 193, LINK)"
26684,1,12,9,21,"(097fc1cdef5c56d4bb239a5a44bf950f0b1c4d37, 2019-03-30 20:32:57 -0700, Nick Felt, 12, 9, 21, LINK)"
26793,2,32,15,47,"(a3444844ee20acd750165f6f8ffef1495909f12e, 2019-03-21 16:40:42 -0700, Dan Moldovan, 2, 2, 4, LINK), (53d3a33b54e1cc725099617b63d2b9637974c97a, 2019-03-21 14:17:57 -0700, Dan Moldovan, 30, 13, 43, LINK)"
26808,1,31,7,38,"(a79ed9c304bf9c1971fe3df4f61a0d0ab515eff9, 2019-03-27 13:45:24 -0700, Akshay Modi, 31, 7, 38, LINK)"
26879,2,13,2,15,"(404f99dbd9cb302e6fe4df3411e9d0750bf84319, 2019-03-26 06:08:01 +0000, Yong Tang, 7, 0, 7, REGEX), (04b97cde86550995da57d16d81084006456ccce5, 2019-03-26 02:38:33 +0000, Yong Tang, 6, 2, 8, REGEX)"
2690,1,24,1,25,"(14e425c313a96cedb514cbc2c122d201707994ac, 2016-06-06 11:55:19 -0800, Derek Murray, 24, 1, 25, LINK)"
26902,1,102,0,102,"(0fa0d44944abd86578fa076802f5a8a7490d5656, 2019-07-24 18:04:24 -0700, Anna R, 102, 0, 102, LINK)"
27,2,42,71,113,"(23caaa5e42c87a189511438dcadc428b683cd028, 2017-05-22 14:09:29 -0700, Benoit Steiner, 36, 70, 106, LINK), (da88e3ff1c973f3aeb69c7632df7dc9c0e9d6f49, 2015-12-11 09:15:31 -0800, Illia Polosukhin, 6, 1, 7, LINK)"
270,2,102,86,188,"(6596a600669d2dea9b3204e07e0943db071c42d1, 2019-11-28 01:59:22 -0800, Jose Ignacio Gomez, 51, 43, 94, LINK), (6596a600669d2dea9b3204e07e0943db071c42d1, 2019-11-28 01:59:22 -0800, Jose Ignacio Gomez, 51, 43, 94, REGEX)"
2703,3,80,5,85,"(4959a1291045674a23793212cfe94d4804760f01, 2016-08-09 11:16:44 -0800, Olivia Nordquist, 64, 5, 69, LINK), (1bfe153a894fbcb00cec6678721b2ef45e68e172, 2016-06-20 10:04:14 -0700, Olivia, 8, 0, 8, LINK), (14712c983015c36382913b55ae6455fecb7c9078, 2016-06-20 10:04:14 -0700, Olivia, 8, 0, 8, LINK)"
27086,1,38,1,39,"(f6e0ec468a3dee7c2ae1fa3575bb46d884b4a319, 2019-07-18 10:05:52 -0700, Rohan Jain, 38, 1, 39, LINK)"
271,2,510,54,564,"(fe28ea37087df028455dd49e3d1d9c15116707a3, 2019-12-05 15:14:22 -0800, Jose Ignacio Gomez, 255, 27, 282, LINK), (fe28ea37087df028455dd49e3d1d9c15116707a3, 2019-12-05 15:14:22 -0800, Jose Ignacio Gomez, 255, 27, 282, REGEX)"
272,2,172,28,200,"(90d71017d128c1e05db50ef45c728c568641db3a, 2019-12-10 12:25:10 -0800, Jose Ignacio Gomez, 86, 14, 100, LINK), (90d71017d128c1e05db50ef45c728c568641db3a, 2019-12-10 12:25:10 -0800, Jose Ignacio Gomez, 86, 14, 100, REGEX)"
27202,1,11,8,19,"(009fde664530e6616e5aa1f882ff497e9e435924, 2019-04-05 17:22:35 -0700, Jared Duke, 11, 8, 19, LINK)"
27282,1,13,6,19,"(04e311bf7628eac8b0334a7419442f1009487d7f, 2019-06-21 16:39:11 -0700, Jared Duke, 13, 6, 19, LINK)"
27292,1,108,112,220,"(3e8a80bce0f7ef0ab2ee49f3528a2652f26110f0, 2019-04-11 16:51:35 -0700, Scott Zhu, 108, 112, 220, LINK)"
2740,1,43,1,44,"(a2b9788ce440c350d4e3fef53fe0c51ba1c10c1a, 2016-06-29 16:30:37 -0800, Frank Li, 43, 1, 44, LINK)"
2742,1,92,37,129,"(572c5861337f937d21c5aa90e37d5d6fbc7c242b, 2016-06-09 10:18:20 -0700, Gregory King, 9, 4, 13, LINK)"
27431,1,16,2,18,"(9d724a8e6034d321e97cdc9972d4d6e7adb3e3ca, 2019-04-11 11:09:06 -0700, Scott Zhu, 16, 2, 18, LINK)"
27455,1,40,0,40,"(244cb0b925902a29c6a39c62fd1b80cb3797051b, 2019-04-09 14:39:48 -0700, A. Unique TensorFlower, 40, 0, 40, LINK)"
27497,2,18,0,18,"(f303882d7a4f97202a378814aabdcb22d960af58, 2019-04-10 00:47:29 +0000, Yong Tang, 12, 0, 12, REGEX), (82eafde35fce5aa7cbe57b6af49cb990f5edaf2c, 2019-04-10 00:43:28 +0000, Yong Tang, 6, 0, 6, REGEX)"
27565,1,2,2,4,"(110f0610ed0cf52d256e414906cf91d4e9d657e7, 2019-05-02 16:38:06 -0700, Alexandre Passos, 2, 2, 4, LINK)"
27680,2,1135,427,1562,"(30485bb7b905d5c367d23846c5248f8c8d0a2c49, 2019-09-03 13:39:52 -0700, Andrew Audibert, 33, 0, 33, LINK), (e7206a7d8efceda25bce5a530fc4e79a5582be13, 2019-07-30 12:01:13 -0700, Jiri Simsa, 1102, 427, 1529, LINK)"
2769,1,5,5,10,"(f36659f555027481788d14cc388cec1071a3182a, 2016-06-13 18:56:43 -0800, Zongheng Yang, 5, 5, 10, LINK)"
27705,1,66,12,78,"(1b96e5212002b7ac5027a7538a8f6e5780b669f5, 2019-04-30 18:51:29 -0700, Katherine Wu, 66, 12, 78, LINK)"
27711,1,14,0,14,"(4e90c97809c44e6e6395ffd6c34c35ce3d646020, 2019-04-16 17:49:52 -0700, Allen Lavoie, 14, 0, 14, LINK)"
2774,1,22,1,23,"(de6ce1de08ea97d599687fbbe5196ca4af5232ae, 2016-06-13 14:26:47 -0800, Zongheng Yang, 22, 1, 23, LINK)"
27769,1,38,38,76,"(f42549a91a3759a9264ef4d44e9224be4ee3bdc3, 2019-06-20 17:33:04 -0700, Katherine Wu, 38, 38, 76, LINK)"
278,1,40,0,40,"(695c97c3ddf73245ceeb9884eb4bc7d86f44532e, 2018-05-17 14:37:34 -0700, Rachel Lim, 40, 0, 40, LINK)"
27829,1,17,7,24,"(6a6e8c2586dfd2aeeebe0d94d60dcca4604ab481, 2019-06-04 13:50:02 -0700, Scott Zhu, 17, 7, 24, LINK)"
27845,1,25,4,29,"(2518fc3ef8b962b8487b930d9798d4696f0e53ee, 2019-04-22 11:07:13 -0700, Alexandre Passos, 25, 4, 29, LINK)"
27847,1,48,1,49,"(e2d269edb9217411fc4119338df949e1a741432b, 2019-04-29 10:16:59 -0700, Shanqing Cai, 48, 1, 49, LINK)"
27848,1,1,1,2,"(7ae75b2cd126f17fe27d3104d5e5629bf0805251, 2019-04-15 19:25:32 +0000, Yong Tang, 1, 1, 2, REGEX)"
27937,1,201,8,209,"(452d8798fa315df6aa042442273cb298e26c8b71, 2019-04-30 11:57:30 -0700, Allen Lavoie, 201, 8, 209, LINK)"
27985,2,14,1,15,"(04f4037adf6c6af592372f1a9755af6a9872fe13, 2019-04-19 20:43:08 +0100, Pasquale Minervini, 13, 0, 13, LINK), (85ba88c973f3dc108d543cb4b590b9f290bdd310, 2019-04-19 15:50:39 +0100, Pasquale Minervini, 1, 1, 2, LINK)"
28,1,36,70,106,"(23caaa5e42c87a189511438dcadc428b683cd028, 2017-05-22 14:09:29 -0700, Benoit Steiner, 36, 70, 106, LINK)"
280,1,51,43,94,"(6596a600669d2dea9b3204e07e0943db071c42d1, 2019-11-28 01:59:22 -0800, Jose Ignacio Gomez, 51, 43, 94, LINK)"
28007,2,154,15,169,"(eaa1729a52952f2a541491a1ce2c34af7ab66fc8, 2020-03-18 13:03:19 -0700, Eugene Zhulenev, 142, 15, 157, LINK), (7eda6f2b247ad9805fe9d917c841f2b7168f7c72, 2020-03-04 15:40:42 -0800, Saurabh Saxena, 12, 0, 12, LINK)"
28027,1,20,10,30,"(93b440f7935ec889a0e60f10107fc7b9495ee5b0, 2019-04-21 20:24:45 -0700, Anna R, 20, 10, 30, LINK)"
28066,1,49,2,51,"(d7cd03f1398cd33fc8579ce336b602350ac99259, 2019-04-23 16:24:07 -0700, Allen Lavoie, 49, 2, 51, LINK)"
28070,1,35,19,54,"(778ca5c0bcf87c9e2df73fe9b8074bae5b8c3e58, 2019-04-26 15:27:26 -0700, Alexandre Passos, 35, 19, 54, LINK)"
28108,1,19,1,20,"(35c87ab0355af9205e875cc807c673c371b2e58c, 2019-04-24 16:57:19 -0700, Allen Lavoie, 19, 1, 20, LINK)"
28158,1,20,2,22,"(008300cc7667da8f8a7d36806470c01a524153d0, 2019-04-29 11:56:08 -0700, Dan Moldovan, 20, 2, 22, LINK)"
2818,1,16,0,16,"(7f79424f63c5684a43d47de216ae152144ddeecf, 2017-01-24 10:04:24 -0800, Geoffrey Irving, 16, 0, 16, LINK)"
282,1,1,1,2,"(67328cf44fb8f8442c94b7ec80b48854a577a795, 2019-11-29 08:48:22 -0800, JKIsaacLee, 1, 1, 2, LINK)"
28241,1,4,5,9,"(6c3cbe44344e7dfed21872b5effcec4a48f4cff3, 2019-04-30 01:08:19 +0000, Yong Tang, 4, 5, 9, REGEX)"
28346,1,142,20,162,"(e03ab548c4696efcdbe1cca599da1289c25093b4, 2019-07-29 09:51:19 -0700, Guangda Lai, 142, 20, 162, LINK)"
2844,2,14957,3894,18851,"(2098b9abcf20d2c9694055bbfd6997bc00b73578, 2016-10-05 09:55:48 -0700, Yifei Feng, 14953, 3894, 18847, LINK), (781080a6c3b8dc78f665968755787f6782f3811b, 2016-10-03 16:42:25 -0800, Martin Wicke, 4, 0, 4, LINK)"
28444,1,4,4,8,"(eb1fde6216a1fa3b66330ecf07e7b206a2e84df4, 2019-05-07 04:07:15 +0000, Yong Tang, 4, 4, 8, REGEX)"
285,1,18,20,38,"(4554a1b426401a7d2dbefd48767ead408bb41426, 2019-12-04 09:29:51 -0800, Uday Bondhugula, 18, 20, 38, LINK)"
2852,2,276,24,300,"(1bea99abc531bf2ce47c1f6767f4796be7168f02, 2016-06-15 19:18:52 -0800, Lukasz Kaiser, 138, 12, 150, LINK), (1da1f63f2d1a225de7a68eae2d362cc335e65e8d, 2016-06-15 19:18:52 -0800, Lukasz Kaiser, 138, 12, 150, LINK)"
28585,1,1,7,8,"(f0836d2a3bdc83b9487d703f30669723bd2662fb, 2019-05-16 09:41:13 -0700, Jared Duke, 1, 7, 8, LINK)"
28614,1,57,40,97,"(12250556493fe7757bd97f397e3483e7c0e022b1, 2019-05-14 07:43:30 -0700, Scott Zhu, 57, 40, 97, LINK)"
2862,1,0,2,2,"(337b6c1945731b3542d35768078c8ea8640933e8, 2016-08-16 18:19:39 -0800, Justine Tunney, 0, 2, 2, LINK)"
2868,1,13,5,18,"(2491c2c5fba31ed90d70e06f9aa0342dcd6bf09f, 2016-06-15 18:00:36 +0100, Igor Babuschkin, 13, 5, 18, LINK)"
28725,1,76,4,80,"(22ba2ebfc9779ca61e574ddf6411ee5565381cec, 2019-06-13 08:38:04 -0700, Dan Moldovan, 76, 4, 80, LINK)"
2873,3,2332,1972,4304,"(58b37cf745c6c30d44878ddf5987c4283ed12c3c, 2016-08-22 23:15:02 -0700, gunan, 777, 657, 1434, LINK), (857eee77a3abde96e62d97866c1579fe14dd7901, 2016-06-13 01:12:08 -0700, David Z. Chen, 777, 657, 1434, LINK), (353235e0b2b35f3df43f42ef84ca00ccda7a3a6d, 2016-06-13 01:12:08 -0700, David Z. Chen, 778, 658, 1436, LINK)"
28849,1,18,0,18,"(d3dd0726fc2a6be6235bc1e9c8825056278d3470, 2019-07-15 11:09:44 -0700, Dan Moldovan, 18, 0, 18, LINK)"
28959,1,2,1,3,"(0088c64ccfab8dfc4734c293ea979c4ad0173c36, 2019-05-29 11:47:26 +0800, EFanZh, 2, 1, 3, LINK)"
290,1,93,91,184,"(421fbae7753c717337d96bad5fd6cb5d58834e0a, 2019-12-06 05:58:59 -0800, Kazuaki Ishizaki, 93, 91, 184, LINK)"
29060,1,33,34,67,"(003e400902b85626d32727589142d12269306703, 2019-06-11 15:01:17 -0700, Jiri Simsa, 33, 34, 67, LINK)"
29170,1,19,0,19,"(c2b5d665aac09154bea0389fbcae9e2936a2c286, 2019-05-30 13:45:02 -0700, Allen Lavoie, 19, 0, 19, LINK)"
29187,1,31,1,32,"(180f28a26660ca2e1ba27477f4f9592db5f9c4e8, 2019-06-04 08:22:34 -0700, Scott Zhu, 31, 1, 32, LINK)"
29191,1,220,174,394,"(4d4f7ed0a4605975e45efe9ca1750653190aeedf, 2019-08-01 10:10:00 -0700, Dan Moldovan, 220, 174, 394, LINK)"
292,1,221,81,302,"(7e2b4b8c968c85e08e7d78faf4cd3dc36cf3a4ba, 2019-12-05 13:10:10 -0800, Denis Khalikov, 221, 81, 302, LINK)"
29342,1,377,113,490,"(7360531c13113a19120d798278cd20bec2e5e0c3, 2019-07-03 12:00:38 -0700, Xiao Yu, 377, 113, 490, LINK)"
2935,1,39,0,39,"(a62b165dd05adc5f0395170f8e72781bc240cbad, 2016-07-07 21:07:37 -0500, terrytangyuan, 39, 0, 39, LINK)"
2938,1,119,32,151,"(706a5baa6e633ffbbcdf49f69e3ef88421001a76, 2016-06-25 14:45:27 -0800, Derek Murray, 119, 32, 151, LINK)"
29393,1,44,5,49,"(665bd441195ce352b0d5ce74d5fd2dc19fa4a614, 2019-06-17 14:40:58 -0700, Dan Moldovan, 44, 5, 49, LINK)"
294,1,19,11,30,"(6b4dc4e9864d6842049537147da26d5e8850109f, 2019-12-06 16:03:16 -0800, nmostafa, 19, 11, 30, LINK)"
29439,1,5,1,6,"(1e30076f57bf30838b5cb2e59f05e13deb944d1b, 2019-11-11 16:14:06 -0800, Gunhan Gulsoy, 5, 1, 6, LINK)"
295,2,126,16,142,"(d68e1fb784af892cc80b58a3ea1230df2b01658d, 2019-12-16 10:36:06 -0800, Jose Ignacio Gomez, 63, 8, 71, LINK), (d68e1fb784af892cc80b58a3ea1230df2b01658d, 2019-12-16 10:36:06 -0800, Jose Ignacio Gomez, 63, 8, 71, REGEX)"
29501,1,183,85,268,"(b2bdbfb9260fe58d9c5bfe9df11fc51535e5fef3, 2019-06-18 11:53:46 -0700, Shanqing Cai, 183, 85, 268, LINK)"
29509,1,512,0,512,"(f54bb6f5578b931d79884302768996ba1073f685, 2020-01-28 15:29:29 -0800, Haoliang Zhang, 512, 0, 512, LINK)"
29525,1,10,6,16,"(24174643a75e819b8ce01fd70d45d03616e50071, 2019-07-11 16:23:20 -0700, A. Unique TensorFlower, 10, 6, 16, LINK)"
29532,1,12,11,23,"(a7bcf5fdc8557bd6ebde40112b17199f6958dd0e, 2019-06-07 12:44:22 -0700, Mihai Maruseac, 12, 11, 23, LINK)"
29536,1,6,0,6,"(bbdc3fafdb7ec689a0ae0d14eed75660292c447f, 2019-06-07 09:12:32 -0700, Mihai Maruseac, 6, 0, 6, LINK)"
29540,2,2,2,4,"(d1c32c20aa8198638712167dc17020434f123c00, 2019-06-07 13:50:56 -0700, Yifei Feng, 1, 1, 2, LINK), (00f6608a0a73b768cd4a810601293d13e3bc722f, 2019-06-07 13:50:56 -0700, Yifei Feng, 1, 1, 2, LINK)"
29545,2,56,12,68,"(88c1b25380f81a8fa598a7675fb2a8e3f78117c5, 2019-08-14 11:21:35 -0700, Katherine Wu, 28, 6, 34, LINK), (c967e6141bbab229ea8ae2552554ef6a3fc9caf1, 2019-08-14 11:21:35 -0700, Katherine Wu, 28, 6, 34, LINK)"
29549,2,286,146,432,"(c6b4bd510fc8577f7b20669455804fdae08435e4, 2019-06-10 10:11:12 -0700, Scott Zhu, 143, 73, 216, LINK), (b2dfb9bff5b8f603c19e0a8a3f280b7724fb89c1, 2019-06-10 10:11:12 -0700, Scott Zhu, 143, 73, 216, LINK)"
2957,1,60,8,68,"(91d65f6e5971302081a9348c4188a5031c30b021, 2016-06-20 10:08:59 -0800, Derek Murray, 60, 8, 68, LINK)"
29656,1,42,1,43,"(a7ef0da19be94d5f189c8a3af960f1da77e58b41, 2019-06-13 13:52:03 -0700, Alexandre Passos, 42, 1, 43, LINK)"
29661,1,10,0,10,"(704c6eb8a6f766e2d4d2f3b004bc26e9a1d55f36, 2020-04-25 21:59:23 +0000, Yong Tang, 10, 0, 10, REGEX)"
2974,1,99,5,104,"(e57750551e4aecea2ecc7f9339f00ca84997514c, 2016-06-21 20:53:46 -0800, Manjunath Kudlur, 99, 5, 104, LINK)"
29856,1,5,3,8,"(15f6c30d7977c92ba452eb5c1873b8c9f0968a5f, 2019-06-26 17:13:12 -0700, Martin Wicke, 5, 3, 8, LINK)"
29863,1,1,0,1,"(61ce785eede101a3a5e77c5d0fd88507bd5f455f, 2019-06-19 19:56:49 +0000, Yong Tang, 1, 0, 1, REGEX)"
29867,2,30,3,33,"(085160e48ace499de3ea2a58f3a4bd3c8cd07dc8, 2019-06-19 22:36:03 +0000, Yong Tang, 8, 0, 8, REGEX), (9770648bd385639feeaebfbb9b38fb6da9d50914, 2019-06-19 22:33:10 +0000, Yong Tang, 22, 3, 25, REGEX)"
29871,1,6,5,11,"(6c8cbdceccce20f886a08b0cf00ac2e783ac524c, 2019-11-13 09:01:49 -0800, Martin Wicke, 6, 5, 11, LINK)"
29872,1,38,1,39,"(f6e0ec468a3dee7c2ae1fa3575bb46d884b4a319, 2019-07-18 10:05:52 -0700, Rohan Jain, 38, 1, 39, LINK)"
29881,1,10,4,14,"(d7e858192d1de827bc03705ac62e1bd38daf06d8, 2019-06-22 18:19:41 -0700, Martin Wicke, 10, 4, 14, LINK)"
299,1,3,1,4,"(707f8f2c187428449e9989e77f06e7d5fc43ca95, 2019-12-06 06:26:24 -0800, Denis Khalikov, 3, 1, 4, LINK)"
29989,1,11,1,12,"(51d1f486fcbe5bc8857586250fd5b10ca110d631, 2019-07-15 17:15:50 -0700, Jiri Simsa, 11, 1, 12, LINK)"
3,8,40163,8576,48739,"(746817af146e65e1e7ebca3a893cb217a4bec938, 2021-01-05 13:37:31 -0800, Advait Jain, 13, 8, 21, LINK), (6be604aaacd9d270de01c37ec6e9a9a077397848, 2020-08-04 12:26:02 -0700, Jared Duke, 321, 73, 394, LINK), (8234d5a3f8967919d3f55d99cd945fa946f4bfe0, 2019-01-25 17:39:13 -0800, Priya Gupta, 43, 4, 47, LINK), (c8535f36d127a2b2c80241d49546326db5d9a1fd, 2017-09-18 11:14:20 -0700, Joel Hestness, 2869, 1, 2870, LINK), (cf7c008ab150ac8e5edb3ed053d38b2919699796, 2017-06-28 11:07:44 -0700, Yifei Feng, 35256, 8213, 43469, LINK), (3faa4d2d9672fb6f8ba8f80a0df45dabeb5a3382, 2017-06-26 10:16:32 -0700, A. Unique TensorFlower, 2, 0, 2, LINK), (fe589d9e7caea582beed160ad47e55f537a8403e, 2017-05-31 06:15:23 +0100, Luke Iwanski, 1505, 242, 1747, LINK), (4c85b12dfffe371e6a75e39dd08573c88f960558, 2017-03-29 07:36:04 -0800, Alexandre Passos, 154, 35, 189, LINK)"
300,1,60,28,88,"(7d7c61bf37c63b01fff15ae24695cff1d13ae9a4, 2019-12-18 11:27:09 -0800, Marcel Koester, 60, 28, 88, LINK)"
30028,1,82,16,98,"(b789a3b37b59e6795f799645a6e8b1a6c70fc346, 2019-06-28 10:45:07 -0700, Anna R, 82, 16, 98, LINK)"
30029,2,2,0,2,"(50f56d58fbbcc1409d2dafb398d0956c252e6acf, 2019-06-22 15:04:36 -0700, Mihai Maruseac, 1, 0, 1, LINK), (266d85e610d2be38f48b0c61a4c590163cc10b49, 2019-06-22 19:07:40 +0000, Yong Tang, 1, 0, 1, REGEX)"
30040,2,22,0,22,"(322486a18ab52fd25d4230889ddfa1f25bfaaa6e, 2019-06-23 01:57:58 +0000, Yong Tang, 16, 0, 16, REGEX), (467730fe90282a75f15f67d701b278e86cfad65e, 2019-06-23 01:53:59 +0000, Yong Tang, 6, 0, 6, REGEX)"
301,1,18,20,38,"(68fb5ac01c1724b1f117a02114c63bd406a56cc8, 2019-12-06 09:40:12 -0800, Alexandre E. Eichenberger, 18, 20, 38, LINK)"
30113,1,108,3,111,"(7807ec92bf8f44b5fd6de5b5342f041b168cf1f3, 2019-11-22 18:11:56 -0800, Akshay Modi, 108, 3, 111, LINK)"
30122,2,39,1,40,"(49f1a478e0c8eb1311679457c3d648395ab51202, 2019-06-30 10:16:58 +0000, Yong Tang, 37, 0, 37, REGEX), (1b8786471f49d6f13ce237524e694a81ca930957, 2019-06-30 10:06:20 +0000, Yong Tang, 2, 1, 3, REGEX)"
30149,1,4,5,9,"(38df5d8ef43e884674f22670dbfd19ec26782f17, 2019-06-30 10:14:23 -0700, Dan Moldovan, 4, 5, 9, LINK)"
30182,1,138,4,142,"(dd3ec9260259a5dba183f9271f517c06d7c69c82, 2019-07-10 06:47:55 -0700, Dan Moldovan, 138, 4, 142, LINK)"
30184,1,82,16,98,"(b789a3b37b59e6795f799645a6e8b1a6c70fc346, 2019-06-28 10:45:07 -0700, Anna R, 82, 16, 98, LINK)"
30222,3,1021,174,1195,"(061d2e0a0d998623a2b0f191038c0aa918a08027, 2019-12-18 06:43:08 -0800, Jaesung Chung, 119, 16, 135, LINK), (9ac7cf82641fe48b177763dfd2ff7b7844426462, 2019-12-10 17:42:46 -0800, Jaesung Chung, 725, 144, 869, LINK), (df41bbafb50e1ea99404257cf7fa6f60bd063b5f, 2019-12-09 21:23:38 -0800, Jaesung Chung, 177, 14, 191, LINK)"
30248,1,1,0,1,"(3baef3b569344f0af6071950a5fc9d828a4ee6a6, 2019-07-02 02:57:53 -0700, Dan Moldovan, 1, 0, 1, LINK)"
3035,1,39,18,57,"(6c14cd8e1bfbf1484ef22c82ac3badc53ed73f7d, 2016-06-27 12:35:03 -0800, Derek Murray, 39, 18, 57, LINK)"
30378,1,306,92,398,"(a377701899b71b5f6bb0f157be763c283c7ff7e9, 2019-07-18 14:19:55 -0700, Philip Pham, 306, 92, 398, LINK)"
30383,2,29,2,31,"(28dbd440e5195119a5ad72ca7a407e7dbaa33ef3, 2019-08-20 13:41:16 +0800, leslie-fang-intel, 1, 1, 2, REGEX), (7001c1f9ef55f2678a2ff7740778d6856fb8b507, 2019-08-20 07:12:58 +0800, leslie-fang-intel, 28, 1, 29, REGEX)"
304,1,36,36,72,"(27a98ccab4cccce50b0fd2133376c9d7134be639, 2019-12-09 09:23:15 -0800, Kazuaki Ishizaki, 36, 36, 72, LINK)"
30420,1,14,8,22,"(52b8190e149223a50d550ecf87c79f38e8d20643, 2019-07-11 07:47:05 -0700, James Ring, 14, 8, 22, LINK)"
3047,2,27,2,29,"(2392f4d355ee83205afd37f9e7f8602548d05829, 2016-10-27 16:50:53 -0800, Martin Wicke, 8, 0, 8, LINK), (92c8c6969eb8b2378eb6886d9c443f2d6f2f2ba6, 2016-10-27 16:50:53 -0800, Martin Wicke, 19, 2, 21, LINK)"
30474,1,27,0,27,"(37fcf0a0e04b2014864936397c25e6c398135772, 2019-07-12 19:36:44 -0700, Pavithra Vijay, 27, 0, 27, LINK)"
3056,2,162,28,190,"(62156713147b256ee862987578021a29e2ed4c13, 2016-08-03 16:20:46 -0800, Lukasz Kaiser, 33, 0, 33, LINK), (d1f35b4cecd025a943f64b55b1887fa27e552eb1, 2016-07-01 23:38:29 -0800, Lukasz Kaiser, 129, 28, 157, LINK)"
3057,1,54,6,60,"(380e801f9251995122ae09ac11d83bd6a30edefa, 2016-06-27 15:01:58 -0800, Derek Murray, 54, 6, 60, LINK)"
30574,1,51,48,99,"(03ff87bfdeec43b9d3a208746ae19ebf9c139c14, 2019-09-16 11:55:31 -0700, RJ Skerry-Ryan, 51, 48, 99, LINK)"
30580,1,64,37,101,"(471b73c238709fb796929eb412f1dab763b3f8cc, 2019-08-19 14:55:33 -0700, Eugene Zhulenev, 64, 37, 101, LINK)"
30633,2,2,2,4,"(3caff5be33a0ac20a73a2230d28679c9d6a8f6cb, 2019-07-12 10:10:05 -0700, Yong Tang, 1, 1, 2, REGEX), (7efc61175c540a56b03e829ec917ce9efc1f06f9, 2019-07-12 10:10:05 -0700, Yong Tang, 1, 1, 2, REGEX)"
30642,1,11,0,11,"(c3e32b03e187fc2854c34add42ee3d1fe1f17628, 2019-09-13 12:20:10 -0700, Alexandre Passos, 11, 0, 11, LINK)"
30653,1,14,1,15,"(038bace3d62aa96fa280a1159f1375a44f00a705, 2019-07-14 12:08:06 +0200, Ivan Habernal, 14, 1, 15, LINK)"
30685,1,18,1,19,"(6cd69820a7ec68363647bf918d312b5d10e0e07a, 2019-07-23 15:40:22 -0700, Andrew Audibert, 18, 1, 19, LINK)"
30691,1,1,1,2,"(c589417ff81aa59160684fdc84ffac44095ac82e, 2019-07-15 19:52:45 +0800, Leslie-Fang, 1, 1, 2, LINK)"
307,1,86,14,100,"(90d71017d128c1e05db50ef45c728c568641db3a, 2019-12-10 12:25:10 -0800, Jose Ignacio Gomez, 86, 14, 100, LINK)"
3070,1,7,0,7,"(09d236384513e205d1a46a59e3a768ffc91c3d47, 2016-06-30 23:30:41 +0800, Wenjian Huang, 7, 0, 7, LINK)"
30750,2,13,1,14,"(6f0b851fc9dd160b92284b206536c1ae12c504b3, 2019-07-17 00:03:43 +0000, Yong Tang, 10, 0, 10, REGEX), (2b681a72d1e785b3d3cbdc9f3f4fded627665f40, 2019-07-16 23:59:59 +0000, Yong Tang, 3, 1, 4, REGEX)"
308,1,135,14,149,"(d44768972096e4b314a4c237dba092e9b04968bd, 2019-12-09 12:43:23 -0800, Denis Khalikov, 135, 14, 149, LINK)"
30808,2,56,12,68,"(88c1b25380f81a8fa598a7675fb2a8e3f78117c5, 2019-08-14 11:21:35 -0700, Katherine Wu, 28, 6, 34, LINK), (c967e6141bbab229ea8ae2552554ef6a3fc9caf1, 2019-08-14 11:21:35 -0700, Katherine Wu, 28, 6, 34, LINK)"
30849,1,24,10,34,"(7379f75705c49d33860a0dfe58b6a32b78ca6b2d, 2019-07-19 00:38:09 +0000, Yong Tang, 24, 10, 34, REGEX)"
31,2,1452,221,1673,"(f289cfb200417ca6dfcfbd1f59e45a9c08f74327, 2019-06-10 21:30:29 -0700, Mehdi Amini, 1, 0, 1, LINK), (2c8d0dca978a246f54c506aae4587dbce5d3bcf0, 2017-02-21 11:00:19 -0800, Benoit Steiner, 1451, 221, 1672, LINK)"
3102,1,11,8,19,"(6062f26f626555ca980c716d52c6204e17745503, 2016-06-30 10:32:46 -0800, Derek Murray, 11, 8, 19, LINK)"
31137,1,1,1,2,"(264f13ec5b57ec2f2745609748b0b7e4cf7e1ed3, 2019-07-29 14:29:45 -0700, Yong Tang, 1, 1, 2, REGEX)"
312,1,51,0,51,"(3e5e7ffa139a2a11ec182dd3c18baf3b29baee73, 2019-12-12 09:24:43 -0800, Ehsan Toosi, 51, 0, 51, LINK)"
31297,2,24,2,26,"(0e772b8c962cfea507d1fb83c5b0c04d1c835dd9, 2019-08-19 21:54:24 -0700, Saurabh Saxena, 12, 1, 13, LINK), (24d206ce4a6dd06f497d24e8b9700f4dff75e65c, 2019-08-19 21:54:24 -0700, Saurabh Saxena, 12, 1, 13, LINK)"
313,1,3,0,3,"(f94d458f1a6acfc309104e03a6cae5a61bfeecd4, 2019-12-11 11:17:03 -0800, Denis Khalikov, 3, 0, 3, LINK)"
3139,1,1,0,1,"(7c03f6e54d5bd8818a09e693bfb55507648ab03c, 2016-09-17 04:38:55 +0530, Malith Yapa, 1, 0, 1, LINK)"
31494,1,10,1,11,"(f8c22c9308d054868e16898b799f7a329348a6ea, 2019-08-09 16:51:02 -0400, Jun Wan, 10, 1, 11, LINK)"
315,1,63,8,71,"(d68e1fb784af892cc80b58a3ea1230df2b01658d, 2019-12-16 10:36:06 -0800, Jose Ignacio Gomez, 63, 8, 71, LINK)"
3168,1,2,2,4,"(11f92de8c8c9cd35106c0f4dd3b0bfaac7581a2f, 2016-07-13 14:28:07 -0700, Sergey Kishchenko, 2, 2, 4, LINK)"
31696,2,24,1,25,"(66803c1fca4d178d6ba8f4c96073efaed8541d59, 2019-08-18 15:53:36 +0000, Yong Tang, 22, 0, 22, REGEX), (289c4500376bcd50462c9e6b66be019bb9c4c88a, 2019-08-18 04:39:22 +0000, Yong Tang, 2, 1, 3, REGEX)"
31706,2,60,4,64,"(9d8571fd483404518bed604b8221709b85235716, 2019-08-16 17:16:09 -0700, Jiri Simsa, 30, 2, 32, LINK), (c73f7cfe54095a26238b56bf1d94a1fe7bf20df8, 2019-08-16 17:16:09 -0700, Jiri Simsa, 30, 2, 32, LINK)"
31744,1,1,1,2,"(4b08e71a10e71a867aa5569be5ad43081d4185d4, 2019-08-20 06:57:59 -0700, Benoit Jacob, 1, 1, 2, LINK)"
3177,1,2,1,3,"(23fb96fa4914f77e7a517fb68984e5e9a5dccd3b, 2016-07-08 09:15:23 -0800, A. Unique TensorFlower, 2, 1, 3, LINK)"
31893,2,30,12,42,"(4d64a47c3e8f9dc18791f31ba7d4e090f8852030, 2019-08-30 13:09:17 -0700, Katherine Wu, 15, 6, 21, LINK), (93b86cc5ee1c3770e9b99ee4969e380154183e9e, 2019-08-30 13:09:17 -0700, Katherine Wu, 15, 6, 21, LINK)"
31952,1,19,0,19,"(d5ee347de231b55f8ef7c11402db1673ff111d53, 2019-12-02 15:08:31 -0800, Alexandre Passos, 19, 0, 19, LINK)"
320,1,1,1,2,"(50caa985b5db16a52e7288b20aa44d6d5fb8464d, 2019-12-17 10:25:19 -0800, Jin Mingjian, 1, 1, 2, LINK)"
3200,1,2,1,3,"(23fb96fa4914f77e7a517fb68984e5e9a5dccd3b, 2016-07-08 09:15:23 -0800, A. Unique TensorFlower, 2, 1, 3, LINK)"
32029,1,13,8,21,"(3ba8bd697faf4b831f78c3fa547d7956f1b1a0aa, 2020-02-20 14:50:37 -0800, Scott Zhu, 13, 8, 21, LINK)"
32049,1,1,1,2,"(8d4ecb0f24c4f9fc18c248838d2496b8410961f6, 2019-09-04 15:59:43 -0700, Alexandre Passos, 1, 1, 2, LINK)"
32164,1,1,0,1,"(212288dbe8f5d4b60615b06ee0afc6c26a9733cd, 2019-09-03 09:42:59 +0200, Colle, 1, 0, 1, LINK)"
32192,1,33,1,34,"(06094928234856a89bf4b607e2fbc9eca9b2d35f, 2019-09-22 22:08:44 -0700, Abin Shahab, 33, 1, 34, LINK)"
32236,1,3,0,3,"(eed165e3d59903ff844cd682b8be4bffc23b9005, 2020-05-04 15:38:59 +0000, Yong Tang, 3, 0, 3, REGEX)"
32293,1,7,0,7,"(b7db3f4ae43f5228952f3a1bb480a3e52a2006ed, 2019-09-06 11:07:40 -0700, Mihai Maruseac, 7, 0, 7, LINK)"
32299,2,91,15,106,"(1a8aaa30ef54e26e548fe1b97a3415c57c635167, 2019-09-12 16:41:12 -0700, Scott Zhu, 55, 11, 66, LINK), (dccf1c7030867865189924989c857bc1d3454216, 2019-09-11 15:34:07 -0700, Scott Zhu, 36, 4, 40, LINK)"
32311,1,2,0,2,"(b7b3cd283609fd46ed7111a32765b26e71749196, 2019-09-12 18:04:53 +0530, HarikrishnanBalagopal, 2, 0, 2, LINK)"
32369,1,16,3,19,"(0f97bdac0757f934875dc2600ce829022cf6821f, 2019-09-12 09:15:50 -0700, Scott Zhu, 16, 3, 19, LINK)"
32380,1,3,1,4,"(10396ff82a9216a3ce5c5770eefa85bc0a973d38, 2020-05-03 20:22:18 +0000, Yong Tang, 3, 1, 4, REGEX)"
32416,1,4,0,4,"(0d08d8dc0b37019ee90a4b89301a8abfc4451492, 2019-09-11 17:12:56 +0800, Fangjun Kuang, 4, 0, 4, LINK)"
32487,1,177,34,211,"(144e0ebb1c9ede81886e215904a4e4598cd8b0b0, 2019-10-02 15:01:12 -0700, Philip Pham, 177, 34, 211, LINK)"
325,1,15,1,16,"(4f47c0d60f50b1dc4fc678e2939f153b3d78c690, 2019-12-19 12:16:19 -0800, A. Unique TensorFlower, 15, 1, 16, LINK)"
32501,1,20,14,34,"(38b748907e04fb212c1183b4999425d768de0233, 2019-09-17 12:00:15 -0700, Scott Zhu, 20, 14, 34, LINK)"
32543,1,65,38,103,"(2eb6dc0f2e7f5455d368c59c35458709eef03a55, 2019-09-25 11:48:45 -0700, Scott Zhu, 65, 38, 103, LINK)"
32570,1,21,15,36,"(4d011793076f6c62a560085b8fe03fbf732d67e6, 2019-09-25 13:58:00 -0700, Scott Zhu, 21, 15, 36, LINK)"
32586,1,44,3,47,"(df2b252fa380994cd9236cc56b06557bcf12a9d3, 2019-09-17 14:51:06 -0700, Scott Zhu, 44, 3, 47, LINK)"
32612,8,88,43,131,"(edc47aeb71857e1139ab4881288172a548f9ef7d, 2019-12-12 23:13:48 -0500, thierry, 1, 1, 2, LINK), (dcc27a65cf6217d87a8a3eb44002f622945524f3, 2019-12-12 22:51:30 -0500, thierry, 2, 2, 4, LINK), (8a386e14fd93d54c402a00780a278ee6ff54b100, 2019-12-12 22:48:57 -0500, thierry, 0, 1, 1, LINK), (2ac645274cb64dc3cdec8ff61a0403302d302862, 2019-12-12 22:44:12 -0500, thierry, 52, 25, 77, LINK), (3d8d6e47206423569fa4a70da0861f0fd305ecc4, 2019-11-17 18:36:42 -0500, Thierry Herrmann, 4, 0, 4, LINK), (939a02331bb446cdf8a75e1853fe0a5afde90576, 2019-11-12 23:32:01 -0500, Thierry Herrmann, 1, 1, 2, LINK), (66383a14e391fae8f93aad6ee2a3e1b6ada47621, 2019-11-12 23:16:22 -0500, Thierry Herrmann, 25, 10, 35, LINK), (702ed446cc404324dd13670edf2df59eb16cb6e3, 2019-10-11 00:09:52 -0400, Thierry Herrmann, 3, 3, 6, LINK)"
32755,1,3,2,5,"(9b5f9aabd84b0d1db782286143c560792d711449, 2019-10-03 21:33:53 -0700, Reed Wanderman-Milne, 3, 2, 5, LINK)"
3277,1,12,0,12,"(5d5db35ed2e9e90b95ab27f8b37898fd4543457f, 2016-07-12 15:12:36 -0800, A. Unique TensorFlower, 12, 0, 12, LINK)"
33,1,1451,221,1672,"(2c8d0dca978a246f54c506aae4587dbce5d3bcf0, 2017-02-21 11:00:19 -0800, Benoit Steiner, 1451, 221, 1672, LINK)"
33094,1,16,1,17,"(66b9b602af695fddb76c113d823d2fa4d0646c04, 2019-10-25 11:01:02 -0700, Katherine Wu, 16, 1, 17, LINK)"
331,2,16,14,30,"(147a847bb3ca178cb0b25574958637d1b62e7f53, 2020-01-23 17:10:22 -0800, Scott Zhu, 9, 7, 16, LINK), (5e8c497c7088be89befad457f4d5165286e0e203, 2019-12-20 09:43:34 -0800, Uday Bondhugula, 7, 7, 14, LINK)"
33148,1,92,18,110,"(4d582a660b4e84fb283eba598127ae40fdd8d1ed, 2020-07-13 21:17:33 -0700, Scott Zhu, 92, 18, 110, LINK)"
33253,1,12,4,16,"(a6b2ac1f3699921f915e146096bae13e745a544b, 2019-10-12 00:34:53 +0000, Yong Tang, 12, 4, 16, REGEX)"
33365,1,19,0,19,"(2ebc291f6a94163c49fc835d3afc93892e645e45, 2020-03-10 13:34:05 -0700, Reed Wanderman-Milne, 19, 0, 19, LINK)"
33383,2,34,6,40,"(4f5b9455c3fae482e1f0477ff664777778e9da02, 2019-10-31 15:08:00 +0000, Yong Tang, 13, 0, 13, REGEX), (8ad07e25b1bcd8e3b4e241147dd97e073b058941, 2019-10-31 15:05:42 +0000, Yong Tang, 21, 6, 27, REGEX)"
33394,2,10,0,10,"(f8f3e73781f1b9cd468db75473b35badfd861114, 2019-10-16 04:37:49 +0000, Yong Tang, 8, 0, 8, REGEX), (eebc5e7bf8e2113ee5417bbc03f61f4027ec981b, 2019-10-16 04:34:33 +0000, Yong Tang, 2, 0, 2, REGEX)"
33425,1,0,1,1,"(cb9319253d81374e6c9b0dc27c28fe8f5ba2ebb1, 2019-10-28 17:20:59 -0700, Akshay Modi, 0, 1, 1, LINK)"
33470,3,108,2,110,"(21a47c3dd60ccfed0d8b2038d8eed7694051b31d, 2019-11-05 10:25:48 -0800, Advait Jain, 0, 1, 1, LINK), (a9c1810fa1fccfc76bae2c450d12b039b879778c, 2019-10-23 11:05:44 -0700, Advait Jain, 107, 1, 108, LINK), (395c725e893ea6fd83ebb5f4f2242fefda569ee2, 2019-10-22 16:18:18 -0700, Advait Jain, 1, 0, 1, LINK)"
3348,1,326,73,399,"(74d0126d52b5227ff32d7aeba43144b4edb4be4e, 2017-05-15 14:18:46 -0700, A. Unique TensorFlower, 326, 73, 399, LINK)"
33516,2,16,6,22,"(711c179522916542d98347deb77663b864409544, 2019-11-21 10:09:43 -0800, Rachel Lim, 8, 3, 11, LINK), (c8ddf43b38326cae300f5da80ecae9103a7f1b8a, 2019-11-21 10:09:43 -0800, Rachel Lim, 8, 3, 11, LINK)"
33572,1,6,0,6,"(d8668d9e03b65c4a6d9ecb08e74b0b67798fbbab, 2019-11-22 09:15:47 -0800, Suharsh Sivakumar, 6, 0, 6, LINK)"
33614,1,33,9,42,"(dcefbf6db1febfce818a69f73c5513bc9d4a60f4, 2019-10-23 09:45:25 -0700, Scott Zhu, 33, 9, 42, LINK)"
3364,2,15121,4081,19202,"(2098b9abcf20d2c9694055bbfd6997bc00b73578, 2016-10-05 09:55:48 -0700, Yifei Feng, 14953, 3894, 18847, LINK), (d74cc130dd0ce5ecd1421ef126e4446f337a856c, 2016-10-04 07:41:44 -0800, A. Unique TensorFlower, 168, 187, 355, LINK)"
33724,1,134,19,153,"(eba45c548371e29cd141c32d367b582b9ca656be, 2020-01-24 05:01:37 -0800, Dan Moldovan, 134, 19, 153, LINK)"
33776,1,59,54,113,"(91bdf64a8b3778d70213446418b2a3d2d7a04a68, 2020-02-03 15:51:27 -0800, Scott Zhu, 59, 54, 113, LINK)"
33799,1,11,2,13,"(ea3063c929c69f738bf65bc99dad1159803e772f, 2019-11-03 19:52:04 +0000, Yong Tang, 11, 2, 13, REGEX)"
33852,1,6,1,7,"(f6a40276a1eaa472b25e87a6371310bc80e3fb56, 2019-10-31 17:14:59 -0700, Yifei Feng, 6, 1, 7, LINK)"
3388,1,8,1,9,"(90d964f3382faf30d291aa3fbdb509844e1f042a, 2017-03-15 16:19:56 -0800, Derek Murray, 8, 1, 9, LINK)"
33888,1,19,1,20,"(0e884391beabe2fadb6398b1fc5f48a9662c333c, 2020-01-28 15:48:35 -0800, A. Unique TensorFlower, 19, 1, 20, LINK)"
3389,1,54,49,103,"(d2e8a32971bfea647f1c703840ef9a09f728b3f2, 2018-02-16 09:26:14 -0800, Mark Daoust, 54, 49, 103, LINK)"
34020,1,8,0,8,"(53d244502fe0de438c939438d00e86f0409b2cb5, 2019-11-07 14:59:54 -0800, Andrew Audibert, 8, 0, 8, LINK)"
34055,1,17,7,24,"(7cea9a4edfd181771da97db944e89551b62195ce, 2019-11-18 16:49:06 -0800, Scott Zhu, 17, 7, 24, LINK)"
34082,2,126,38,164,"(eb7b125276ee8569cbb80b7fb3a7e75c49729677, 2019-11-12 02:00:24 -0800, sunway513, 124, 36, 160, LINK), (5b5c562241b4fa54c40d25ed2db5baf44c0fcf91, 2019-11-12 02:00:24 -0800, A. Unique TensorFlower, 2, 2, 4, LINK)"
34124,1,20,11,31,"(5006295cf7a20de9ef9087127569e9d58b28022d, 2019-11-11 23:28:14 +0530, Kaustubh Maske Patil, 20, 11, 31, LINK)"
34297,1,110,0,110,"(75af7b4750cd757cd82b32896eb98414e1b38898, 2019-11-21 14:24:05 -0800, Dan Moldovan, 110, 0, 110, LINK)"
34348,1,37,9,46,"(fdadd0e5e524df6488cd763c4ab7595d469ed1ef, 2019-11-18 23:04:25 +0530, nikochiko, 37, 9, 46, LINK)"
34363,3,83,0,83,"(426869b50f88fb3efccaa3553ec86ba1eedb6aa6, 2020-05-27 12:53:50 -0700, A. Unique TensorFlower, 14, 0, 14, LINK), (426869b50f88fb3efccaa3553ec86ba1eedb6aa6, 2020-05-27 12:53:50 -0700, A. Unique TensorFlower, 14, 0, 14, REGEX), (da3c1f4b01bc417d50adc2d0979b603baf859e44, 2020-04-14 16:15:29 +0000, Yong Tang, 55, 0, 55, REGEX)"
34701,1,7,4,11,"(c16614ef36b990ce9633e25aa00467ea4ce85844, 2019-12-02 10:50:10 -0800, Jared Duke, 7, 4, 11, LINK)"
34789,1,23,2,25,"(48b920246f9f06a645a9b864c39171c5b0c2c4ef, 2020-01-07 17:20:09 -0800, Scott Zhu, 23, 2, 25, LINK)"
34873,1,1,0,1,"(f48446d6d301d261f4fa7d73baa80e593e965abf, 2019-12-11 15:27:39 -0800, Juhyun Lee, 1, 0, 1, LINK)"
34905,3,87,15,102,"(5d28926aba5c40f6d6e9c7034c1f631b3e2cdcac, 2019-12-11 09:06:59 +0100, Milan Straka, 29, 5, 34, LINK), (846714eb4ec1a78b3ea2485ba1a0094c9363026b, 2019-12-11 09:06:59 +0100, Milan Straka, 29, 5, 34, LINK), (e08ae8459886595aafeec694a49fa8fd4bd23025, 2019-12-11 09:06:59 +0100, Milan Straka, 29, 5, 34, LINK)"
34907,2,6,2,8,"(c97b2206163ec6fda0eac77ef26b095be0d0651d, 2019-12-11 08:40:37 +0100, Milan Straka, 3, 1, 4, LINK), (f835a4a795f733e8b46d351ffc979df178ed584d, 2019-12-11 08:40:37 +0100, Milan Straka, 3, 1, 4, LINK)"
35,1,1451,221,1672,"(2c8d0dca978a246f54c506aae4587dbce5d3bcf0, 2017-02-21 11:00:19 -0800, Benoit Steiner, 1451, 221, 1672, LINK)"
35027,1,26,0,26,"(71d7f39d9c3667bd76bbc4d3e3d644b299ea8dc0, 2020-08-19 18:10:55 -0700, Reed Wanderman-Milne, 26, 0, 26, LINK)"
35100,1,18,22,40,"(b6edd34c5858ab0ab4380da774e7e2fd81a92da0, 2019-12-19 16:17:49 -0800, Jiri Simsa, 18, 22, 40, LINK)"
35115,1,104,76,180,"(57826bf39de534860fe7aa8316fccaecacd5aba0, 2019-12-19 12:44:39 -0800, Austin Anderson, 104, 76, 180, LINK)"
35117,1,9,1,10,"(7813cb00f35d6fc6d8ad8421021c1535f3e8c029, 2019-12-14 17:08:18 -0700, Stephan Uphoff, 9, 1, 10, LINK)"
35121,1,45,12,57,"(f757bda2e6ae7aec6d72c185a9efc35a352a30e9, 2019-12-19 19:28:16 -0700, Stephan Uphoff, 45, 12, 57, LINK)"
35306,1,35,68,103,"(74c9e141067c804bb9a5f94df9342d270cc01f75, 2020-02-19 16:05:05 -0800, Scott Zhu, 35, 68, 103, LINK)"
35335,1,106,4,110,"(c4ec9389364cb8d1bff451ab8baf55d25cabdd1f, 2020-01-23 10:32:43 -0800, Jiri Simsa, 106, 4, 110, LINK)"
35364,2,60,15,75,"(596afe01b74ed8775ee10a4550e8c0b8b985894b, 2019-12-26 15:43:47 -0800, Austin Anderson, 57, 15, 72, LINK), (bfe0d85ea045a32b628c7674bc47dc02bee16e48, 2019-12-26 14:23:17 -0800, Austin Anderson, 3, 0, 3, LINK)"
35379,1,18,2,20,"(cd6184047e9e497955c473b88387b54818ff23a0, 2019-12-26 17:54:56 -0800, Reed Wanderman-Milne, 18, 2, 20, LINK)"
35430,2,6,1,7,"(30b9cd8b6061bc36ad8f67cb872c690f37339680, 2020-01-19 15:06:43 +0000, Yong Tang, 5, 0, 5, REGEX), (42b4b376f5f184cd0ab52b25255808f70e321a1f, 2020-01-19 15:04:42 +0000, Yong Tang, 1, 1, 2, REGEX)"
35442,1,35,26,61,"(e0aa80f5f64db9b408d2b28bce85d71ed82633f7, 2020-01-31 15:57:39 -0800, Ran Chen, 35, 26, 61, LINK)"
35547,1,6,6,12,"(3ff0960fee4927db7baea2f354e60c3328b066fe, 2020-01-03 12:32:49 -0800, Frank Chen, 6, 6, 12, LINK)"
35551,1,25,8,33,"(e8f6431f53f49f8cab7e15bef24ab2ee775f2ed9, 2020-01-07 16:43:57 -0800, Haoliang Zhang, 25, 8, 33, LINK)"
35683,1,2,0,2,"(6ae8094917a6e10cc0f698e3bdae00b30d86f62f, 2020-01-10 13:27:53 -0800, Artem Mavrin, 2, 0, 2, LINK)"
357,1,1016,298,1314,"(a4806a3fba7c00bea3e7022477339b2d09539751, 2015-12-03 10:26:25 -0800, Vijay Vasudevan, 1016, 298, 1314, LINK)"
35710,2,19,7,26,"(5097ebda4743297518f2384cced64ea03920f70c, 2020-01-13 15:49:31 +0000, Yong Tang, 5, 0, 5, REGEX), (8515bcd85ebba9fa129530d9ed64d1c31c7d7153, 2020-01-13 15:47:14 +0000, Yong Tang, 14, 7, 21, REGEX)"
35731,1,59,54,113,"(91bdf64a8b3778d70213446418b2a3d2d7a04a68, 2020-02-03 15:51:27 -0800, Scott Zhu, 59, 54, 113, LINK)"
35765,1,31,0,31,"(8e3adf77b2a148fb2c6fea8fea2d0217bca3339f, 2020-01-20 05:39:12 -0800, Dan Moldovan, 31, 0, 31, LINK)"
358,1,4661,3026,7687,"(795f35da2d458cbae477ac2fe2bff80c1427a771, 2015-12-01 13:26:53 -0800, Vijay Vasudevan, 4661, 3026, 7687, LINK)"
35817,1,186,88,274,"(f9e899854cc96db28564fa65f22d32a647268fc1, 2020-01-27 16:23:55 -0800, Reed Wanderman-Milne, 186, 88, 274, LINK)"
35874,2,130,29,159,"(a66d4828f39268ebb178cf579a36dc8e8b0f967d, 2020-02-18 10:58:27 -0800, George Karpenkov, 114, 22, 136, LINK), (ad526e38168afe1097191014a7ea045ee62bc767, 2020-02-12 18:43:23 -0800, George Karpenkov, 16, 7, 23, LINK)"
35883,1,186,88,274,"(f9e899854cc96db28564fa65f22d32a647268fc1, 2020-01-27 16:23:55 -0800, Reed Wanderman-Milne, 186, 88, 274, LINK)"
35938,1,8,1,9,"(b398e5bf6d216f76e8e5fd09ff96caf45c80e943, 2020-01-17 01:03:26 +0000, Yong Tang, 8, 1, 9, REGEX)"
35955,1,7,5,12,"(6ab77f3be330714746054eb678c9c4116f300692, 2020-01-17 00:13:26 +0000, Yong Tang, 7, 5, 12, REGEX)"
35980,1,45,13,58,"(75286a79e7cdf9fdc27b15919f453786eee8936d, 2020-01-28 11:06:50 -0800, Igor Ganichev, 45, 13, 58, LINK)"
36067,1,40,38,78,"(0a57a64a022a180abf7a95584a9570e9f126c42e, 2020-01-20 10:34:18 -0800, Eugene Brevdo, 40, 38, 78, LINK)"
36146,2,11,5,16,"(a3e5597e9ef78a198a09b7c99d3ee7ea904a8fc1, 2020-04-06 14:42:03 -0500, Tony Tonev, 5, 4, 9, LINK), (ec1788baa37f3c691a7f425f0ac14edda99e7d51, 2020-04-06 12:12:15 -0500, Tony Tonev, 6, 1, 7, LINK)"
36198,1,19,3,22,"(bb2e09ad7207c504296962192fa5f1b7ec53a659, 2020-12-03 10:49:20 -0800, Reed Wanderman-Milne, 19, 3, 22, LINK)"
36236,1,22,1,23,"(b0e08f68d84476b941e8a821d653ab08129c92ce, 2020-06-05 12:53:08 +0200, Milan Straka, 22, 1, 23, LINK)"
36259,1,24,0,24,"(76ce154bb5358222934aac16a4c56a36a964f92e, 2020-03-30 16:11:27 -0700, Scott Zhu, 24, 0, 24, LINK)"
3626,1,46,32,78,"(645a554a41ef5524e7ec65beeb7976c066886da6, 2016-09-11 10:03:45 -0800, Shanqing Cai, 46, 32, 78, LINK)"
36268,1,191,17,208,"(11fc1489d01822a2e728103c3af998976b4e7cd1, 2020-09-30 12:49:03 -0700, Shanqing Cai, 191, 17, 208, LINK)"
36363,5,51,38,89,"(4a37d3fecd759f2e8a02f917f4256f9089cd44f4, 2020-05-19 19:49:43 -0700, Scott Zhu, 17, 4, 21, LINK), (40218a75747cd0246665b3edfeaba76719c34d59, 2020-04-08 20:36:26 -0700, A. Unique TensorFlower, 3, 14, 17, LINK), (8b2e09d7dc15831dec55dc63f3173e45e9b10d83, 2020-04-08 19:45:54 -0700, Scott Zhu, 14, 3, 17, LINK), (7404928316e7c415d53d5b3d601bd5cce6e1c45f, 2020-04-07 21:27:39 -0700, A. Unique TensorFlower, 3, 14, 17, LINK), (052461853bf023bc42aaa470694a0db4ce01ec34, 2020-04-07 20:15:05 -0700, Scott Zhu, 14, 3, 17, LINK)"
3639,1,5,3,8,"(579438b835aafc377bba01ef6c50beca896a56bb, 2016-08-11 18:59:33 -0800, Benoit Steiner, 5, 3, 8, LINK)"
36394,1,67,2,69,"(7bfbd3f7be0725ee9c220047fe85032cf126d92b, 2020-05-21 15:05:37 -0700, Mihai Maruseac, 67, 2, 69, LINK)"
36462,1,24,11,35,"(a962580295172539a3a6ae5b02836aac1cabf100, 2020-02-27 18:14:26 -0800, Dan Moldovan, 24, 11, 35, LINK)"
36525,1,138,31,169,"(07d7624b1a76afe8e2ec4b44d75ec035062943e4, 2020-02-26 20:34:20 -0800, A. Unique TensorFlower, 138, 31, 169, LINK)"
36533,1,1,0,1,"(42b80a5229a01394c23b8aac32aa2f345044f640, 2020-02-07 12:37:02 +0100, exfalso, 1, 0, 1, LINK)"
36554,1,8,6,14,"(eff141826d2617cba02cda842fc09eabde65a43c, 2020-02-11 10:24:37 -0800, Vishnuvardhan Janapati, 8, 6, 14, LINK)"
366,1,715,273,988,"(fa095c5db0ac9cfe2328a19b32ae208e58e3746a, 2015-12-02 09:12:45 -0800, Manjunath Kudlur, 715, 273, 988, LINK)"
36624,1,20,25,45,"(619ca02f2d9ff61aedf7de6e6b43116e859f6913, 2020-02-14 16:06:18 -0800, Scott Zhu, 20, 25, 45, LINK)"
36700,1,10,6,16,"(35a382295ad81f7080d306c9b09b0edaa451fcfc, 2020-03-25 10:55:17 -0700, Martin Wicke, 10, 6, 16, LINK)"
36721,2,38,47,85,"(469e56eeff17eb857c95e935ca7b49723c43470e, 2020-02-13 13:05:46 -0800, Mihai Maruseac, 15, 23, 38, LINK), (6737d443fd27fe3c0fdf27914706d934b25124dc, 2020-02-13 09:08:46 -0800, Mihai Maruseac, 23, 24, 47, LINK)"
3677,1,1,0,1,"(ce0bbb9fef8c47b95715029288a3504de4a0b7fe, 2016-08-11 20:17:24 -0500, Yuan Terry Tang, 1, 0, 1, LINK)"
36790,1,2,2,4,"(a744818876ab362ad4112b625f40b2a0dbdafb12, 2020-05-03 22:36:08 +0000, Yong Tang, 2, 2, 4, REGEX)"
36792,2,85,53,138,"(50433098af6951f8559e2cb5f5bcf25d2c7eb922, 2020-04-03 08:29:41 -0700, Dan Moldovan, 4, 2, 6, LINK), (a0f63991647908b3e258c594bcfba9d15b8c16a0, 2020-03-27 11:09:26 -0700, Dan Moldovan, 81, 51, 132, LINK)"
36991,1,8,0,8,"(f3f5afbe7bf3499e8735df0655344e7dc7ae554e, 2020-02-26 10:38:36 +0000, Janosh Riebesell, 8, 0, 8, LINK)"
37,1,120,1,121,"(afb324dfe8f4aa5e350de90116b6106242dc8164, 2015-12-18 14:43:28 -0800, Illia Polosukhin, 120, 1, 121, LINK)"
370,1,4661,3026,7687,"(795f35da2d458cbae477ac2fe2bff80c1427a771, 2015-12-01 13:26:53 -0800, Vijay Vasudevan, 4661, 3026, 7687, LINK)"
3721,1,127,47,174,"(5247ebbe24465563bdd4ef46f1cecc34f256f76b, 2016-09-09 14:33:39 -0800, Sergio Guadarrama, 127, 47, 174, LINK)"
37230,1,23,2,25,"(cf09044d9e7b232080f95f0f910a6803904df1de, 2020-03-30 16:18:46 -0700, Saurabh Saxena, 23, 2, 25, LINK)"
37307,1,116,100,216,"(eaaf5b6b432b819e929f736c90133ceca5e7443d, 2020-05-05 19:43:01 -0700, Anudhyan Boral, 116, 100, 216, LINK)"
3731,1,6,2,8,"(96b0d83aa0170ca1dbf7369c7b24326a0d5c80ac, 2016-08-11 12:18:56 -0800, Geoffrey Irving, 6, 2, 8, LINK)"
3743,1,3,0,3,"(9024250ee45924317d1df734760951d7e23ce92a, 2016-09-14 18:50:56 -0700, Gustav Larsson, 3, 0, 3, LINK)"
37440,3,346,182,528,"(7961a2441f0a9559e11c74197e68173444962b51, 2020-05-04 15:41:43 -0700, Tomer Kaftan, 170, 6, 176, LINK), (580b03a12c50df594d693bda032fdfb40b8a186b, 2020-05-01 20:28:00 -0700, A. Unique TensorFlower, 6, 170, 176, LINK), (d6d97887484b77f97bb7b7c44d7de39d2110186a, 2020-05-01 19:55:30 -0700, Tomer Kaftan, 170, 6, 176, LINK)"
3752,3,1174,261,1435,"(5ce2567953b3bde1665e82a75bebf35066111b2c, 2016-08-12 09:19:52 -0800, Manjunath Kudlur, 78, 13, 91, LINK), (4be49d4d8a91a071d01eeba28ab543782a746d26, 2016-08-12 18:50:15 -0700, Benoit Steiner, 1018, 235, 1253, LINK), (20a869a79b04eebd930b9085e32927b46fabd149, 2016-08-12 09:19:52 -0800, Manjunath Kudlur, 78, 13, 91, LINK)"
37638,1,2,2,4,"(8f8c86ffeff30434c17e897e23458c6c32c17a1b, 2020-04-01 20:00:21 +0000, Yong Tang, 2, 2, 4, REGEX)"
37640,1,85,32,117,"(081c7d5add2f084aabe71c2d4da1e0de6a780ac6, 2020-04-22 08:21:44 -0700, Mark Daoust, 85, 32, 117, LINK)"
37758,2,52,20,72,"(a7e2a238a10d3c1e5b548392dec3a63c406f9334, 2020-03-25 17:46:09 -0700, Mihai Maruseac, 26, 10, 36, LINK), (56f4edbb5a78ae9d29d797f39e107a28c9bcf6e5, 2020-03-25 17:46:09 -0700, Mihai Maruseac, 26, 10, 36, LINK)"
37765,4,18,2,20,"(a7bca909f2925ab5181807a92312125be7297ef3, 2020-03-27 19:01:29 -0700, Reed Wanderman-Milne, 3, 0, 3, LINK), (0603c3d171260008dbd6baa72a7eed4e1d87e42f, 2020-03-27 19:01:29 -0700, Reed Wanderman-Milne, 3, 0, 3, LINK), (77e6258f9296c885d5dea4106f2bb891a5f778c6, 2020-03-25 12:46:52 -0700, Reed Wanderman-Milne, 6, 1, 7, LINK), (bcfc1ba6798ced6889f579644c2c79515832d098, 2020-03-25 12:46:52 -0700, Reed Wanderman-Milne, 6, 1, 7, LINK)"
37777,1,3,0,3,"(f61175812426009a4c96e51befb2951612990903, 2020-03-26 11:21:13 -0700, A. Unique TensorFlower, 3, 0, 3, LINK)"
37840,2,17,2,19,"(b5f5af4c9d9d32fd35624ab0ee79b031851613b0, 2020-03-31 12:54:23 -0700, Scott Zhu, 14, 0, 14, LINK), (01e84d7cc214dbf5a7a21bc418ad43afb5694fbc, 2020-03-31 09:27:33 -0700, Scott Zhu, 3, 2, 5, LINK)"
37871,1,8,1,9,"(bda5ba03da606b0d41fa3282de0108c3e98cff8e, 2020-04-01 00:49:40 -0700, Karim Nosir, 8, 1, 9, LINK)"
379,1,4661,3026,7687,"(795f35da2d458cbae477ac2fe2bff80c1427a771, 2015-12-01 13:26:53 -0800, Vijay Vasudevan, 4661, 3026, 7687, LINK)"
37983,1,184,9,193,"(95ea3404528afcb1a74dd5f0946ea8d17beda28b, 2020-04-11 16:27:22 -0700, Dan Moldovan, 184, 9, 193, LINK)"
38041,1,1,1,2,"(a05bb5559f80ef1401bada468414e30161845713, 2020-08-28 04:12:06 +0200, Ongun Kanat, 1, 1, 2, LINK)"
38042,2,10,0,10,"(8d60b700f25933850e6c92ce224b9b8dfb3c58cf, 2020-04-03 17:26:13 -0700, Eugene Brevdo, 5, 0, 5, LINK), (e483e7f29c1994b349ae8abff3986b75abe6e2ef, 2020-04-03 17:26:13 -0700, Eugene Brevdo, 5, 0, 5, LINK)"
38172,1,3,0,3,"(1b522964a8eb24a827bf67b17d7d7fd227e0cf31, 2020-04-03 20:39:59 +0000, Yong Tang, 3, 0, 3, REGEX)"
38349,1,15,0,15,"(d6c0858665de6036de24991b29d74b182cfcf5ae, 2020-07-25 09:28:01 +0200, codeadmin_peritiae, 15, 0, 15, LINK)"
38403,1,37,4,41,"(60b167181081c14ff88c77ae62049cab8a5ba4c7, 2020-04-14 10:09:56 -0700, Scott Zhu, 37, 4, 41, LINK)"
38459,1,5,10,15,"(3cfba9571bcc4be237bfdfa3498c66073ae59280, 2020-06-08 11:32:43 -0700, Scott Zhu, 5, 10, 15, LINK)"
38516,1,1,1,2,"(2730e4b0bcba80799ddc10f52081927848540f30, 2020-04-15 13:38:36 -0700, Reed Wanderman-Milne, 1, 1, 2, LINK)"
38640,1,3,0,3,"(3db8df8ffafe5bcd83a12b92bc4c8287cd80237f, 2020-04-27 12:58:38 -0700, A. Unique TensorFlower, 3, 0, 3, LINK)"
38694,1,4,2,6,"(24c75ce5016efb4ab107f27b96aac07549d8617b, 2020-05-14 22:18:50 -0700, Hye Soo Yang, 4, 2, 6, LINK)"
38893,1,43,14,57,"(bd1422f12ed2beadf30476c59262c5216e67e67a, 2020-04-28 11:55:34 -0700, Allen Lavoie, 43, 14, 57, LINK)"
38906,1,23,3,26,"(80a93674eafc224a45cbe96c65e993e9735634a3, 2020-06-04 09:37:28 -0700, Eugene Zhulenev, 23, 3, 26, LINK)"
38932,1,2,0,2,"(85c637969a25228065a276044691dab020984361, 2020-05-21 15:16:46 -0700, Karim Nosir, 2, 0, 2, LINK)"
39,1,1,0,1,"(10961e7aed1b29468c660ab4e4a30712417cb73a, 2015-12-17 18:33:36 -0800, Illia Polosukhin, 1, 0, 1, LINK)"
39004,1,1,0,1,"(edf5029353c452a5599dd02e95adee5657cd5599, 2020-05-03 16:28:29 +0000, Yong Tang, 1, 0, 1, REGEX)"
39019,1,2,2,4,"(7a7a8b4c87943d371c76e712cd24eb55c83ea5b4, 2020-04-29 14:49:56 +0000, Yong Tang, 2, 2, 4, REGEX)"
39075,1,20,3,23,"(3e6697b916c9e775dc61375b913d21ba9d22126f, 2020-05-05 12:02:04 -0700, Allen Lavoie, 20, 3, 23, LINK)"
391,1,715,273,988,"(fa095c5db0ac9cfe2328a19b32ae208e58e3746a, 2015-12-02 09:12:45 -0800, Manjunath Kudlur, 715, 273, 988, LINK)"
39136,1,18,0,18,"(e4281619f160dae0e04fc71c634da609c11ec52e, 2020-05-04 02:57:56 +0000, Yong Tang, 18, 0, 18, REGEX)"
39186,1,22,9,31,"(79acb0824b8bbb1fb887d2ff625f2f170d80fe1f, 2020-05-07 16:51:02 -0700, Rachel Lim, 22, 9, 31, LINK)"
39229,1,13,0,13,"(0ee6b3a69da0f17d14d40e34b7008651012638da, 2020-05-06 22:29:23 +0000, Yong Tang, 13, 0, 13, REGEX)"
3932,1,22,4,26,"(3b7153de39732170cc5abd01b0e051bf98e066eb, 2016-08-22 08:37:38 -0800, Vijay Vasudevan, 22, 4, 26, LINK)"
3933,1,6,2,8,"(308e34fbd1277ad38dd4c7d10d3aef2712b3d4b8, 2016-08-23 09:27:27 -0800, Olivia Nordquist, 6, 2, 8, LINK)"
39462,1,2,2,4,"(b3461c38fd09abc6f31f69ade9bc632fabbdb73a, 2020-05-20 14:04:54 -0400, Ben Arnao, 2, 2, 4, LINK)"
39475,1,12,1,13,"(4e9b6b454e1d057513ac477b2cd65f5925f91cc8, 2020-05-13 01:29:03 +0000, Yong Tang, 12, 1, 13, REGEX)"
3956,1,3,3,6,"(8cb0558da924e891aa1bb5d79a6c0c846301e4eb, 2016-09-02 12:23:26 -1000, jpangburn, 3, 3, 6, LINK)"
3957,1,9,7,16,"(182fef1b55640906637e4bf0d205e508c24549e7, 2016-09-01 20:03:58 -0800, Geoffrey Irving, 9, 7, 16, LINK)"
396,1,2784,1274,4058,"(f9d3e9d03c69bfac77a2fe1ad80f7c5aa517e0f0, 2015-12-06 14:53:28 -0800, Vijay Vasudevan, 2784, 1274, 4058, LINK)"
39696,1,4,4,8,"(2b2b680ed3ba12b79909f630dacaf3d9333b1429, 2020-05-20 16:58:13 +0000, Yong Tang, 4, 4, 8, REGEX)"
39718,1,122,34,156,"(268a0ea1502532e0e127e71d0ad42cc4e8ad81c6, 2020-06-05 12:02:39 -0700, Suharsh Sivakumar, 122, 34, 156, LINK)"
39749,1,17,10,27,"(838341539843b1b972f9a8bbb3afa2d2288a6c63, 2020-05-29 10:08:56 -0700, Juhyun Lee, 17, 10, 27, LINK)"
39756,1,1,1,2,"(f9fb66cdb7419d2eadf7faea995f1aacb032104b, 2020-05-28 17:27:56 -0700, YoungSeok Yoon, 1, 1, 2, LINK)"
3978,2,270,102,372,"(17d0e46e6cc31af0bcf6e80ff4c5670d233b4940, 2016-08-26 11:09:52 -0700, Derek Murray, 135, 51, 186, LINK), (b04c9f48ce69377a1172fd58e8ab210b435f359e, 2016-08-24 19:35:47 -0800, Derek Murray, 135, 51, 186, LINK)"
39815,1,16,3,19,"(7738aca0dcf9f2d2d27b7c3bb1b17c0fb41bbb10, 2020-05-23 22:56:38 +0000, Yong Tang, 16, 3, 19, REGEX)"
39832,2,427,211,638,"(f621c6502097c062a1130fc0b3a1f4122d706dd4, 2020-07-07 06:34:49 -0700, Dan Moldovan, 390, 199, 589, LINK), (e13ff2da43ab00dba94dd00d87a876b2a03f48e7, 2020-07-06 07:31:00 -0700, Dan Moldovan, 37, 12, 49, LINK)"
3985,1,2,2,4,"(3ccdb2b695586201cde65e079806c5941ae542b6, 2016-10-31 09:15:24 -0700, David Z. Chen, 2, 2, 4, LINK)"
39872,3,71,40,111,"(b8bb250ebb52d4f037975f58cb1eadb2eff3751c, 2020-06-18 10:59:05 -0700, George Karpenkov, 34, 3, 37, LINK), (ba658404f279df1b2c86ade146fbdccffcf68f8f, 2020-06-15 11:10:33 -0700, George Karpenkov, 3, 34, 37, LINK), (ef47bbbd57cba8fcc7ae11df8c7141d6c68ba0d0, 2020-06-09 21:59:35 -0700, George Karpenkov, 34, 3, 37, LINK)"
399,1,66,19,85,"(bdcb349ed01d9444ac2bbdc61a47b34a5c3ccc4a, 2018-09-27 07:43:44 -0700, Chris Lattner, 66, 19, 85, LINK)"
3994,1,43,5,48,"(7e7dff529fd35edea443580d58e95f5de39b5356, 2016-09-08 07:25:26 +0800, Jingtian Peng, 43, 5, 48, LINK)"
3996,3,8,7,15,"(673f6cb46d2d03a44147c441a8c4a978105c659a, 2017-12-28 02:58:24 +0100, Robin Richtsfeld, 3, 1, 4, LINK), (f1582cf82f06810900ee99870f5d5d3a7478d044, 2017-12-04 16:13:58 +0100, Robin Richtsfeld, 1, 5, 6, LINK), (8a3107801d15bf8af36221ff5bca0b94bf44d6d3, 2016-08-23 21:58:57 -0700, Derek Murray, 4, 1, 5, LINK)"
39976,1,2,2,4,"(25213f58c433d3712931b4071d2498bb67f8c2ca, 2020-06-01 12:15:28 -0700, A. Unique TensorFlower, 2, 2, 4, LINK)"
39978,1,60,9,69,"(3ab25c320300b6c2e9f78fb08db4d15334bf2603, 2020-06-01 21:52:21 -0700, Scott Zhu, 60, 9, 69, LINK)"
4,2,35258,8213,43471,"(cf7c008ab150ac8e5edb3ed053d38b2919699796, 2017-06-28 11:07:44 -0700, Yifei Feng, 35256, 8213, 43469, LINK), (3faa4d2d9672fb6f8ba8f80a0df45dabeb5a3382, 2017-06-26 10:16:32 -0700, A. Unique TensorFlower, 2, 0, 2, LINK)"
40,3,240,17,257,"(d1a2d09981774455a4eee75fcde65f3e554b7faa, 2019-07-22 17:41:38 -0700, Uday Bondhugula, 104, 12, 116, LINK), (0655342040635311ba9221da6ab2b8e6a8ec7f32, 2015-12-18 19:17:29 -0800, Illia Polosukhin, 101, 0, 101, LINK), (7306490b87eef23ae7d393bbf9c2f6dc4cfdde7a, 2015-12-18 17:01:54 -0800, Illia Polosukhin, 35, 5, 40, LINK)"
4002,2,65,47,112,"(761e6de4357786bee049e63e227b03d57f18bab0, 2016-08-25 11:35:11 -0700, Vijay Vasudevan, 36, 24, 60, LINK), (77d37ddde43b03bda29764885a8da0ed80ed5cfd, 2016-08-25 07:45:54 -0700, David Z. Chen, 29, 23, 52, LINK)"
40204,1,28,0,28,"(b0375e267c55ae97e65b50ce51200e012ac3e8ad, 2020-06-06 01:24:20 +0000, Yong Tang, 28, 0, 28, REGEX)"
40328,1,28,2,30,"(47582983cb1064b5bb81233db4f0adeeaa10b74d, 2020-06-18 10:30:56 -0700, Scott Zhu, 28, 2, 30, LINK)"
404,3,3,3,6,"(8e590dba8b25ab9b7c24fa254eabe00b8e71ff1a, 2017-07-24 21:55:56 +0900, lewuathe, 1, 1, 2, REGEX), (d30efdbaa2b80bf4eb8db9e0b94501fdbd4107d8, 2017-07-24 21:55:56 +0900, lewuathe, 1, 1, 2, REGEX), (679bb02274de245c3ce00d2229081010c656dc3c, 2017-06-30 22:54:13 +0200, Kevin van der Burgt, 1, 1, 2, REGEX)"
40462,2,2,2,4,"(2e7f0f4f0491fae7ac9c4d0893b87820f8a00fad, 2020-06-20 20:32:38 -0700, A. Unique TensorFlower, 1, 1, 2, LINK), (a70ad66828f198f4f495c3f29445b396045b6c3f, 2020-06-19 16:23:33 -0700, A. Unique TensorFlower, 1, 1, 2, LINK)"
40471,1,18,1,19,"(83f19c6a9e84fc6971ad0a7df5874603237a595f, 2020-06-15 17:16:56 +0000, Yong Tang, 18, 1, 19, REGEX)"
405,1,652,216,868,"(cd53f3c3302c9312c1840389a9988a879b8b9dd5, 2015-12-07 15:48:00 -0800, Vijay Vasudevan, 652, 216, 868, LINK)"
40504,1,14,4,18,"(b80105402991b0e19db1bc50c42055a53023ba1c, 2020-10-27 16:14:16 -0700, Jaesung Chung, 14, 4, 18, LINK)"
40577,1,2,0,2,"(9616883b82ee81b4b03faafb219d5aa23c275ca8, 2020-06-18 16:17:52 +0000, Yong Tang, 2, 0, 2, REGEX)"
4058,1,38,17,55,"(4c49dbebef05442c7e72d6129a30574fcd13f0e1, 2016-08-27 22:37:49 -0700, David Z. Chen, 38, 17, 55, LINK)"
40580,1,61,7,68,"(7eed107f52cde76a44a0e1f66896d259af1051bf, 2020-06-19 22:55:27 +0000, Yong Tang, 61, 7, 68, REGEX)"
40633,1,10,1,11,"(5da215da086da25561afb6059ad52ac8c1cc7e98, 2020-06-20 15:10:30 +0000, Yong Tang, 10, 1, 11, REGEX)"
40638,2,164,4,168,"(7d310df2deb9925eb6c5fb2113e4b7b724f6eb2c, 2020-07-16 13:54:22 -0700, Tomer Kaftan, 82, 2, 84, LINK), (ba134e5995a38456718ccdcdc3df07a7d8be7d27, 2020-07-16 13:54:22 -0700, Tomer Kaftan, 82, 2, 84, LINK)"
40653,1,14,0,14,"(cc7e68b611392174c95e13fa8efa9d7bd21832df, 2020-06-22 23:14:18 +0000, Yong Tang, 14, 0, 14, REGEX)"
4071,1,37,19,56,"(93ebfca89051d3b9c94e346786f3a9b51c3ec762, 2016-08-31 13:40:51 -0800, Derek Murray, 37, 19, 56, LINK)"
40839,1,127,36,163,"(0859ec0386ffa55739cbe831f38942c53027c12f, 2020-07-06 10:43:06 -0700, Hye Soo Yang, 127, 36, 163, LINK)"
4084,1,17,1,18,"(c35e69c56941d79163dc9f054f57c199b1a4cc44, 2016-08-31 16:22:04 -0800, Derek Murray, 17, 1, 18, LINK)"
40895,1,30,1,31,"(3d1f1b062dafc5cea4561d0a48538c60aef5aa5e, 2020-10-30 17:09:40 -0700, Allen Lavoie, 30, 1, 31, LINK)"
41,2,2,2,4,"(da247af90f695f552dccb15caa59d5ee6a4bbbcc, 2019-07-30 11:54:29 -0700, Jacques Pienaar, 1, 1, 2, LINK), (7614eb2ce26f40f7ad5b54c1cb29308293f2f87e, 2019-07-30 11:54:29 -0700, Jacques Pienaar, 1, 1, 2, LINK)"
4103,1,1,1,2,"(0e9542ee48aa53d62975d67150ad4de6d7f67914, 2016-09-09 16:47:40 -0700, Martin Wicke, 1, 1, 2, LINK)"
4105,1,47,7,54,"(4316aeb4cb3f7867cf40f74020bd5d12f72d9f0f, 2016-09-21 12:50:41 -0700, David Z. Chen, 47, 7, 54, LINK)"
411,1,817,215,1032,"(27259353e50e6bcaeeedbc26dc3aaaa5695fe500, 2015-12-09 17:40:18 -0800, Vijay Vasudevan, 817, 215, 1032, LINK)"
41113,2,182,176,358,"(83870cb25fa07fac8900aa9da7ecc7823f15cbcf, 2020-07-27 21:58:46 -0700, Ayush Dubey, 135, 135, 270, LINK), (600b4f145b9a3fcc2d6295fa10c4dce766b6c136, 2020-07-15 13:27:14 -0700, Ayush Dubey, 47, 41, 88, LINK)"
4116,2,66,40,106,"(f41daaa2d1c4c89424a688c8735c5f7fc58df4fd, 2016-10-16 15:42:47 -0800, Shanqing Cai, 33, 20, 53, LINK), (8a724211a9d4871338afe874276abf1d358f799b, 2016-10-16 15:42:47 -0800, Shanqing Cai, 33, 20, 53, LINK)"
4117,2,66,40,106,"(f41daaa2d1c4c89424a688c8735c5f7fc58df4fd, 2016-10-16 15:42:47 -0800, Shanqing Cai, 33, 20, 53, LINK), (8a724211a9d4871338afe874276abf1d358f799b, 2016-10-16 15:42:47 -0800, Shanqing Cai, 33, 20, 53, LINK)"
4122,1,1,1,2,"(7df9c6860e00b91eda0e550b11d9be52d9341d85, 2016-09-17 01:53:18 -0500, Andrew Thomas, 1, 1, 2, LINK)"
413,1,29,6,35,"(d45ed5c9387e64be8d35a41bcaa7f752f6f3eba5, 2016-01-14 07:30:07 -0800, Martin Wicke, 29, 6, 35, LINK)"
4131,1,5,8,13,"(fadc1f3c869c15b1890221bb6dfb0f7bd0f7c23d, 2016-09-02 15:05:07 -0800, Benoit Steiner, 5, 8, 13, LINK)"
41370,1,34,4,38,"(3acb88ed27b589449648b680c56c004b5ae9db86, 2020-07-14 18:47:03 +0000, Yong Tang, 34, 4, 38, REGEX)"
4149,1,3,3,6,"(8cb0558da924e891aa1bb5d79a6c0c846301e4eb, 2016-09-02 12:23:26 -1000, jpangburn, 3, 3, 6, LINK)"
41504,1,11,1,12,"(bcbe3dc2bb8d88d35c99d9ad02fa516e1e6af962, 2020-07-17 22:08:18 +0000, Yong Tang, 11, 1, 12, REGEX)"
41549,1,260,13,273,"(3741a7bda7131f7ba26c840d9906a5824bbbc3c3, 2020-12-28 02:49:10 -0800, Hye Soo Yang, 260, 13, 273, LINK)"
41630,2,10,4,14,"(7a4f86d215f12fc1e055e2d762e460db85107d7d, 2020-07-28 20:41:54 +0200, Alexandre Lissy, 5, 2, 7, LINK), (9442cbb955147567792c37ace0090f7ae9df8360, 2020-07-28 20:41:54 +0200, Alexandre Lissy, 5, 2, 7, LINK)"
41674,1,14,12,26,"(dd918be82cb9702cc9ca022179629fbd8c6d3ed9, 2020-07-24 17:07:04 -0700, Nat Jeffries, 14, 12, 26, LINK)"
42,3,1507,227,1734,"(2c8d0dca978a246f54c506aae4587dbce5d3bcf0, 2017-02-21 11:00:19 -0800, Benoit Steiner, 1451, 221, 1672, LINK), (881265ff80209710b2f064a98e2b7bc4608bbf64, 2015-12-20 19:46:09 -0800, Illia Polosukhin, 43, 0, 43, LINK), (2461edeae4a6cefc4e521d7aed8f4b62e85a763b, 2015-12-20 19:07:04 -0800, Illia Polosukhin, 13, 6, 19, LINK)"
42001,1,11,2,13,"(766dec30b45ad1fb3a801413222d24a2c0173665, 2020-08-05 23:36:52 +0000, Yong Tang, 11, 2, 13, REGEX)"
42105,3,30,5,35,"(e64379525429165faf34b52063919401f9283827, 2020-10-20 16:27:25 -0700, Mihai Maruseac, 6, 0, 6, LINK), (eccb7ec454e6617738554a255d77f08e60ee0808, 2020-10-19 17:56:36 -0700, Mihai Maruseac, 20, 0, 20, LINK), (12a806e96866296b154134b27ef4228f39f403cc, 2020-08-08 19:12:31 -0700, A. Unique TensorFlower, 4, 5, 9, LINK)"
42129,2,31,0,31,"(e64379525429165faf34b52063919401f9283827, 2020-10-20 16:27:25 -0700, Mihai Maruseac, 6, 0, 6, LINK), (3ade2efec2e90c6237de32a19680caaa3ebc2845, 2020-08-08 00:47:35 +0000, Yong Tang, 25, 0, 25, REGEX)"
42193,1,32,4,36,"(e4fe575ea367f06e31898adf7fb5b62cbd22240d, 2020-08-18 15:02:44 -0700, Scott Zhu, 32, 4, 36, LINK)"
42217,1,1,1,2,"(916bd91c2bc1ded18ca460520e922a71c3033418, 2020-08-11 21:18:44 -0700, A. Unique TensorFlower, 1, 1, 2, LINK)"
42248,1,6,1,7,"(bf9a705387b76ff9b58d89c71448dac5bd6b5092, 2020-08-13 19:11:53 +0000, Yong Tang, 6, 1, 7, REGEX)"
4226,1,46,7,53,"(b00e940445a03dd5edbe47ff34762ec8ff4087fb, 2016-11-01 11:15:37 -0800, Illia Polosukhin, 46, 7, 53, LINK)"
42281,1,68,4,72,"(7bd42cf6ba061ba7c06c072c9d962abe331461eb, 2020-10-26 17:12:19 -0700, Rohan Jain, 68, 4, 72, LINK)"
42329,2,15,1,16,"(7170d8e8468568ae100e925741e59b7270b009ce, 2020-08-15 19:12:31 +0000, Yong Tang, 6, 1, 7, REGEX), (0824c3e1b6671d641d495ff736d83dd8bd53ad96, 2020-08-15 19:05:06 +0000, Yong Tang, 9, 0, 9, REGEX)"
42331,1,1,0,1,"(35c2a97ddca6da7d5a21d5ee3e2869eec68299f9, 2020-08-21 11:55:02 -0700, A. Unique TensorFlower, 1, 0, 1, LINK)"
42364,1,48,6,54,"(532966cad34471bded2b0483737e8e8d23bc4720, 2020-09-01 14:42:52 -0700, Frank Chen, 48, 6, 54, LINK)"
42386,1,6,0,6,"(f25125e50bab365642335413356466883bf7f361, 2021-01-03 11:09:16 -0800, A. Unique TensorFlower, 6, 0, 6, LINK)"
424,1,1,0,1,"(090cb450e25f14942e70c53d0d82ea8f9d164d57, 2018-11-05 15:30:04 -0800, Bhavani Subramanian, 1, 0, 1, LINK)"
42481,1,4,1,5,"(57b009e31e59bd1a7ae85ef8c0232ed86c9b71db, 2020-08-22 08:35:54 -0400, Peter Sobot, 4, 1, 5, LINK)"
42500,1,12,0,12,"(113555fab7c1a607991b41cdf3974f5f8e0873ea, 2020-08-23 01:30:31 -0700, drebain, 12, 0, 12, LINK)"
42504,1,0,3,3,"(47afb26c2d28991eeebea9c404da499c2a9c8148, 2020-08-25 19:32:38 -0700, Terry Heo, 0, 3, 3, LINK)"
42522,2,18,18,36,"(f7639d3a3257e0a99dd7cafbd1db8b9d9402de3f, 2020-09-18 16:54:41 -0700, Allen Lavoie, 15, 3, 18, LINK), (151800d58a1909d3d4ffc7a44804706252399d5e, 2020-09-17 00:45:35 -0700, A. Unique TensorFlower, 3, 15, 18, LINK)"
42597,6,31,7,38,"(a8b5e782415c200d9536f943254122633b190e8c, 2020-09-24 17:04:36 +0800, yuanbopeng, 13, 1, 14, LINK), (8a773b71258e627ee51bee30b017c27d790a1b3f, 2020-09-14 13:55:39 +0800, yuanbopeng, 10, 3, 13, LINK), (3e4222c02e2aff4a0ff8997a55455d304b6c28c3, 2020-09-02 10:12:50 +0800, yuanbopeng, 1, 1, 2, LINK), (43641031eaf781fb12c8c18d1bc320bd9108de62, 2020-09-01 21:52:26 +0800, yuanbopeng, 1, 1, 2, LINK), (bdf940adf6eb2e0eff1655dfaae3eab36580fac6, 2020-09-01 21:38:40 +0800, yuanbopeng, 1, 1, 2, LINK), (316c4d68cdb79c6b11d9662907ec8afdbd0432e2, 2020-09-01 20:14:36 +0800, yuanbopeng, 5, 0, 5, LINK)"
4261,2,38,6,44,"(103f89a10888a749c24593bffae188dda320cfc8, 2016-09-07 18:59:28 -0700, David Z. Chen, 19, 3, 22, LINK), (ddd1f1677fb7b7ffdd5f029b86a5baf7f2a1558c, 2016-09-07 18:59:28 -0700, David Z. Chen, 19, 3, 22, LINK)"
42627,1,4,7,11,"(e82addaf775118306dd7c3cb6b6d0fb26ae130c1, 2020-08-24 15:01:16 -0700, A. Unique TensorFlower, 4, 7, 11, LINK)"
42704,1,1,1,2,"(8a23ae3d60357eb3d46f92f5f6d7ec0434834953, 2020-08-27 14:33:57 +0200, Martin Hwasser, 1, 1, 2, LINK)"
42748,2,44,13,57,"(170e2be33d2ffd98c7007ed11a40b544261141a3, 2020-09-23 12:41:00 +0200, Felix Johnny, 15, 4, 19, LINK), (b18a353b7819c4049e70c6b77594221df1563fe7, 2020-08-31 10:50:36 +0200, Jan Jongboom, 29, 9, 38, LINK)"
4279,2,35258,8214,43472,"(cf7c008ab150ac8e5edb3ed053d38b2919699796, 2017-06-28 11:07:44 -0700, Yifei Feng, 35256, 8213, 43469, LINK), (5a25cba3423060cfff038a4e42606c74d44b6663, 2017-06-21 13:54:27 -0700, Andrew Selle, 2, 1, 3, LINK)"
42832,1,7,1,8,"(c9e3bda585d5acb8c458d4f2417815e31f4ad883, 2020-09-02 16:37:42 -0700, Advait Jain, 7, 1, 8, LINK)"
42909,1,5,3,8,"(734ac4e9ab98a784e02b3278cdf80e2b758e64da, 2020-09-03 19:20:36 +0000, Yong Tang, 5, 3, 8, REGEX)"
42951,2,119,125,244,"(47aa064459a5efd94ab714d1543930b173069455, 2020-09-23 09:47:54 +0200, Felix Johnny, 117, 125, 242, LINK), (b1b5be5bd97fadd8fe77dbb25db448339e45fd7f, 2020-09-23 10:27:10 +0200, Felix Johnny, 2, 0, 2, LINK)"
43,1,57,4,61,"(8f4ef469af1850cd8d7cca824d94ec71d0510376, 2015-12-20 11:16:17 -0800, Illia Polosukhin, 57, 4, 61, LINK)"
43043,3,61,33,94,"(9a02380d42369f6d3780235d24ab165c862c64d6, 2020-12-14 20:05:57 -0800, Allen Lavoie, 29, 1, 30, LINK), (3c81a306067d8148a6e37ccb51b9836766932796, 2020-12-14 11:06:49 -0800, A. Unique TensorFlower, 3, 29, 32, LINK), (4b05947bf188786ff7f09b46fbc286d6a885e36b, 2020-12-14 08:45:36 -0800, Allen Lavoie, 29, 3, 32, LINK)"
43076,1,24,18,42,"(88ba6c1fbd481169343f0f92f63aa3efdd99a52a, 2020-09-09 05:51:06 -0700, Advait Jain, 24, 18, 42, LINK)"
4308,1,32,22,54,"(4d241449aeb3707143c64e1be106cc6828a0d7b0, 2016-09-09 15:42:52 -0800, Derek Murray, 32, 22, 54, LINK)"
4312,1,4,28,32,"(f66b491a06627510c1cf751fc11db2caf5aa1f25, 2016-09-12 22:58:44 -0800, A. Unique TensorFlower, 4, 28, 32, LINK)"
43126,1,28,20,48,"(80d89bc7c9e883f4523b282fd6875926ae9010be, 2020-09-11 13:56:29 -0700, Advait Jain, 28, 20, 48, LINK)"
4330,1,0,34,34,"(1822073137e1ac431250ea6f89b2719aac8d4782, 2017-04-07 14:17:02 -0700, Vijay Vasudevan, 0, 34, 34, LINK)"
43449,1,48,0,48,"(79fce11a6cc8c3d9fd85e9a04b596fd4ea4d7b79, 2020-09-22 18:19:53 -0700, Allen Lavoie, 48, 0, 48, LINK)"
43475,1,2,0,2,"(b1b5be5bd97fadd8fe77dbb25db448339e45fd7f, 2020-09-23 10:27:10 +0200, Felix Johnny, 2, 0, 2, LINK)"
43529,1,5,0,5,"(8dbab4f830b2f77199c22e7c1763bea8e523079b, 2020-09-24 18:23:35 -0700, Jaesung Chung, 5, 0, 5, LINK)"
43561,1,7,4,11,"(aa59c42debb5146da4f9192321c92fe06eaec35d, 2020-09-26 00:25:19 +0800, Hollow Man, 7, 4, 11, LINK)"
43653,1,5,0,5,"(3b0672c24b134f9eb7549cc4cefcb23c773295cd, 2020-10-02 18:15:44 -0700, A. Unique TensorFlower, 5, 0, 5, LINK)"
43781,1,0,1,1,"(1831af3c012643a5d61012bf71b653e075dcfd22, 2020-10-05 16:41:23 -0700, Jaesung Chung, 0, 1, 1, LINK)"
43789,3,39,42,81,"(79614a9262d07855b0c2154bfaf0ab8d93f92aa2, 2020-10-14 12:22:25 -0700, A. Unique TensorFlower, 12, 15, 27, LINK), (72028307fdd8b00559ed631a409c9237ff0c24b8, 2020-10-13 14:05:57 -0700, A. Unique TensorFlower, 15, 12, 27, LINK), (4a08a202298065781ba4462a8713cb623e6b0547, 2020-10-13 10:47:30 -0700, A. Unique TensorFlower, 12, 15, 27, LINK)"
43813,1,6,4,10,"(172b97d429c87351e15002ce0443fe1c40bb5ff9, 2020-10-06 13:59:03 -0700, Frank Chen, 6, 4, 10, LINK)"
43816,1,31,7,38,"(5a8b0d3e80cef5ffba362d747a0f449c90862b5d, 2020-11-30 10:29:31 -0800, Scott Zhu, 31, 7, 38, LINK)"
43817,2,2,2,4,"(1fd4a4655b4f59773ee2509e9fbbb7797fc5f5b7, 2020-10-07 13:00:25 -0700, Brian Patton, 1, 1, 2, LINK), (8146610552259c345d75db623517fa58ed7916cc, 2020-10-06 18:39:33 -0700, A. Unique TensorFlower, 1, 1, 2, LINK)"
43824,1,63,10,73,"(62d414ba034ae82f863b4f8c91bdb463426feae0, 2020-10-08 14:34:57 -0700, Tomer Kaftan, 63, 10, 73, LINK)"
43887,1,15,11,26,"(e4828fe68d9d8348259607010b1c23350004b576, 2020-10-20 22:49:39 -0700, Advait Jain, 15, 11, 26, LINK)"
43898,1,45,47,92,"(2a8152031aab72ec496a80a3f822c74af312354e, 2020-11-03 11:29:17 -0800, Advait Jain, 45, 47, 92, LINK)"
43978,1,36,10,46,"(ab9b5f5b05aba06b7fbd69a1dc2493bf866b0215, 2020-10-19 18:05:28 -0700, Reed Wanderman-Milne, 36, 10, 46, LINK)"
44,2,1809,240,2049,"(b31675bbff6f8274752e64f59c478d534fd91307, 2019-07-12 06:14:53 -0700, Denis Khalikov, 358, 19, 377, LINK), (2c8d0dca978a246f54c506aae4587dbce5d3bcf0, 2017-02-21 11:00:19 -0800, Benoit Steiner, 1451, 221, 1672, LINK)"
44011,1,138,80,218,"(1ce28a3f8a7670eda543176c7fe3a78b5db11a1e, 2020-12-15 16:54:01 -0800, Allen Lavoie, 138, 80, 218, LINK)"
4424,1,0,3,3,"(d2c2d134dfc3e31f6d1296576f76e9abd4fc6c1c, 2016-09-23 12:55:06 -0800, Vijay Vasudevan, 0, 3, 3, LINK)"
4425,1,14,0,14,"(9bff346137aa1c627f2dccb77fdda10863456b45, 2016-10-11 08:29:18 -0800, Benoit Steiner, 14, 0, 14, LINK)"
44278,1,72,20,92,"(cbc7f31b7d6aac81158be084201d3b3e8e346907, 2020-11-03 11:41:58 -0800, Andrew Audibert, 72, 20, 92, LINK)"
44502,5,476,351,827,"(4f2a50496df5907a33e82c452c91e365ce841c91, 2020-11-19 09:21:40 -0800, Allen Lavoie, 160, 35, 195, LINK), (a01917bcfacbb25a8b0af09d81bdcc92d58ab3b7, 2020-11-16 19:19:48 -0800, A. Unique TensorFlower, 33, 125, 158, LINK), (cd24d3f0ec0f5802629ac94ea8651b30621727ef, 2020-11-16 16:13:20 -0800, Allen Lavoie, 125, 33, 158, LINK), (bf0c564860c7d1dfde2a536ff534aefe891afeff, 2020-11-16 14:10:26 -0800, A. Unique TensorFlower, 33, 125, 158, LINK), (cd95ce5edab5a30912da94412575c32b4ee663c1, 2020-11-16 12:26:23 -0800, Allen Lavoie, 125, 33, 158, LINK)"
44520,2,74,2,76,"(9b87db80e0992c99b52166b560ed23670af720ef, 2020-12-03 17:19:02 -0800, Terry Heo, 37, 1, 38, LINK), (e7e56b2650ab9eb2d4245bdaf86d4861ad75f5af, 2020-12-03 17:19:02 -0800, Terry Heo, 37, 1, 38, LINK)"
44646,1,100,1,101,"(8f68aad1107df679843da96a990773e9fc30201c, 2020-11-19 16:13:09 -0800, Scott Zhu, 100, 1, 101, LINK)"
447,1,48,8,56,"(15f32d93a48fa78f7f2f17c0a46f5625637c82aa, 2017-05-10 12:31:10 -0700, Vijay Vasudevan, 48, 8, 56, LINK)"
44768,2,18,4,22,"(eff07b8226691714cca14cf2827f817baca92f7b, 2020-11-11 12:37:55 -0800, Ran Chen, 9, 2, 11, LINK), (659aca25dabfabdf66f51182aee8f94eae8f78cc, 2020-11-11 12:37:55 -0800, Ran Chen, 9, 2, 11, LINK)"
449,1,109,31,140,"(5de908567355337fdebd997fb5c60993cbe9ba2e, 2015-12-08 16:11:23 -0800, Vijay Vasudevan, 109, 31, 140, LINK)"
4492,1,2,0,2,"(3584eba95fe886dd3cea851e82c77e53e376931f, 2016-09-20 09:45:49 -0800, Vijay Vasudevan, 2, 0, 2, LINK)"
44983,1,15,23,38,"(b6be9714e878a7dd0d1405bd7a83e021ba4b561a, 2020-12-20 13:11:02 -0800, Hye Soo Yang, 15, 23, 38, LINK)"
45,1,7,7,14,"(83ff81bfd9d382852d0302ab2a234feb2e938fc7, 2019-07-13 05:55:25 -0700, Masaki Kozuki, 7, 7, 14, LINK)"
45054,1,50,7,57,"(8438d59abbd7a2c3d1c48bfd91b118aae53bbb14, 2021-01-07 12:11:14 -0800, Scott Zhu, 50, 7, 57, LINK)"
4514,1,2,2,4,"(a5f8f42cb29d890650c4ca5fac6654884856a8e1, 2016-09-21 12:54:46 -0700, Vijay Vasudevan, 2, 2, 4, LINK)"
4516,1,4,0,4,"(922fe29b37efe127e4a8b4344ed02b3edb0173d4, 2017-06-14 20:45:30 -0700, Andrew Selle, 4, 0, 4, LINK)"
45195,1,58,2,60,"(077fe29d9d1f2149dd8c74bcd2f99de7b5fd1506, 2020-12-03 15:35:02 -0800, Jaesung Chung, 58, 2, 60, LINK)"
45300,4,16,16,32,"(cdb400a3aa465bfc7b1fb7b6686b7734e641d1c3, 2020-12-02 13:08:20 -0800, Geeta Chavan, 4, 4, 8, LINK), (852bbc996e50391eb8dcdfd0b58cbe3e90e9782b, 2020-12-02 13:08:20 -0800, Geeta Chavan, 4, 4, 8, LINK), (9b4b05875a2fb4922ff5d6bec57232247102648b, 2020-12-01 17:18:28 -0800, Geeta Chavan, 4, 4, 8, LINK), (06f65877333618af29e50ae0dd279ebc85f34f42, 2020-12-01 17:18:28 -0800, Geeta Chavan, 4, 4, 8, LINK)"
45315,1,4,0,4,"(a2350d3cad4bb93044f4d876f0597642762fe14f, 2020-12-01 15:28:53 -0800, Advait Jain, 4, 0, 4, LINK)"
45392,2,25,0,25,"(f137ea2a23ac1e171224a16d59efc060ea06a616, 2020-12-14 23:12:56 +0000, Yong Tang, 12, 0, 12, REGEX), (0666d8bb711b41c9f03dec238d7d165bc946fc70, 2020-12-14 23:11:16 +0000, Yong Tang, 13, 0, 13, REGEX)"
45492,1,11,0,11,"(7d7e3953d4cc1435a102e2dd192b9d6c30536dcf, 2020-12-08 12:02:02 -0800, Advait Jain, 11, 0, 11, LINK)"
45536,2,162,42,204,"(ef97e90d60046ed9f50ac632f87301a4a73c47f2, 2020-12-14 20:06:07 -0800, Reed Wanderman-Milne, 81, 21, 102, LINK), (ab80014d88857d143238071e58b0c81e708431f0, 2020-12-14 20:06:07 -0800, Reed Wanderman-Milne, 81, 21, 102, LINK)"
45662,1,3,1,4,"(671c78343c3427858bd5674baab80c3c8c429815, 2021-01-05 14:11:22 -0800, Allen Lavoie, 3, 1, 4, LINK)"
45665,1,0,2,2,"(4ed0453e335527c12b6a5769867af20fd09af914, 2020-12-09 22:38:54 -0600, Ryan Kuester, 0, 2, 2, LINK)"
4588,1,8,2,10,"(996ea134da6b672e603d215ba3137140ae36cb90, 2016-10-06 10:28:24 -0800, Eugene Brevdo, 8, 2, 10, LINK)"
45894,1,16,1,17,"(59f5abfbc8dc5559c361f80f4fa4a006db825e40, 2020-12-28 13:03:29 -0800, Andrew Audibert, 16, 1, 17, LINK)"
4595,1,24,24,48,"(c51a29a43a7c2b4a7bab39282b01b46bfceac498, 2016-09-27 09:31:56 -0800, Asim Shankar, 24, 24, 48, LINK)"
45975,1,9,0,9,"(73c5ff37f15e385eb3541089b183a3a66907842d, 2020-12-28 13:53:11 +0000, Yong Tang, 9, 0, 9, REGEX)"
46020,1,147,31,178,"(c5ce162da8efb465e2ba8a8825049614813892a9, 2021-01-05 22:54:09 -0800, Advait Jain, 147, 31, 178, LINK)"
46064,1,17,1,18,"(1a99f30ec75c9a851af3ddde8eb954d9c6920af3, 2021-01-10 19:07:11 +0000, Yong Tang, 17, 1, 18, REGEX)"
46148,1,1,1,2,"(12c3d683af1d5d7bd4e0e0e8e5c5d67f93e99f6d, 2021-01-04 13:01:23 -0600, Ryan Kuester, 1, 1, 2, LINK)"
46186,1,13,8,21,"(746817af146e65e1e7ebca3a893cb217a4bec938, 2021-01-05 13:37:31 -0800, Advait Jain, 13, 8, 21, LINK)"
46261,1,4,2,6,"(90866e40723dbdfd9091109331fe8ec292081063, 2021-01-07 15:22:21 -0800, Advait Jain, 4, 2, 6, LINK)"
4628,1,2,2,4,"(510ed21e3dbb81aee8e31318990dff21163086d5, 2016-09-29 15:42:37 -0800, Zongheng Yang, 2, 2, 4, LINK)"
46297,2,72,11,83,"(1a324f5c7249fbff56ed0b488d3cb20379a35d92, 2021-01-08 11:46:58 -0800, Advait Jain, 72, 9, 81, LINK), (0a342ee36b2627c2ce5d3d1bb4103191dd8d7711, 2021-01-07 15:21:02 -0600, Ryan Kuester, 0, 2, 2, LINK)"
46347,1,44,15,59,"(892bbc9797710e78cede18ba4baae3c4185ea2a9, 2021-01-11 11:53:27 -0800, Advait Jain, 44, 15, 59, LINK)"
4640,1,0,5,5,"(78faf868e3a8ee5a2123f1736b0b6983b1776d1c, 2016-11-18 21:14:49 +0300, Vladislav Gubarev, 0, 5, 5, LINK)"
46423,1,30,10,40,"(f12082d7af509e9549d8e8fb2b514ccd0db0e84e, 2021-01-14 18:43:36 -0800, Jaesung Chung, 30, 10, 40, LINK)"
46465,2,842,12,854,"(fdfe9ee81d841dfddc0df23a9c2779ac404610ca, 2021-01-15 11:40:55 -0800, Advait Jain, 842, 11, 853, LINK), (d2460be38bd655520dd16a0a64096e0161d52331, 2021-01-15 15:51:07 -0800, Advait Jain, 0, 1, 1, LINK)"
4662,1,26,9,35,"(9c4b2f5df01987f94db72396f5dd59b363524d3d, 2016-10-04 15:55:13 -0700, David Z. Chen, 26, 9, 35, LINK)"
4668,1,210,28,238,"(434794582e79e2d98d984a00a5779a712a34e885, 2016-12-01 11:59:22 -0800, A. Unique TensorFlower, 210, 28, 238, LINK)"
4673,1,40,27,67,"(8acc9eb46e9b2aa88d90dac77f37cfc98a4a739c, 2016-10-06 12:28:12 -0800, A. Unique TensorFlower, 40, 27, 67, LINK)"
469,1,1,0,1,"(2a128fcaa6eb2771428f300c728db4db647b5927, 2016-01-16 12:05:52 +0800, Yi-Lin Juang, 1, 0, 1, LINK)"
47,1,5,1,6,"(35862b95ffeab2d0d741f0489ae5dcf51436c713, 2015-12-22 10:05:15 -0800, Illia Polosukhin, 5, 1, 6, LINK)"
471,1,5,4,9,"(475edf8e949e9913e74d2f4b183f271198ecda86, 2015-12-10 15:10:51 -0800, Vijay Vasudevan, 5, 4, 9, LINK)"
4715,1,213,1,214,"(b718fd6ad8cebc470fcc7e53bb6902168edd5587, 2016-10-11 09:54:32 -0800, A. Unique TensorFlower, 213, 1, 214, LINK)"
4727,1,5,6,11,"(4b553d2325bef388fdbae4a868189c6c7e7cbf57, 2017-03-22 09:45:43 -0700, Yong Tang, 5, 6, 11, LINK)"
4737,1,45,1,46,"(2775130b04db48bb74c8399b05f6602aa7a88f13, 2016-10-22 13:24:24 +0800, 郭同jet · 耐心, 45, 1, 46, REGEX)"
4746,1,7719,2403,10122,"(98f0e1efec45ed56ef9045f6f1443998bc0d2da1, 2017-08-11 08:36:21 -0700, Yong Tang, 1289, 343, 1632, REGEX)"
4782,1,17,1,18,"(aa5e959b8908e79e21cc9b545ceea74477abb6a3, 2016-10-07 18:08:06 +0800, Haosdent Huang, 17, 1, 18, LINK)"
4798,1,4,2,6,"(77c8a03c3b398a95cd01ef3a1c7f5bed4935432b, 2016-10-06 18:44:42 +0100, Derek Murray, 4, 2, 6, LINK)"
480,1,2,2,4,"(391a5a4adf439785979914e112021ea96f237da9, 2015-12-23 11:59:21 -0800, Vijay Vasudevan, 2, 2, 4, LINK)"
4844,1,8,7,15,"(57566b58e1ff3ce81f853e59f43a99bdf931259c, 2016-10-12 16:47:56 -0800, Justine Tunney, 8, 7, 15, LINK)"
4861,1,4,0,4,"(7c79d528f43c69b6719da0c7846cd3aa56df57ef, 2016-10-13 13:47:54 -0800, Justine Tunney, 4, 0, 4, LINK)"
49,2,78,30,108,"(d18653005c8ff077492b541538538de0b2ec55ac, 2019-08-05 22:13:56 -0700, Diego Caballero, 37, 14, 51, LINK), (dc7bc9e4053e8b643937447f1f31a2bf980a1d3a, 2019-08-05 22:13:56 -0700, Diego Caballero, 41, 16, 57, LINK)"
490,1,6,7,13,"(d3e23707f1f7e0f75dea7ede5417403617f084db, 2015-12-14 16:44:21 -0800, Martin Wicke, 6, 7, 13, LINK)"
4903,2,151,211,362,"(37851f4abdf4991fde654264f56a2bd8a2762551, 2016-10-22 08:06:15 -0800, A. Unique TensorFlower, 69, 139, 208, LINK), (39d0932c8796802a15663d3b59f559ab36244ece, 2016-10-12 07:48:41 -0800, A. Unique TensorFlower, 82, 72, 154, LINK)"
4928,1,1,1,2,"(60d54d6b8524bcaf512f53384b307fae47b953d2, 2016-10-13 14:54:59 -0700, David Z. Chen, 1, 1, 2, LINK)"
4938,1,3,0,3,"(3a8ec777219002edf05264730f06760d1c346d6f, 2016-10-14 11:51:28 -0800, Lukasz Kaiser, 3, 0, 3, LINK)"
4996,2,66,162,228,"(4d0b2a57fa883bf8b80ee1d08fd3bd45e3625f53, 2016-10-25 15:43:01 -0800, Vijay Vasudevan, 19, 82, 101, LINK), (465ce3dd8a6e4006bd802b73f2ec09f6fd169272, 2016-10-19 16:38:33 -0800, Vijay Vasudevan, 47, 80, 127, LINK)"
5,17,40211,8735,48946,"(996f37c25dfa1bd81d28d76c19f46e8755c31d28, 2020-06-28 17:52:01 -0400, settle, 36, 27, 63, LINK), (cf7c008ab150ac8e5edb3ed053d38b2919699796, 2017-06-28 11:07:44 -0700, Yifei Feng, 35256, 8213, 43469, LINK), (3faa4d2d9672fb6f8ba8f80a0df45dabeb5a3382, 2017-06-26 10:16:32 -0700, A. Unique TensorFlower, 2, 0, 2, LINK), (870b7775b2538d78d9353eba53d7664021405013, 2017-01-25 23:25:29 -0800, Asim Shankar, 409, 5, 414, LINK), (cd4a96499b5f83d82f2612f8e5aa99726cf15edb, 2017-01-23 17:54:29 -0800, Asim Shankar, 111, 24, 135, LINK), (d73a2668b5e7b65d54576be461e1107f27ea1365, 2017-01-10 10:44:40 -0800, Asim Shankar, 40, 1, 41, LINK), (bd65cda4051a042003096096ab9b05c73a15e65c, 2016-12-06 16:59:55 -0800, Asim Shankar, 223, 40, 263, LINK), (4d51b55cf8c2f58f49b3c89bf0dbd32b5875f1fb, 2016-12-06 13:49:10 -0800, Asim Shankar, 145, 4, 149, LINK), (f074dc8a132b3de5fd1e0886222e1fa4ad5b4c96, 2016-12-06 12:35:05 -0800, Asim Shankar, 734, 13, 747, LINK), (22812d55368956b74ccf3afd4c1139458b7b29fb, 2016-12-05 17:16:23 -0800, Asim Shankar, 354, 14, 368, LINK), (6de74f8502c0fae1a7ddeeb5c02496e2452774f5, 2016-12-05 16:02:11 -0800, Asim Shankar, 410, 0, 410, LINK), (005b59a92eb71a5880c16414eb0a442b7cdb6ec2, 2016-12-05 14:04:24 -0800, Asim Shankar, 93, 1, 94, LINK), (502675bc775700fb1fa53edde377ba65de6d2897, 2016-12-05 13:35:54 -0800, Asim Shankar, 98, 29, 127, LINK), (2b1cd28297c4ba9305807f5fe9bb15570758a3fc, 2016-12-02 11:11:28 -0800, Asim Shankar, 1012, 18, 1030, LINK), (00ae29436a604ae62cbe4eb823cb5785431c842e, 2016-11-28 17:28:20 -0800, Asim Shankar, 376, 0, 376, LINK), (573fbda10163d4d12871f824acbfd1fb5778332f, 2016-01-07 07:45:47 -0800, Vincent Vanhoucke, 834, 346, 1180, LINK), (634105240d4ccc4e17b0639584ce647b0bfbc639, 2015-11-25 00:15:45 -0800, Illia Polosukhin, 78, 0, 78, LINK)"
50,3,747,398,1145,"(c3f5d9c2630b51b15936c5b6c8b21fa52e2f0bb5, 2019-08-01 16:31:15 -0700, Uday Bondhugula, 286, 190, 476, LINK), (80bad2fe8756358a46943de36f2353339afc19fb, 2019-08-01 16:31:15 -0700, Uday Bondhugula, 400, 195, 595, LINK), (b14b86cef14e6205a7bd4c602834008e568ea31f, 2016-01-13 16:21:18 +0300, makseq-ubnt, 61, 13, 74, LINK)"
5014,1,2,0,2,"(222e4a716feae7a0331399903139bc9a2b422529, 2016-10-31 19:52:53 +0100, Dr. Kashif Rasul, 2, 0, 2, LINK)"
505,1,23,20,43,"(f2eae4b3d27a4dc6d1f591f55a50fb3e1984a287, 2015-12-16 17:54:29 -0800, Derek Murray, 23, 20, 43, LINK)"
5059,1,25,25,50,"(08c73994c90cc4e9f2ce055913669d86b1949c79, 2016-10-21 17:43:11 -0800, A. Unique TensorFlower, 25, 25, 50, LINK)"
5070,1,1,1,2,"(ab9d1c480a6b5131e0225752ca8c055eac2e70d1, 2016-10-24 15:08:48 -0800, Vincent Vanhoucke, 1, 1, 2, LINK)"
51,2,1515,243,1758,"(a821b8c1fed1b2370c86dfb0ec74e7e8941a8c7f, 2019-07-22 15:06:15 -0700, River Riddle, 10, 1, 11, LINK), (fe589d9e7caea582beed160ad47e55f537a8403e, 2017-05-31 06:15:23 +0100, Luke Iwanski, 1505, 242, 1747, LINK)"
5106,1,57,12,69,"(6f259612b6763444df59f8229e14b5127ec40b75, 2016-10-25 10:19:49 -0800, Asim Shankar, 57, 12, 69, LINK)"
5115,1,50,12,62,"(f46fe646a26f0514fdfbfcea3882fd0120f24388, 2016-11-09 13:15:12 -0800, Derek Murray, 50, 12, 62, LINK)"
5118,1,2,2,4,"(7c9d0da5bc3f6a707b311e7f38e8d77e5574901a, 2016-11-26 16:58:05 -0800, Ian, 2, 2, 4, LINK)"
514,1,12,10,22,"(ff30fdc3d3ba0a6fe94a292b8d5616f6f4901ad2, 2015-12-18 06:59:43 +0100, Denny Britz, 12, 10, 22, LINK)"
5143,1,0,1,1,"(c8929e2e6e1dcb7e8e0feda6f917bf9b61d851b1, 2016-10-26 08:04:41 -0800, Asim Shankar, 0, 1, 1, LINK)"
5169,1,2,1,3,"(dde4e3caff94e3c47b4868615365936883cb31a1, 2016-10-27 16:00:00 -0700, guschmue, 2, 1, 3, LINK)"
519,1,1,1,2,"(d851fbed77f6998dd9bab6ee045077a6c61ff44d, 2019-02-05 22:27:39 -0800, Abolfazl Shahbazi, 1, 1, 2, LINK)"
52,1,318,1,319,"(bbe771a33d6a1561194cbad84db4e97bb85cc672, 2019-07-25 15:42:41 -0700, Denis Khalikov, 318, 1, 319, LINK)"
5236,1,4,2,6,"(2b703011163454ae15ba07ec89dd6bd2d8633a00, 2016-11-03 01:25:46 +0800, Burness Duan, 4, 2, 6, LINK)"
5251,1,4,1,5,"(d131c5d35b9ef01b6cc5776ca6b0725f83ad35b6, 2016-11-04 01:55:27 +0800, a7744hsc, 4, 1, 5, LINK)"
529,1,1,1,2,"(be91852fbcb6c86afac465f41eee3bd0ba0c538c, 2015-12-17 10:27:14 -0800, Martin Wicke, 1, 1, 2, LINK)"
53,1,1505,242,1747,"(fe589d9e7caea582beed160ad47e55f537a8403e, 2017-05-31 06:15:23 +0100, Luke Iwanski, 1505, 242, 1747, LINK)"
5316,1,124,101,225,"(9113b25790bfc4e2da1876a78d74382f776bf02a, 2016-11-02 17:57:50 -0800, Jonathan Hseu, 124, 101, 225, LINK)"
537,1,41,15,56,"(69b38d3672e7c3dac7173ad8e74ffd195263914c, 2015-12-18 14:40:07 -0800, Lukasz Kaiser, 41, 15, 56, LINK)"
5380,1,1,0,1,"(b725df4aaf4fde1139f7204bae31650a25348e0f, 2016-11-03 11:40:56 -0800, Vijay Vasudevan, 1, 0, 1, LINK)"
539,1,2,2,4,"(1b69b6873e0fa0e510797c7dca01563de2988838, 2015-12-18 10:05:16 -0800, Derek Murray, 2, 2, 4, LINK)"
54,4,2249,276,2525,"(f577e958bad27b0de36bd6bc70ec2b33cccacb7e, 2019-07-30 09:42:33 -0700, Denis Khalikov, 445, 16, 461, LINK), (ef67a29e9d41ebec1484f905db511828c1cb5b09, 2019-07-30 09:42:33 -0700, Denis Khalikov, 297, 16, 313, LINK), (fe589d9e7caea582beed160ad47e55f537a8403e, 2017-05-31 06:15:23 +0100, Luke Iwanski, 1505, 242, 1747, LINK), (1c131f29d7877e3155f1e58ef3aa99b51faf399b, 2016-08-19 13:16:03 -0800, Andrew Selle, 2, 2, 4, LINK)"
540,1,4,6,10,"(48cc3eae7e00867002c88cc73244560ba61be85e, 2015-12-18 14:39:49 -0800, Derek Murray, 4, 6, 10, LINK)"
5401,1,26,19,45,"(f8573271af6d5d4907709cd570320fec0db33780, 2016-11-16 14:20:30 -0800, Mustafa Ispir, 26, 19, 45, LINK)"
542,1,1,1,2,"(6c576f017156cc0bf50e2dd2cd42b2ab8db9bffe, 2016-03-08 15:25:25 -0800, Geoffrey Irving, 1, 1, 2, LINK)"
5438,1,83,11,94,"(e6e8d8715552d8890c0dd10f49ec3dff931a9926, 2016-11-17 13:59:10 -0800, Jonathan Hseu, 83, 11, 94, LINK)"
5487,1,2,2,4,"(903167fe3ef9348c879e7dd2c0c7ec1a9e244acc, 2016-11-09 08:08:27 +0200, Adriano, 2, 2, 4, LINK)"
5514,1,1,1,2,"(0e418320250c64f5a5beaacecd39713f99b8a80f, 2017-02-24 23:31:18 -0500, tbonza, 1, 1, 2, LINK)"
5517,1,0,4,4,"(8eadfadba54fff373da822554b94f5e280e5eab5, 2016-11-10 15:25:39 -0800, Derek Murray, 0, 4, 4, LINK)"
553,1,9,27,36,"(753f680cb10f4a3dcf71ea6de03752e09ebc2afa, 2015-12-21 13:31:53 -0800, Derek Murray, 9, 27, 36, LINK)"
5576,1,9,4,13,"(5729571e6f6ef07c0303b6c1a4df2615dc0ed0c5, 2016-11-17 10:57:14 -0800, Derek Murray, 9, 4, 13, LINK)"
5588,1,66,43,109,"(16a4bc203b90f0eff07df369d9d8fe6260c99aef, 2017-03-03 14:44:23 -0800, Eugene Brevdo, 66, 43, 109, LINK)"
56,5,41435,9948,51383,"(16c7ece1fd1594c467be7bd6163d55aa91717ff8, 2020-09-28 13:17:36 -0700, Bruce Fontaine, 4, 0, 4, LINK), (8ca02e0fd561ea570b4c596259579cf89fe370bb, 2019-07-31 11:10:17 -0700, Denis Khalikov, 178, 1, 179, LINK), (4ca0e2c71a954ac97ac9aaffdf0e9e8b6469e50a, 2019-07-31 11:10:17 -0700, Denis Khalikov, 263, 1, 264, LINK), (cf7c008ab150ac8e5edb3ed053d38b2919699796, 2017-06-28 11:07:44 -0700, Yifei Feng, 35256, 8213, 43469, LINK), (1699d904afa9568db12d4948a330947048b68e96, 2017-06-22 16:20:32 +0100, John Lawson, 3, 1, 4, LINK)"
5622,1,2,0,2,"(95d2a35ff60369775992879389648fa401e1dab8, 2016-11-16 17:04:55 -0800, Martin Wicke, 2, 0, 2, LINK)"
5639,1,2,0,2,"(9a48b7570a94fe3590a6453918aa5a3b1dae7b19, 2016-12-07 13:18:57 -0800, Pete Warden, 2, 0, 2, LINK)"
5652,1,1,10,11,"(1b531b9d88361a3b8506399d5edae155125c5371, 2016-11-18 12:52:07 -0800, A. Unique TensorFlower, 1, 10, 11, LINK)"
57,3,1566,254,1820,"(fe589d9e7caea582beed160ad47e55f537a8403e, 2017-05-31 06:15:23 +0100, Luke Iwanski, 1505, 242, 1747, LINK), (79eed0389370dad7210312975b101489b6dc9f8c, 2016-02-13 21:49:36 -0800, Illia Polosukhin, 46, 10, 56, LINK), (b729f46b2db01b4b53e2a79b773f7269fea0bc0a, 2016-02-02 19:45:31 -0800, Illia Polosukhin, 15, 2, 17, LINK)"
571,1,88,0,88,"(eef2aaa3f7931cc3c0e7bbc6757386cfbcf5e3ef, 2015-11-19 13:26:35 -0500, MarkDaoust, 88, 0, 88, LINK)"
5738,1,22,17,39,"(b5c22c1c201fd4b3d4359331f61728e715724274, 2016-11-23 14:34:40 -0800, A. Unique TensorFlower, 22, 17, 39, LINK)"
5759,1,2,2,4,"(7544aeec4886e430690f2ef5a44d04cacf2e44cd, 2016-11-22 12:57:34 +0000, Abhishek Aggarwal, 2, 2, 4, LINK)"
5764,2,2,0,2,"(7fe08e33138edf6889e3cbc56a3cc56a844ad863, 2017-02-03 16:08:11 -0800, Andrew Harp, 1, 0, 1, LINK), (c43c858646d782a54b8b581d99d5ebc8b7b7b3b3, 2017-02-03 16:08:11 -0800, Andrew Harp, 1, 0, 1, LINK)"
5770,1,4,2,6,"(9c887941d52fe9a3e5d7da3efb30639e89228f0c, 2017-06-30 15:32:36 -0700, Andrew Selle, 4, 2, 6, LINK)"
58,4,138,23,161,"(1b4a7714b3db0b9cde093a7493f1fbdb1c087aba, 2019-08-20 10:43:45 -0700, Diego Caballero, 49, 7, 56, LINK), (b8b95002628275e1ed6fbc5342f8c8835a0cd7b3, 2019-08-07 10:31:14 -0700, Diego Caballero, 30, 7, 37, LINK), (ab0291224c3460ac7cf06d1a073afd2291dd0435, 2019-08-07 10:31:14 -0700, Diego Caballero, 53, 9, 62, LINK), (1e416cd23464aa77d23a2d63a9f7df12325d6491, 2015-12-21 13:31:21 -0800, Martin Wicke, 6, 0, 6, LINK)"
5804,1,106,2,108,"(c89ebd31d6d729704d77a712c7103f0a7e5353e1, 2017-10-24 08:36:47 -0700, A. Unique TensorFlower, 106, 2, 108, LINK)"
5807,1,4,11,15,"(51ae55c4e782c7577e10e51ee54721593204f396, 2016-11-23 09:49:33 -0800, Vijay Vasudevan, 4, 11, 15, LINK)"
5818,1,1,6,7,"(0d805b42bdddf23527d35d434cee07d836894d28, 2016-11-23 16:03:00 -0800, Derek Murray, 1, 6, 7, LINK)"
582,1,45,0,45,"(8ac009728db931ef3119a337bd23250c89bc7efe, 2016-03-25 19:53:20 -0800, Manjunath Kudlur, 45, 0, 45, LINK)"
5832,1,13,0,13,"(801f0a9ef88072b42c4b884822a7e8977979e06c, 2016-11-27 22:12:49 +0100, Xingdong Zuo, 13, 0, 13, LINK)"
586,1,18,12,30,"(a26aad7dcfa604506ba2c5aa76ee36dc9b6d701a, 2016-12-13 12:06:11 -0800, A. Unique TensorFlower, 18, 12, 30, LINK)"
5871,1,12,0,12,"(0e1ff10ec3c4dd3f44cd312fa392aa04e9f3c662, 2016-12-08 13:22:27 -0800, Manjunath Kudlur, 12, 0, 12, LINK)"
5876,1,107,20,127,"(42add47d50ae7572dbd3a4b69711b800a429ec1b, 2016-12-09 11:24:49 -0800, Vijay Vasudevan, 107, 20, 127, LINK)"
59,2,44,2,46,"(047cb2280d3caf17ae187412ef7bf0b629557fe5, 2019-08-02 08:23:48 -0700, Diego Caballero, 4, 1, 5, LINK), (bda264f0591f8cbaf68fc497f9af0a5e11086c59, 2019-08-02 08:23:48 -0700, Diego Caballero, 40, 1, 41, LINK)"
5946,1,4,4,8,"(689f7a0b8468c8feec4d2a6db54bb6bc3759fbe2, 2016-11-29 23:54:42 -0800, Gunhan Gulsoy, 4, 4, 8, LINK)"
5986,1,3,2,5,"(45254d9d7f790f97746775967637773d137682a9, 2016-11-30 17:00:20 -0800, Derek Murray, 3, 2, 5, LINK)"
6,2,35258,8213,43471,"(cf7c008ab150ac8e5edb3ed053d38b2919699796, 2017-06-28 11:07:44 -0700, Yifei Feng, 35256, 8213, 43469, LINK), (3faa4d2d9672fb6f8ba8f80a0df45dabeb5a3382, 2017-06-26 10:16:32 -0700, A. Unique TensorFlower, 2, 0, 2, LINK)"
6027,1,3,3,6,"(a1e064fc6d738a66b9104306505e8a1a7e49c752, 2016-12-01 15:35:02 -0800, Vincent Vanhoucke, 3, 3, 6, LINK)"
603,1,4,4,8,"(c90113175756e2505b6fdedd106fbe7b9670845d, 2015-12-23 11:05:03 -0800, Vijay Vasudevan, 4, 4, 8, LINK)"
6034,1,15,3,18,"(5e07ab3ff51b06c3291789ac0e65499217f720d1, 2018-07-27 07:32:47 -0700, Vitaly Lavrukhin, 15, 3, 18, LINK)"
6036,1,4,4,8,"(605bf2a513eb71828aeabc5accfa790661cce78a, 2016-12-03 09:18:08 +1100, Ronny, 4, 4, 8, LINK)"
6083,2,6,6,12,"(e088c887200ab3cb1ae4f501e11ba2b14456ef11, 2016-12-05 09:59:53 -0800, Derek Murray, 3, 3, 6, LINK), (669b2cc9fa02527c87e9f82bd4ac7d76e715d2a8, 2016-12-05 09:59:53 -0800, Derek Murray, 3, 3, 6, LINK)"
61,3,2488,277,2765,"(1415114e444dfa9cc40e9074aa8985bd0302d061, 2019-08-01 13:05:28 -0700, Denis Khalikov, 394, 8, 402, LINK), (04df3bea68e2440ec1185950ff86736539d26d85, 2019-08-01 13:05:28 -0700, Denis Khalikov, 589, 27, 616, LINK), (fe589d9e7caea582beed160ad47e55f537a8403e, 2017-05-31 06:15:23 +0100, Luke Iwanski, 1505, 242, 1747, LINK)"
6115,2,20,20,40,"(9ff4b1a423783299d88565ece61ad2f4d133805c, 2016-12-06 08:46:04 -0800, Derek Murray, 10, 10, 20, LINK), (b5e6d667d28f8dd1ea21ed428fa560b0d4720afa, 2016-12-06 08:46:04 -0800, Derek Murray, 10, 10, 20, LINK)"
6136,1,21,0,21,"(c5fb76889307e6dae92312ea68383d8ae8f47277, 2016-12-07 21:47:31 +0200, Adriano Carmezim, 21, 0, 21, LINK)"
616,1,237,63,300,"(4da1ccb9ff7fe1cba97fe4404db505ae47d28235, 2019-08-08 14:59:46 +0000, Peng Sun, 237, 63, 300, LINK)"
62,2,2,0,2,"(99b9869d529a22291e34817f191d8a53ec54cd2e, 2019-08-01 13:39:21 -0700, Eric Schweitz, 1, 0, 1, LINK), (8e059c6a5fdbf2937db11e61a9824fc69d346766, 2019-08-01 13:39:21 -0700, Eric Schweitz, 1, 0, 1, LINK)"
6263,1,6,1,7,"(b8969d12f9260a7b1981b8d22788aa1f8c8cbbb6, 2017-11-28 15:44:48 -0800, Martin Wicke, 6, 1, 7, LINK)"
6342,1,1,1,2,"(7314d0853e2ee7d64526ad3b1dcaa08591199bfb, 2017-02-15 14:54:53 -0800, Martin Wicke, 1, 1, 2, LINK)"
6377,1,207,74,281,"(f3d5990d6971faf9b15f5e6fa53e2e640742b8e0, 2017-01-06 12:57:14 -0800, A. Unique TensorFlower, 207, 74, 281, LINK)"
64,2,14,0,14,"(aefad5a65c8653385b39121635414a0c522e2ab0, 2019-08-08 01:05:26 -0700, Eric Schweitz, 5, 0, 5, LINK), (f70b56ad25d7e6e3899b2042722ed53422bbedd7, 2019-08-08 01:05:26 -0700, Eric Schweitz, 9, 0, 9, LINK)"
6509,1,20,4,24,"(cf9818e1725d8f6229c1865eb26549725c04959a, 2017-01-14 10:03:01 -0800, Derek Murray, 20, 4, 24, LINK)"
6549,1,13,1,14,"(eeb13cdbac643014674940324465a78307d81a86, 2017-01-01 02:22:37 -0500, terrytangyuan, 13, 1, 14, LINK)"
6558,1,0,2,2,"(1e4d6f1c32be198a682518f1afce03c017c0aa11, 2017-01-10 20:13:14 -0800, Victor Costan, 0, 2, 2, LINK)"
6594,1,1,1,2,"(ecf97ee5f2e386be31fde8ca790d48786b969103, 2017-01-05 01:59:19 -0500, Andrew Hundt, 1, 1, 2, LINK)"
6602,1,1,0,1,"(02d2385b8c33e89b53e49bc89e646b54de920bad, 2017-01-04 15:04:39 -0800, Vijay Vasudevan, 1, 0, 1, LINK)"
6616,1,2,1,3,"(9d3efca71e9a6250802dcdc3d19152f3acf0c675, 2017-04-17 14:12:43 -0800, Suharsh Sivakumar, 2, 1, 3, LINK)"
6620,2,126,4,130,"(0282f080fa0555a0f4af1a0293e529327d09b153, 2018-02-06 16:25:59 -0800, James Qin, 63, 2, 65, LINK), (0282f080fa0555a0f4af1a0293e529327d09b153, 2018-02-06 16:25:59 -0800, James Qin, 63, 2, 65, REGEX)"
6647,1,1,1,2,"(7314d0853e2ee7d64526ad3b1dcaa08591199bfb, 2017-02-15 14:54:53 -0800, Martin Wicke, 1, 1, 2, LINK)"
67,1,10,10,20,"(ee6e2fb5b68773195c498aad37a1aeec2f908e59, 2019-08-05 01:39:26 -0700, Denis Khalikov, 10, 10, 20, LINK)"
6717,1,33,13,46,"(b39773478542bf812a12715f7f753f9a88e5e86c, 2017-01-18 15:36:06 -0800, Eugene Brevdo, 33, 13, 46, LINK)"
6720,1,2663,973,3636,"(371c96df55a7b23eb8d8496fb477b473fd137fcc, 2019-02-28 19:12:06 -0800, A. Unique TensorFlower, 2663, 973, 3636, LINK)"
6735,1,2,1,3,"(11fbea4ccf3ec0b354c5a31a109ac35cb457fc8e, 2017-01-14 23:28:46 -0800, Yaroslav Bulatov, 2, 1, 3, LINK)"
6736,1,10,5,15,"(f25907ec4f823028adbaa675d9a1fe476202795e, 2017-01-11 18:59:15 +0100, Dr. Kashif Rasul, 10, 5, 15, LINK)"
674,1,1,4,5,"(5b68a7e8703ea58c603a0be3b6aea4e097ffbc81, 2016-01-12 12:28:57 -0800, A. Unique TensorFlower, 1, 4, 5, REGEX)"
6741,1,35,1,36,"(ca6131130a25e00646972dfed2256ad2d633743c, 2017-01-10 16:03:33 -0800, Andrew Selle, 35, 1, 36, LINK)"
6742,1,40,7,47,"(e1362157e33a6fd6a66caefd083bd4afc27dc030, 2016-12-27 11:00:12 -0800, Derek Murray, 40, 7, 47, LINK)"
6749,1,12,1,13,"(fa867b0e3fe5f6c36405a7019ec6b8b0e001bed5, 2017-06-29 22:32:25 +0000, Yong Tang, 12, 1, 13, LINK)"
6766,1,16,4,20,"(07e6ca0ac7cdfcb6105fb3410fc68355c04df1d5, 2018-01-23 13:12:40 -0800, Yong Tang, 16, 4, 20, REGEX)"
6780,1,32,18,50,"(b0006cef925d0588cc53a57951c370c83d8e5de9, 2017-02-22 14:30:58 -0800, Jonathan Hseu, 32, 18, 50, LINK)"
6799,1,18,2,20,"(2abef5cebb7d8771f610d213bc900b7ab7aea47e, 2017-01-11 22:14:44 -0800, Asim Shankar, 18, 2, 20, LINK)"
6809,2,2,3,5,"(088b2d49e9dd0ce752b0019c7e543c249e0a8052, 2017-02-08 21:20:10 -0800, gunan, 2, 2, 4, LINK), (0c68156ffcf918df905f9f39a632888724c66c3b, 2017-02-07 20:04:34 -0800, gunan, 0, 1, 1, LINK)"
6823,1,38,5,43,"(6ed5eaaac13540c1b9d5a7549b2c82aac91ba318, 2017-01-25 10:25:36 -0800, Justine Tunney, 38, 5, 43, LINK)"
6854,2,214,30,244,"(bd371a33810ecb7957fa952b2af0e6dc33f9341c, 2017-01-17 09:05:39 -0800, Peter Hawkins, 107, 15, 122, LINK), (88499af956956a11f8daa309881952f2fcba7120, 2017-01-17 09:05:39 -0800, Peter Hawkins, 107, 15, 122, LINK)"
686,1,13,1,14,"(b18bd346f523092af2beb5c1a10a8b35a9698188, 2016-01-12 16:55:21 -0800, David G. Andersen, 13, 1, 14, LINK)"
6869,1,42,23,65,"(c058a01d99621c7220c57e4f8c5ee6efd163ed03, 2017-01-17 15:06:43 -0800, Jonathan Hseu, 42, 23, 65, LINK)"
69,2,523,63,586,"(ec44652f2b852b94a1f69f42e1a8c1cf8085de59, 2019-08-08 18:29:23 -0700, Nagy Mostafa, 189, 31, 220, LINK), (ee6dbf9f4570869c3356ab5f43524135b480842f, 2019-08-08 18:29:23 -0700, Nagy Mostafa, 334, 32, 366, LINK)"
6931,2,30,0,30,"(5147b75ea8cb3fdc6b864f842ca48c65b2bf2c64, 2017-01-19 16:24:46 -0800, Asim Shankar, 15, 0, 15, LINK), (135729a045538335aefe4404581d793590ec975a, 2017-01-19 16:24:46 -0800, Asim Shankar, 15, 0, 15, LINK)"
6969,1,20,2,22,"(8499dc1ee56b40a6e1f16ccbf3073a12523a0f58, 2017-01-20 10:34:19 -0800, Asim Shankar, 20, 2, 22, LINK)"
6974,2,52,12,64,"(9d01b154aa0d31fdea93f349abfb232b2a557327, 2017-01-20 16:59:36 -0800, Suharsh Sivakumar, 26, 6, 32, LINK), (723c4048790d6f0636f6c1df5f4fb793ef7a4ae6, 2017-01-20 16:59:36 -0800, Suharsh Sivakumar, 26, 6, 32, LINK)"
70,1,3,3,6,"(2c7aa90670934537b22b78f295e37449b2fc48da, 2019-08-08 09:30:09 -0700, Kan Chen, 3, 3, 6, LINK)"
7025,1,8,0,8,"(0a9b39caefd437fec742ae48b25061abd6e2699b, 2017-04-28 16:42:25 -0800, Vijay Vasudevan, 8, 0, 8, LINK)"
7051,1,884,326,1210,"(cc2dd4ac8538045e94e3f8fe4fb1c532f67c1844, 2017-06-05 10:29:50 -0700, Shanqing Cai, 884, 326, 1210, LINK)"
7065,1,311,9,320,"(0318cf082ee88ff0e226a5bf7da0487f44d82182, 2017-01-30 12:28:52 -0800, A. Unique TensorFlower, 311, 9, 320, LINK)"
7088,1,1,0,1,"(c3df5d40ef8240ede980ccb740d6af87837d8eef, 2017-01-27 14:50:34 -0800, Andrew Harp, 1, 0, 1, LINK)"
71,2,27,2,29,"(31eee7f5c23fd3387b7b3adaafcfd258fecd2025, 2019-08-08 16:02:50 -0700, Diego Caballero, 14, 1, 15, LINK), (e5603953205c94a0bba5f406df18b479298b7a79, 2019-08-08 16:02:50 -0700, Diego Caballero, 13, 1, 14, LINK)"
713,1,8,8,16,"(38f54b55cdc66e12a2f6ce9d6724440e9738ac6f, 2016-01-11 13:03:29 -0800, Benoit Steiner, 8, 8, 16, LINK)"
7136,1,7,2,9,"(b059b4c7e7de05024f6c19370dcd83293b500a26, 2017-03-13 12:01:29 -0700, Yong Tang, 7, 2, 9, LINK)"
714,2,65,9,74,"(05626f9fc3b7084b34535bf0cd44f79d8fcee649, 2016-08-19 22:54:58 +0800, Jingtian Peng, 51, 0, 51, LINK), (2e680bbcace962a7aa85baaef948d360e6a2c49b, 2015-12-29 22:54:31 -0800, Jan Prach, 14, 9, 23, REGEX)"
7150,1,39,6,45,"(033f87b7f4d54c9f981ef848f559d232dbcc8d34, 2017-02-10 11:20:10 -0800, Pete Warden, 39, 6, 45, LINK)"
7162,1,2,0,2,"(17ce98437f34ab5439b3e46adb2eb5b692c48abd, 2017-11-07 05:30:51 +0800, Daniel Zhang, 2, 0, 2, LINK)"
7169,1,6,1,7,"(afc7ea521c1ad14c217116a462cb77f2e8640b16, 2017-02-01 12:06:08 -0800, Asim Shankar, 6, 1, 7, LINK)"
7175,1,23,5,28,"(fbcb58b422f9bf2c2a23ac33d21b87daf5f31d49, 2017-03-07 17:49:17 -0800, Asim Shankar, 23, 5, 28, LINK)"
72,3,13,9,22,"(cae7b6b7f185cff51cbde7fb27ed5e4a4811fce5, 2019-08-23 11:28:19 -0700, River Riddle, 4, 3, 7, LINK), (ae4fec85877bf9318ebcf9d18b1beb2d3c084edb, 2019-08-23 11:28:19 -0700, River Riddle, 4, 3, 7, LINK), (ee403f003e4614baab6219bedb19f5c15a6a1225, 2016-01-07 11:35:37 -0800, Illia Polosukhin, 5, 3, 8, LINK)"
7204,1,57,17,74,"(029a1708c1804ddbdb6396b3df6d8b3541d77f0d, 2017-02-18 13:53:23 -0800, Eugene Brevdo, 57, 17, 74, LINK)"
7216,1,4,3,7,"(edc1bf117b88059b92d7500953615f417122950a, 2017-02-02 11:53:25 -0800, A. Unique TensorFlower, 4, 3, 7, LINK)"
7287,1,1,0,1,"(43c2d687153a42fe91f8f93fb571cf0f4a15be3e, 2017-03-09 15:40:18 -0800, Martin Wicke, 1, 0, 1, LINK)"
7308,1,3,3,6,"(fcae253c08a9f54d55cfa596402ab53c397089bd, 2017-02-07 14:31:04 -0800, A. Unique TensorFlower, 3, 3, 6, LINK)"
7312,1,0,2,2,"(940d968347eccd4afded06603b4d63eedc721a16, 2017-06-16 14:20:40 -0700, Kaarthik Sivashanmugam, 0, 2, 2, LINK)"
7356,1,1,1,2,"(c7fca9eed7b584cbfd95b253908c51f4e9b7fa8b, 2017-02-09 13:09:43 -0500, Julian Berman, 1, 1, 2, LINK)"
7375,1,2,2,4,"(099ef38a99d069b9a1f6d09a289b2df69eaee276, 2017-02-10 18:26:19 -0800, Justine Tunney, 2, 2, 4, LINK)"
7382,1,1,1,2,"(c0fc1b998ddbc838a479e295dfd9c0ad75d28f48, 2017-02-09 16:14:05 -0800, Dandelion Mané, 1, 1, 2, LINK)"
7394,1,28,7,35,"(caced55cbc205a9423a480cae0bb9e7a9a10f3a1, 2018-02-08 13:17:53 -0800, Asim Shankar, 28, 7, 35, LINK)"
74,2,66,14,80,"(a3fb4cd4ea207f01b60b49b307c8618a55422d53, 2019-08-20 10:43:45 -0700, Diego Caballero, 17, 7, 24, LINK), (1b4a7714b3db0b9cde093a7493f1fbdb1c087aba, 2019-08-20 10:43:45 -0700, Diego Caballero, 49, 7, 56, LINK)"
7406,1,1,4,5,"(3116fa80450735e907907bc57a6834e9e212570a, 2017-03-22 09:54:14 -0700, Mycosynth, 1, 4, 5, LINK)"
744,1,16,2,18,"(a6037e933fe8799c80f94decc9f5b178b833c1b8, 2016-01-11 11:37:01 -0800, Derek Murray, 16, 2, 18, LINK)"
7452,1,4,4,8,"(d758e6dc346eadee5d71482415ad9a0095bfb591, 2017-02-13 11:26:38 -0800, Andrew Harp, 4, 4, 8, LINK)"
75,2,6,0,6,"(68ba90e77dde008dc7109a3f9eef943bfe2e4de1, 2019-08-13 14:22:58 -0700, jpienaar, 3, 0, 3, LINK), (8024036f66ba5ba47cbfdacd627ec91f25196145, 2019-08-13 14:22:58 -0700, jpienaar, 3, 0, 3, LINK)"
751,1,123,31,154,"(92ea3d1120cf58bac27eac3189b3c6ff0eba68e4, 2016-01-14 14:58:19 -0800, Sherry Moore, 123, 31, 154, LINK)"
7569,1,1,1,2,"(f2843b0831653020ca6e1ceb7011f916e2e8f706, 2017-02-22 13:22:41 -0800, Patrick Nguyen, 1, 1, 2, LINK)"
759,1,51,0,51,"(05626f9fc3b7084b34535bf0cd44f79d8fcee649, 2016-08-19 22:54:58 +0800, Jingtian Peng, 51, 0, 51, LINK)"
7647,1,2,1,3,"(cb4f6337a583bb0f745d0a7319cf4d8256fdb3ea, 2017-02-19 13:30:22 -0500, Jeremy Sawruk, 2, 1, 3, LINK)"
7683,1,16,1,17,"(d58dd2dfd24d995aee56473aa9663cfabc6faea1, 2017-02-23 11:10:18 -0800, Andrew Harp, 16, 1, 17, LINK)"
772,1,1,0,1,"(2a128fcaa6eb2771428f300c728db4db647b5927, 2016-01-16 12:05:52 +0800, Yi-Lin Juang, 1, 0, 1, LINK)"
7754,1,96,20,116,"(53f68459f18fd9c707183511e1e58d03e2f367db, 2017-05-05 16:32:41 -0800, A. Unique TensorFlower, 96, 20, 116, LINK)"
7767,1,32,18,50,"(b0006cef925d0588cc53a57951c370c83d8e5de9, 2017-02-22 14:30:58 -0800, Jonathan Hseu, 32, 18, 50, LINK)"
79,1,92,10,102,"(b378657b8c50f49f9622281e698c62d5538b9397, 2016-01-14 19:17:59 -0800, Illia Polosukhin, 92, 10, 102, LINK)"
791,1,1,0,1,"(deb4f6f596f20e958fa4c9c0a47b98e6e7097aa4, 2016-01-26 20:43:06 -0800, Sagan Bolliger, 1, 0, 1, LINK)"
7917,1,0,1,1,"(d0eb4d6a2e0b22a5f72d880232871b57da892bfa, 2017-03-01 00:30:08 -0800, A. Unique TensorFlower, 0, 1, 1, LINK)"
7919,1,32,63,95,"(b4d091d5a372f97af48192cb431985b20b447158, 2017-02-27 11:16:08 -0800, Peter Hawkins, 32, 63, 95, LINK)"
7935,1,10,2,12,"(ab9ab8937f13a98e13ee531d56999473099a373c, 2017-03-07 00:31:47 -0800, Derek Murray, 10, 2, 12, LINK)"
8,5,35480,8286,43766,"(cf7c008ab150ac8e5edb3ed053d38b2919699796, 2017-06-28 11:07:44 -0700, Yifei Feng, 35256, 8213, 43469, LINK), (3faa4d2d9672fb6f8ba8f80a0df45dabeb5a3382, 2017-06-26 10:16:32 -0700, A. Unique TensorFlower, 2, 0, 2, LINK), (1c156f643c9e5cdf5b349f43111b0cd1391ef468, 2017-02-20 21:11:19 +0100, Hans Pabst, 21, 15, 36, LINK), (fa4c9a73fc04c5026035684fec6604ee47034f96, 2017-01-26 16:26:46 +0100, Hans Pabst, 49, 44, 93, LINK), (0eaf00d35735095cfc306b115a908e17b2c4beb0, 2015-11-24 19:34:48 -0800, Illia Polosukhin, 152, 14, 166, LINK)"
80,2,254,41,295,"(be0c1480422b56b58cfdba5ee714af50f822a756, 2019-08-16 10:17:47 -0700, Denis Khalikov, 116, 20, 136, LINK), (43cb2e491b095b331659e298f3bb536b29583e56, 2019-08-16 10:17:47 -0700, Denis Khalikov, 138, 21, 159, LINK)"
8041,1,1,1,2,"(1f8eae975b16940d60041065b08d15d47af6c820, 2017-03-04 08:46:22 -0800, A. Unique TensorFlower, 1, 1, 2, LINK)"
8047,1,36,4,40,"(97bb657c6d3849bfddead2c4c6f68c53157d7982, 2017-03-20 07:57:56 -0800, A. Unique TensorFlower, 36, 4, 40, LINK)"
8059,2,103,67,170,"(5f1976d08346f2e444679ee902d5a8b00c2ab95a, 2017-03-06 10:16:16 -0800, Andrew Harp, 5, 4, 9, LINK), (9c86d93fd36db784677a50d0e4aca8fe6a342bac, 2017-03-03 16:31:42 -0800, Andrew Harp, 98, 63, 161, LINK)"
8142,1,1,1,2,"(eaffcab3a4af34ef08cc489e73d445db9af61424, 2017-03-06 17:04:47 -0800, A. Unique TensorFlower, 1, 1, 2, LINK)"
8165,1,3,13,16,"(a727ee3909ca831992f0eda975dc09475d245f8e, 2017-03-07 22:08:34 +0100, Micael Carvalho, 3, 13, 16, LINK)"
82,2,8,2,10,"(b240a5b5f3d457fd95283e7a93a27e91e5fab451, 2019-08-20 01:52:39 -0700, Uday Bondhugula, 1, 1, 2, LINK), (09db8c1c51f2d82e7a584a3bcd31fadd4be4448e, 2019-08-20 01:52:39 -0700, Uday Bondhugula, 7, 1, 8, LINK)"
8233,1,1,1,2,"(c4da3832480a14f0621612eb28ec2ebbe7ad333f, 2017-03-13 09:41:28 -0800, Andrew Harp, 1, 1, 2, LINK)"
8284,1,14,0,14,"(5fb1aeaa6df73fe3ed6e66c034cf4202e3aa90ed, 2017-03-11 18:41:34 -0800, Asim Shankar, 14, 0, 14, LINK)"
8310,1,28,16,44,"(8d758e1e1843202e273e88f35dcf3bc8f4803906, 2017-05-17 01:56:08 +0900, Leandro Gracia Gil, 28, 16, 44, LINK)"
8325,1,1,1,2,"(2fdd1784d59dda69c840fa699220a79f72cbd5c0, 2017-03-15 23:32:26 +0530, Mandeep Singh, 1, 1, 2, LINK)"
8337,2,218,67,285,"(7b410ebea68bb26b3166a357cf7c1e8946a1b35b, 2017-03-30 20:27:38 -0800, Shanqing Cai, 64, 0, 64, LINK), (99559a3455d7c3b3663968a55bf56801743201d0, 2017-03-30 20:27:38 -0800, Shanqing Cai, 64, 0, 64, LINK)"
8353,1,2,1,3,"(3e64dcd2d66e25bc248767a0101922a3cb25d1cb, 2017-03-13 14:32:24 +0100, Micael Carvalho, 2, 1, 3, LINK)"
8391,1,68,61,129,"(4376dd7278c3f8da1ea7ac330bc6473163793d17, 2017-03-20 04:08:24 -0800, Ian Langmore, 68, 61, 129, LINK)"
8396,1,120,12,132,"(496a6ac03200bb518b4a9ea74b7b24ef58cbf918, 2017-03-15 08:14:52 -0800, Asim Shankar, 120, 12, 132, LINK)"
84,3,37,9,46,"(b240a5b5f3d457fd95283e7a93a27e91e5fab451, 2019-08-20 01:52:39 -0700, Uday Bondhugula, 1, 1, 2, LINK), (09db8c1c51f2d82e7a584a3bcd31fadd4be4448e, 2019-08-20 01:52:39 -0700, Uday Bondhugula, 7, 1, 8, LINK), (207578cd018e98d0e1cca0df9f146f4cec4b0631, 2016-01-20 19:57:31 -0800, Illia Polosukhin, 29, 7, 36, LINK)"
8494,1,211,28,239,"(e8ee5286a686c6fc3057ba7cf9ba9ef7003789a6, 2017-03-30 17:34:30 -0800, Geoffrey Irving, 211, 28, 239, LINK)"
8504,2,141,41,182,"(81761d7d07018af6665a20afe74b99b18ba02728, 2017-03-22 15:55:05 -0800, Eugene Brevdo, 34, 13, 47, LINK), (cb9d67def133b238b0ebba62392e672410a40f0d, 2017-03-20 16:41:32 -0800, Eugene Brevdo, 107, 28, 135, LINK)"
8507,1,18,0,18,"(039c74293abfc8e9263ca80ab4facdde658dfb03, 2017-03-22 09:24:00 -0800, Shanqing Cai, 18, 0, 18, LINK)"
8587,1,18,11,29,"(f12b26ea5b6953a16c3a968aaa0fd623b1f7a74f, 2017-03-27 11:01:31 -0800, Andrew Harp, 18, 11, 29, LINK)"
8619,3,132,78,210,"(6187242334f85934f3c025b5b27f42dc4364a94e, 2017-03-22 21:02:08 -0400, Damien Martin-Guillerez, 17, 8, 25, LINK), (a7d60270d564a2aa7ece58f1c3d9fad8c7def594, 2017-03-29 19:21:36 +0200, Damien Martin-Guillerez, 8, 0, 8, LINK), (fba05c300bf6840e76787680ed7fd1239cdb9ad0, 2017-03-22 21:02:08 -0400, Damien Martin-Guillerez, 17, 3, 20, LINK)"
8652,1,3,0,3,"(b0ab95c7af7c051d78dd74bd0a3032ce35273ea6, 2017-05-03 20:38:21 -0700, Shane, 3, 0, 3, LINK)"
8667,1,6,6,12,"(6d6738098055416e3f190745fcb236eff5ead514, 2017-04-11 01:20:21 +0200, Ilya Edrenkin, 6, 6, 12, LINK)"
867,1,8,8,16,"(87c31f6474a5fe90048eef25e5f19b9aff6060dd, 2016-06-11 11:13:10 -0700, Chris Lesniewski, 8, 8, 16, LINK)"
8720,1,96,20,116,"(53f68459f18fd9c707183511e1e58d03e2f367db, 2017-05-05 16:32:41 -0800, A. Unique TensorFlower, 96, 20, 116, LINK)"
8742,1,1,1,2,"(bb09c45fb6a0ef791f94ba23b51855117ba53414, 2017-03-27 02:13:12 -0700, James Mishra, 1, 1, 2, LINK)"
88,2,275,159,434,"(fd7e97cbecfe452323a6f12d1a4516faeff3b2b0, 2019-09-03 11:52:39 -0700, Uday Bondhugula, 110, 79, 189, LINK), (7a78eddd119868968bbf9f96556e3aad5b452c4f, 2019-09-03 11:52:39 -0700, Uday Bondhugula, 165, 80, 245, LINK)"
883,1,31,42,73,"(1854a502c84b96200308f6dfcd4b341b799ae50b, 2016-01-26 10:50:19 -0800, Vijay Vasudevan, 31, 42, 73, LINK)"
8854,2,45,0,45,"(8feab61146f08697c28d18a54c4e8c32ed028876, 2018-03-13 10:09:03 -0700, Mark Daoust, 1, 0, 1, LINK), (0627928fb49ea03022b001e2e366f7967367eace, 2017-05-02 01:29:41 +0100, Jamie Cooke, 44, 0, 44, LINK)"
8878,1,42,40,82,"(45115c0a985815feef3a97a13d6b082997b38e5d, 2017-04-08 16:49:52 +0100, Alan Mosca, 42, 40, 82, LINK)"
889,1,91,44,135,"(555c7f7c4108ae91601dce2e2dea1ad1158d5977, 2016-04-14 22:11:18 -0400, ry, 91, 44, 135, LINK)"
8923,3,22723,2102,24825,"(9e7bf403817a3acd4e8d865b041f37609564076e, 2017-04-10 13:55:56 -0700, drpngx, 16811, 1223, 18034, LINK), (52dcb2590bb9274262656c958c105cb5e5cc1300, 2017-04-07 18:04:26 -0700, Rohan Jain, 5879, 879, 6758, LINK), (b0989a0280971034bd838fa176ae3f92b210e8dc, 2017-04-06 03:01:27 -0800, Asim Shankar, 33, 0, 33, LINK)"
8947,1,2,1,3,"(1792a0af641f15c9442a5d461a34dd9bc8bd8616, 2017-04-10 13:18:36 -0800, Asim Shankar, 2, 1, 3, LINK)"
8982,1,59,3,62,"(98f9dd67f7cfe339a3794bee9fa0b83a69462ff6, 2017-04-17 23:14:38 -0800, Suharsh Sivakumar, 59, 3, 62, LINK)"
899,1,29,2,31,"(8525dbdc02b0c45c38ba16cfba26856eece2b851, 2016-02-01 14:59:09 -0800, Pete Warden, 29, 2, 31, LINK)"
9,5,35568,8241,43809,"(cf7c008ab150ac8e5edb3ed053d38b2919699796, 2017-06-28 11:07:44 -0700, Yifei Feng, 35256, 8213, 43469, LINK), (3faa4d2d9672fb6f8ba8f80a0df45dabeb5a3382, 2017-06-26 10:16:32 -0700, A. Unique TensorFlower, 2, 0, 2, LINK), (1c156f643c9e5cdf5b349f43111b0cd1391ef468, 2017-02-20 21:11:19 +0100, Hans Pabst, 21, 15, 36, LINK), (bb7a15b53942d747a21a83a80f0f2dee4a407e35, 2017-01-26 19:40:46 -0800, Alexander Heinecke, 41, 13, 54, LINK), (a615e37b50ecc36764795bbc2dfe8d003e606aed, 2015-11-24 21:42:38 -0800, Illia Polosukhin, 248, 0, 248, LINK)"
9014,3,22712,2110,24822,"(9e7bf403817a3acd4e8d865b041f37609564076e, 2017-04-10 13:55:56 -0700, drpngx, 16811, 1223, 18034, LINK), (52dcb2590bb9274262656c958c105cb5e5cc1300, 2017-04-07 18:04:26 -0700, Rohan Jain, 5879, 879, 6758, LINK), (a957eb9cb5ccc238b3196707be4ed22b91b67913, 2017-04-06 15:54:16 -0800, Asim Shankar, 22, 8, 30, LINK)"
9031,3,22697,2108,24805,"(9e7bf403817a3acd4e8d865b041f37609564076e, 2017-04-10 13:55:56 -0700, drpngx, 16811, 1223, 18034, LINK), (52dcb2590bb9274262656c958c105cb5e5cc1300, 2017-04-07 18:04:26 -0700, Rohan Jain, 5879, 879, 6758, LINK), (35c88a7f7d0189809dfb630396566eec078dc5db, 2017-04-07 07:54:39 -0800, Vincent Vanhoucke, 7, 6, 13, LINK)"
9047,1,7,2,9,"(1926b9d3b91375f5a4433303a27b49b4da53f64e, 2017-04-12 13:48:09 -0800, A. Unique TensorFlower, 7, 2, 9, LINK)"
9075,1,18,0,18,"(e436ecd251b0bdb6c645ba32ad33219bcbf6004e, 2017-05-05 14:07:33 -0800, A. Unique TensorFlower, 18, 0, 18, LINK)"
91,2,41002,9945,50947,"(cf7c008ab150ac8e5edb3ed053d38b2919699796, 2017-06-28 11:07:44 -0700, Yifei Feng, 35256, 8213, 43469, LINK), (fc7361081f88321fdaf4ab58e1939e71faf44ddf, 2017-06-22 01:00:43 +0100, Luke Iwanski, 15, 0, 15, LINK)"
9103,1,139,163,302,"(24a95ae389e1c76e771ac33d66e0ec40a236260f, 2017-04-10 15:29:15 -0800, Vijay Vasudevan, 139, 163, 302, LINK)"
9136,1,54,62,116,"(1f210ad7c2a81fe27196dd1a85c9bb92f19bc94a, 2017-04-19 09:06:46 -0800, Brennan Saeta, 54, 62, 116, LINK)"
9138,1,10,14,24,"(affc8b084284125ac366d53b63dda7f57eb2d12a, 2017-06-19 10:27:47 -0700, Patrick Nguyen, 10, 14, 24, LINK)"
917,1,229,37,266,"(bce6216610d57f8f4b1e9e79836737df109c4e42, 2016-02-24 16:27:54 -0800, Vincent Vanhoucke, 229, 37, 266, LINK)"
92,3,7,39,46,"(f2c3b869d354c05e497a79118a13a599dfc256bc, 2018-03-29 11:12:36 -0700, Xiaoming Jason Cui, 2, 3, 5, LINK), (10cddb4268b174f879956a2d1124b8ae1044c425, 2018-03-17 13:17:13 -0700, Xiaoming Jason Cui, 5, 2, 7, LINK), (35e12d74537ffbf7a27a2136337b1c52c922ae96, 2016-02-13 10:22:03 -0600, terrytangyuan, 0, 34, 34, LINK)"
93,3,41017,9946,50963,"(982b36ee53c6c7192f292da72e9ea2e62401ed51, 2019-08-20 08:53:02 -0700, Zhang, 1, 1, 2, LINK), (cf7c008ab150ac8e5edb3ed053d38b2919699796, 2017-06-28 11:07:44 -0700, Yifei Feng, 35256, 8213, 43469, LINK), (832894ef891568bcd4f56dd6ae4d9503cc41a694, 2017-06-22 00:59:54 +0100, Luke Iwanski, 29, 0, 29, LINK)"
9312,1,1,1,2,"(0557e8f90c1a2f027f4561c70558c6c836138058, 2017-04-20 11:56:43 +0800, weipingpku, 1, 1, 2, LINK)"
9369,1,656,0,656,"(76b3531362775f1f8e0ca18581a1fb6c089831c5, 2017-12-01 11:21:21 -0800, Jeff, 656, 0, 656, LINK)"
9392,1,1,1,2,"(f0ff37b9073f60fae052545796e93fa82dc4604c, 2017-06-16 15:23:42 -0700, gunan, 1, 1, 2, LINK)"
9412,1,29,16,45,"(bfd39838de87cba85f9edf028c1c30bae86da164, 2017-11-03 17:07:50 -0700, Andrew Harp, 29, 16, 45, LINK)"
95,3,144,28,172,"(d72aca428b3d932eef884b78a40bb1e55dcb878a, 2019-08-30 13:01:34 -0700, Jacques Pienaar, 61, 14, 75, LINK), (cf461e226780d05792573578fb7a01cddb8469be, 2019-08-30 13:01:34 -0700, Jacques Pienaar, 70, 14, 84, LINK), (a26f18c99047e1857f23c0fc966e28a655735849, 2017-06-23 05:46:03 +0100, Luke Iwanski, 13, 0, 13, LINK)"
952,2,11,11,22,"(ee649764d5635d1acfaa74a892542e03018e554f, 2016-02-03 15:44:41 -0800, Martin Wicke, 7, 9, 16, LINK), (c15732f9fc8e030872ea7234d300e76a9b5c9cd7, 2016-02-03 08:34:42 -0800, Martin Wicke, 4, 2, 6, LINK)"
9587,1,4,4,8,"(cb4322c7c3731740680a30ebbf8dd62ce9d4cb9f, 2017-05-02 15:48:58 -0700, Andrew Selle, 4, 4, 8, LINK)"
9593,2,13,0,13,"(ace33c76636ed908958888243131524091085f96, 2018-04-12 12:59:48 -0700, Yihong Wang, 6, 0, 6, LINK), (50d816cbc55ac2fb5e2f9dfadb669553fd4e2525, 2017-05-06 05:46:12 +0200, Erik Smistad, 7, 0, 7, LINK)"
96,2,41016,9945,50961,"(cf7c008ab150ac8e5edb3ed053d38b2919699796, 2017-06-28 11:07:44 -0700, Yifei Feng, 35256, 8213, 43469, LINK), (832894ef891568bcd4f56dd6ae4d9503cc41a694, 2017-06-22 00:59:54 +0100, Luke Iwanski, 29, 0, 29, LINK)"
9600,2,423,13,436,"(19559c06fef36c75b0bd773ba78088a4bc7161a3, 2017-11-07 06:33:22 +0900, Chris Hoyean Song, 402, 6, 408, LINK), (da0d883cba8c3b8103e17432bf8398a56a719c40, 2017-05-17 04:35:46 +0900, Chris Hoyean Song, 21, 7, 28, LINK)"
9633,1,21,8,29,"(50b836addfed6b49fc823987e9301f1b6eeef90c, 2017-05-04 11:12:52 -0800, Zongheng Yang, 21, 8, 29, LINK)"
964,1,3,0,3,"(f8741f131d30050205d84034fe13450ed9c36cf2, 2016-02-03 13:54:37 -0800, Vijay Vasudevan, 3, 0, 3, LINK)"
9651,1,1,1,2,"(3bee923c93f9624ce3abf8d55173be66a7755545, 2017-05-04 08:48:51 -0800, Patrick Nguyen, 1, 1, 2, LINK)"
9672,1,20,2,22,"(2c3bf9eff79156e32512e8d6da2179cd044167b8, 2017-10-04 19:14:02 -0700, Derek Murray, 20, 2, 22, LINK)"
97,3,816,35,851,"(ff3db06c623422f45869538d45976b6e45bca3ec, 2019-08-21 19:03:13 -0700, River Riddle, 14, 10, 24, LINK), (67ebeebe36ea5eef66b6119febad335c2f674935, 2019-08-21 19:03:13 -0700, River Riddle, 14, 10, 24, LINK), (e6fee141e3bdde3bac5741b2aadfdd41bd2a7b24, 2017-08-03 00:34:42 +0100, Luke Iwanski, 788, 15, 803, LINK)"
9708,1,2,1,3,"(73e537e7826297d2b238ca276db87f7289bb6eb2, 2017-05-09 09:16:04 -0700, Geoffrey Irving, 2, 1, 3, LINK)"
98,3,79,72,151,"(26622483a0f3057319932676bd09d709a5afb01b, 2019-08-28 23:42:17 -0700, Uday Bondhugula, 8, 8, 16, LINK), (1ab1daec63a777874bc03187db59e312d57bdec9, 2019-08-28 23:42:17 -0700, Uday Bondhugula, 64, 56, 120, LINK), (90740259edb1ff2a858cac71075a8020cb4a18f8, 2017-06-23 22:44:31 +0100, Luke Iwanski, 7, 8, 15, LINK)"
9826,1,75,30,105,"(7d785f1e18af9d22d940f18aac6e8c9ffd268b22, 2017-05-12 12:38:21 -0700, Asim Shankar, 75, 30, 105, LINK)"
9832,1,89,2,91,"(aae34fa7e35d9c3931cae49bfc20384dd20dffec, 2017-09-29 17:14:55 -0700, Eugene Brevdo, 89, 2, 91, LINK)"
9855,1,12,2,14,"(7161c8205794f744653ffe6739a0c4038e1d6cb8, 2017-05-17 13:35:37 +0900, Beomsu Kim, 12, 2, 14, LINK)"
9858,1,32,10,42,"(3ff2747a71ad45ea5158631d99833e2b5198bd69, 2017-05-24 02:48:28 +0800, jiefangxuanyan, 32, 10, 42, LINK)"
9873,1,6,7,13,"(84c11cef2417fbe44ec536786a9200b31e0e68f6, 2017-05-13 18:37:55 +0100, Adriano Carmezim, 6, 7, 13, LINK)"
9904,2,192,50,242,"(4f586f145be2a8aa66540be15e0f8ad3f8ff970c, 2017-05-29 15:14:46 -0700, Eugene Brevdo, 96, 25, 121, LINK), (34dcd5b493af9ac3bbc1bce81808a3f20e9791bd, 2017-05-29 15:14:46 -0700, Eugene Brevdo, 96, 25, 121, LINK)"
9906,1,215,0,215,"(194b1644cba446d36c6d192771b11245847db7cc, 2017-05-16 11:55:45 -0700, Yao Zhang, 215, 0, 215, LINK)"
9931,1,34,4,38,"(fe41d05e7c8343ed53fc788d6c312792b390f679, 2017-05-16 13:08:04 -0700, Asim Shankar, 34, 4, 38, LINK)"
999,1,52,22,74,"(d53f06b6a3c77160ad955b718a04260674752298, 2016-02-07 07:03:00 -0800, Vincent Vanhoucke, 52, 22, 74, LINK)"
